FGR_NR,ORT_NR,SEL_ZIEL,SEL_FZT,FRT_START,LI_NR,STR_LI_VAR,DEPARTURE,ARRIVAL
138,501500,500500,60,18540,1,"""14""",18540,18600
138,500500,500300,60,18540,1,"""14""",18600,18660
138,500300,500200,60,18540,1,"""14""",18660,18720
138,500200,502300,180,18540,1,"""14""",18720,18900
138,501500,500500,60,19740,1,"""14""",19740,19800
138,500500,500300,60,19740,1,"""14""",19800,19860
138,500300,500200,60,19740,1,"""14""",19860,19920
138,500200,502300,180,19740,1,"""14""",19920,20100
138,501500,500500,60,20100,1,"""14""",20100,20160
138,500500,500300,60,20100,1,"""14""",20160,20220
138,500300,500200,60,20100,1,"""14""",20220,20280
138,500200,502300,180,20100,1,"""14""",20280,20460
386,109012,101101,180,27000,71,"""1""",27000,27180
386,101101,32200,900,27000,71,"""1""",27180,28080
395,500102,109006,600,47100,73,"""3""",47100,47700
413,406402,405902,60,47100,54,"""3""",47700,47760
413,405902,109006,540,47100,54,"""3""",47760,48300
421,404700,403601,60,27180,54,"""5""",27180,27240
421,403601,408703,360,27180,54,"""5""",27240,27600
421,408703,404002,60,27180,54,"""5""",27600,27660
421,404002,405502,60,27180,54,"""5""",27660,27720
421,405502,409102,60,27180,54,"""5""",27720,27780
421,409102,408402,180,27180,54,"""5""",27780,27960
457,404400,408603,60,25860,3,"""5""",25860,25920
457,408603,407801,60,25860,3,"""5""",25920,25980
457,407801,400301,60,25860,3,"""5""",25980,26040
457,400301,401202,60,25860,3,"""5""",26040,26100
457,401202,400101,60,25860,3,"""5""",26100,26160
457,400101,407302,60,25860,3,"""5""",26160,26220
457,407302,408202,60,25860,3,"""5""",26220,26280
457,408202,403104,120,25860,3,"""5""",26280,26400
457,403104,112103,120,25860,3,"""5""",26400,26520
457,404400,408603,60,25920,3,"""5""",25920,25980
457,408603,407801,60,25920,3,"""5""",25980,26040
457,407801,400301,60,25920,3,"""5""",26040,26100
457,400301,401202,60,25920,3,"""5""",26100,26160
457,401202,400101,60,25920,3,"""5""",26160,26220
457,400101,407302,60,25920,3,"""5""",26220,26280
457,407302,408202,60,25920,3,"""5""",26280,26340
457,408202,403104,120,25920,3,"""5""",26340,26460
457,403104,112103,120,25920,3,"""5""",26460,26580
457,404400,408603,60,27120,3,"""5""",27120,27180
457,408603,407801,60,27120,3,"""5""",27180,27240
457,407801,400301,60,27120,3,"""5""",27240,27300
457,400301,401202,60,27120,3,"""5""",27300,27360
457,401202,400101,60,27120,3,"""5""",27360,27420
457,400101,407302,60,27120,3,"""5""",27420,27480
457,407302,408202,60,27120,3,"""5""",27480,27540
457,408202,403104,120,27120,3,"""5""",27540,27660
457,403104,112103,120,27120,3,"""5""",27660,27780
457,404400,408603,60,28320,3,"""5""",28320,28380
457,408603,407801,60,28320,3,"""5""",28380,28440
457,407801,400301,60,28320,3,"""5""",28440,28500
457,400301,401202,60,28320,3,"""5""",28500,28560
457,401202,400101,60,28320,3,"""5""",28560,28620
457,400101,407302,60,28320,3,"""5""",28620,28680
457,407302,408202,60,28320,3,"""5""",28680,28740
457,408202,403104,120,28320,3,"""5""",28740,28860
457,403104,112103,120,28320,3,"""5""",28860,28980
465,401202,400101,60,57480,3,"""32""",57480,57540
465,400101,407302,60,57480,3,"""32""",57540,57600
465,407302,408202,60,57480,3,"""32""",57600,57660
465,408202,403104,120,57480,3,"""32""",57660,57780
465,403104,112103,120,57480,3,"""32""",57780,57900
502,101002,102002,60,71940,62,"""2""",71940,72000
502,102002,101101,120,71940,62,"""2""",72000,72120
502,101101,403802,120,71940,62,"""2""",72120,72240
502,403802,408300,60,71940,62,"""2""",72240,72300
502,408300,406502,60,71940,62,"""2""",72300,72360
502,406502,407702,60,71940,62,"""2""",72360,72420
502,407702,34201,60,71940,62,"""2""",72420,72480
502,34201,408004,120,71940,62,"""2""",72480,72600
502,101002,102002,60,73140,62,"""2""",73140,73200
502,102002,101101,120,73140,62,"""2""",73200,73320
502,101101,403802,120,73140,62,"""2""",73320,73440
502,403802,408300,60,73140,62,"""2""",73440,73500
502,408300,406502,60,73140,62,"""2""",73500,73560
502,406502,407702,60,73140,62,"""2""",73560,73620
502,407702,34201,60,73140,62,"""2""",73620,73680
502,34201,408004,120,73140,62,"""2""",73680,73800
504,408002,34202,120,54180,64,"""1""",54180,54300
504,34202,407701,60,54180,64,"""1""",54300,54360
504,407701,406501,60,54180,64,"""1""",54360,54420
504,406501,405901,60,54180,64,"""1""",54420,54480
504,405901,405101,60,54180,64,"""1""",54480,54540
504,408002,34202,120,55380,64,"""1""",55380,55500
504,34202,407701,60,55380,64,"""1""",55500,55560
504,407701,406501,60,55380,64,"""1""",55560,55620
504,406501,405901,60,55380,64,"""1""",55620,55680
504,405901,405101,60,55380,64,"""1""",55680,55740
504,408002,34202,120,56580,64,"""1""",56580,56700
504,34202,407701,60,56580,64,"""1""",56700,56760
504,407701,406501,60,56580,64,"""1""",56760,56820
504,406501,405901,60,56580,64,"""1""",56820,56880
504,405901,405101,60,56580,64,"""1""",56880,56940
504,408002,34202,120,57780,64,"""1""",57780,57900
504,34202,407701,60,57780,64,"""1""",57900,57960
504,407701,406501,60,57780,64,"""1""",57960,58020
504,406501,405901,60,57780,64,"""1""",58020,58080
504,405901,405101,60,57780,64,"""1""",58080,58140
504,408002,34202,120,58980,64,"""1""",58980,59100
504,34202,407701,60,58980,64,"""1""",59100,59160
504,407701,406501,60,58980,64,"""1""",59160,59220
504,406501,405901,60,58980,64,"""1""",59220,59280
504,405901,405101,60,58980,64,"""1""",59280,59340
504,408002,34202,120,60180,64,"""1""",60180,60300
504,34202,407701,60,60180,64,"""1""",60300,60360
504,407701,406501,60,60180,64,"""1""",60360,60420
504,406501,405901,60,60180,64,"""1""",60420,60480
504,405901,405101,60,60180,64,"""1""",60480,60540
504,408002,34202,120,61380,64,"""1""",61380,61500
504,34202,407701,60,61380,64,"""1""",61500,61560
504,407701,406501,60,61380,64,"""1""",61560,61620
504,406501,405901,60,61380,64,"""1""",61620,61680
504,405901,405101,60,61380,64,"""1""",61680,61740
504,408002,34202,120,62580,64,"""1""",62580,62700
504,34202,407701,60,62580,64,"""1""",62700,62760
504,407701,406501,60,62580,64,"""1""",62760,62820
504,406501,405901,60,62580,64,"""1""",62820,62880
504,405901,405101,60,62580,64,"""1""",62880,62940
504,408002,34202,120,63780,64,"""1""",63780,63900
504,34202,407701,60,63780,64,"""1""",63900,63960
504,407701,406501,60,63780,64,"""1""",63960,64020
504,406501,405901,60,63780,64,"""1""",64020,64080
504,405901,405101,60,63780,64,"""1""",64080,64140
504,408002,34202,120,64980,64,"""1""",64980,65100
504,34202,407701,60,64980,64,"""1""",65100,65160
504,407701,406501,60,64980,64,"""1""",65160,65220
504,406501,405901,60,64980,64,"""1""",65220,65280
504,405901,405101,60,64980,64,"""1""",65280,65340
504,408002,34202,120,66180,64,"""1""",66180,66300
504,34202,407701,60,66180,64,"""1""",66300,66360
504,407701,406501,60,66180,64,"""1""",66360,66420
504,406501,405901,60,66180,64,"""1""",66420,66480
504,405901,405101,60,66180,64,"""1""",66480,66540
504,408002,34202,120,67380,64,"""1""",67380,67500
504,34202,407701,60,67380,64,"""1""",67500,67560
504,407701,406501,60,67380,64,"""1""",67560,67620
504,406501,405901,60,67380,64,"""1""",67620,67680
504,405901,405101,60,67380,64,"""1""",67680,67740
504,408002,34202,120,68580,64,"""1""",68580,68700
504,34202,407701,60,68580,64,"""1""",68700,68760
504,407701,406501,60,68580,64,"""1""",68760,68820
504,406501,405901,60,68580,64,"""1""",68820,68880
504,405901,405101,60,68580,64,"""1""",68880,68940
504,408002,34202,120,69780,64,"""1""",69780,69900
504,34202,407701,60,69780,64,"""1""",69900,69960
504,407701,406501,60,69780,64,"""1""",69960,70020
504,406501,405901,60,69780,64,"""1""",70020,70080
504,405901,405101,60,69780,64,"""1""",70080,70140
504,408002,34202,120,71100,64,"""1""",71100,71220
504,34202,407701,60,71100,64,"""1""",71220,71280
504,407701,406501,60,71100,64,"""1""",71280,71340
504,406501,405901,60,71100,64,"""1""",71340,71400
504,405901,405101,60,71100,64,"""1""",71400,71460
504,408002,34202,120,72900,64,"""1""",72900,73020
504,34202,407701,60,72900,64,"""1""",73020,73080
504,407701,406501,60,72900,64,"""1""",73080,73140
504,406501,405901,60,72900,64,"""1""",73140,73200
504,405901,405101,60,72900,64,"""1""",73200,73260
1891,200900,202002,60,19380,4,"""4""",19380,19440
1891,202002,204103,120,19380,4,"""4""",19440,19560
1891,204103,203604,60,19380,4,"""4""",19560,19620
1891,203604,201903,60,19380,4,"""4""",19620,19680
1891,201903,203900,120,19380,4,"""4""",19680,19800
1891,203900,201503,60,19380,4,"""4""",19800,19860
1891,201503,208103,60,19380,4,"""4""",19860,19920
1891,208103,34104,60,19380,4,"""4""",19920,19980
1891,34104,105002,60,19380,4,"""4""",19980,20040
1891,105002,118002,120,19380,4,"""4""",20040,20160
1891,118002,106002,60,19380,4,"""4""",20160,20220
1891,106002,118102,60,19380,4,"""4""",20220,20280
1891,118102,101004,120,19380,4,"""4""",20280,20400
1891,200900,202002,60,73020,4,"""4""",73020,73080
1891,202002,204103,120,73020,4,"""4""",73080,73200
1891,204103,203604,60,73020,4,"""4""",73200,73260
1891,203604,201903,60,73020,4,"""4""",73260,73320
1891,201903,203900,120,73020,4,"""4""",73320,73440
1891,203900,201503,60,73020,4,"""4""",73440,73500
1891,201503,208103,60,73020,4,"""4""",73500,73560
1891,208103,34104,60,73020,4,"""4""",73560,73620
1891,34104,105002,60,73020,4,"""4""",73620,73680
1891,105002,118002,120,73020,4,"""4""",73680,73800
1891,118002,106002,60,73020,4,"""4""",73800,73860
1891,106002,118102,60,73020,4,"""4""",73860,73920
1891,118102,101004,120,73020,4,"""4""",73920,74040
1891,200900,202002,60,74820,4,"""4""",74820,74880
1891,202002,204103,120,74820,4,"""4""",74880,75000
1891,204103,203604,60,74820,4,"""4""",75000,75060
1891,203604,201903,60,74820,4,"""4""",75060,75120
1891,201903,203900,120,74820,4,"""4""",75120,75240
1891,203900,201503,60,74820,4,"""4""",75240,75300
1891,201503,208103,60,74820,4,"""4""",75300,75360
1891,208103,34104,60,74820,4,"""4""",75360,75420
1891,34104,105002,60,74820,4,"""4""",75420,75480
1891,105002,118002,120,74820,4,"""4""",75480,75600
1891,118002,106002,60,74820,4,"""4""",75600,75660
1891,106002,118102,60,74820,4,"""4""",75660,75720
1891,118102,101004,120,74820,4,"""4""",75720,75840
1891,200900,202002,60,76620,4,"""4""",76620,76680
1891,202002,204103,120,76620,4,"""4""",76680,76800
1891,204103,203604,60,76620,4,"""4""",76800,76860
1891,203604,201903,60,76620,4,"""4""",76860,76920
1891,201903,203900,120,76620,4,"""4""",76920,77040
1891,203900,201503,60,76620,4,"""4""",77040,77100
1891,201503,208103,60,76620,4,"""4""",77100,77160
1891,208103,34104,60,76620,4,"""4""",77160,77220
1891,34104,105002,60,76620,4,"""4""",77220,77280
1891,105002,118002,120,76620,4,"""4""",77280,77400
1891,118002,106002,60,76620,4,"""4""",77400,77460
1891,106002,118102,60,76620,4,"""4""",77460,77520
1891,118102,101004,120,76620,4,"""4""",77520,77640
1891,200900,202002,60,78420,4,"""4""",78420,78480
1891,202002,204103,120,78420,4,"""4""",78480,78600
1891,204103,203604,60,78420,4,"""4""",78600,78660
1891,203604,201903,60,78420,4,"""4""",78660,78720
1891,201903,203900,120,78420,4,"""4""",78720,78840
1891,203900,201503,60,78420,4,"""4""",78840,78900
1891,201503,208103,60,78420,4,"""4""",78900,78960
1891,208103,34104,60,78420,4,"""4""",78960,79020
1891,34104,105002,60,78420,4,"""4""",79020,79080
1891,105002,118002,120,78420,4,"""4""",79080,79200
1891,118002,106002,60,78420,4,"""4""",79200,79260
1891,106002,118102,60,78420,4,"""4""",79260,79320
1891,118102,101004,120,78420,4,"""4""",79320,79440
1891,200900,202002,60,80220,4,"""4""",80220,80280
1891,202002,204103,120,80220,4,"""4""",80280,80400
1891,204103,203604,60,80220,4,"""4""",80400,80460
1891,203604,201903,60,80220,4,"""4""",80460,80520
1891,201903,203900,120,80220,4,"""4""",80520,80640
1891,203900,201503,60,80220,4,"""4""",80640,80700
1891,201503,208103,60,80220,4,"""4""",80700,80760
1891,208103,34104,60,80220,4,"""4""",80760,80820
1891,34104,105002,60,80220,4,"""4""",80820,80880
1891,105002,118002,120,80220,4,"""4""",80880,81000
1891,118002,106002,60,80220,4,"""4""",81000,81060
1891,106002,118102,60,80220,4,"""4""",81060,81120
1891,118102,101004,120,80220,4,"""4""",81120,81240
1891,200900,202002,60,82020,4,"""4""",82020,82080
1891,202002,204103,120,82020,4,"""4""",82080,82200
1891,204103,203604,60,82020,4,"""4""",82200,82260
1891,203604,201903,60,82020,4,"""4""",82260,82320
1891,201903,203900,120,82020,4,"""4""",82320,82440
1891,203900,201503,60,82020,4,"""4""",82440,82500
1891,201503,208103,60,82020,4,"""4""",82500,82560
1891,208103,34104,60,82020,4,"""4""",82560,82620
1891,34104,105002,60,82020,4,"""4""",82620,82680
1891,105002,118002,120,82020,4,"""4""",82680,82800
1891,118002,106002,60,82020,4,"""4""",82800,82860
1891,106002,118102,60,82020,4,"""4""",82860,82920
1891,118102,101004,120,82020,4,"""4""",82920,83040
1891,200900,202002,60,83820,4,"""4""",83820,83880
1891,202002,204103,120,83820,4,"""4""",83880,84000
1891,204103,203604,60,83820,4,"""4""",84000,84060
1891,203604,201903,60,83820,4,"""4""",84060,84120
1891,201903,203900,120,83820,4,"""4""",84120,84240
1891,203900,201503,60,83820,4,"""4""",84240,84300
1891,201503,208103,60,83820,4,"""4""",84300,84360
1891,208103,34104,60,83820,4,"""4""",84360,84420
1891,34104,105002,60,83820,4,"""4""",84420,84480
1891,105002,118002,120,83820,4,"""4""",84480,84600
1891,118002,106002,60,83820,4,"""4""",84600,84660
1891,106002,118102,60,83820,4,"""4""",84660,84720
1891,118102,101004,120,83820,4,"""4""",84720,84840
1891,200900,202002,60,85620,4,"""4""",85620,85680
1891,202002,204103,120,85620,4,"""4""",85680,85800
1891,204103,203604,60,85620,4,"""4""",85800,85860
1891,203604,201903,60,85620,4,"""4""",85860,85920
1891,201903,203900,120,85620,4,"""4""",85920,86040
1891,203900,201503,60,85620,4,"""4""",86040,86100
1891,201503,208103,60,85620,4,"""4""",86100,86160
1891,208103,34104,60,85620,4,"""4""",86160,86220
1891,34104,105002,60,85620,4,"""4""",86220,86280
1891,105002,118002,120,85620,4,"""4""",86280,86400
1891,118002,106002,60,85620,4,"""4""",86400,86460
1891,106002,118102,60,85620,4,"""4""",86460,86520
1891,118102,101004,120,85620,4,"""4""",86520,86640
2378,405300,402800,60,66900,10,"""9""",66900,66960
2378,402800,405100,60,66900,10,"""9""",66960,67020
2378,405100,405902,60,66900,10,"""9""",67020,67080
2378,405902,406500,60,66900,10,"""9""",67080,67140
2378,406500,400601,120,66900,10,"""9""",67140,67260
2378,400601,404300,60,66900,10,"""9""",67260,67320
2378,404300,407401,60,66900,10,"""9""",67320,67380
2378,407401,404103,120,66900,10,"""9""",67380,67500
2378,404103,403104,120,66900,10,"""9""",67500,67620
2378,403104,112101,180,66900,10,"""9""",67620,67800
2388,405300,402800,60,24900,10,"""33""",24900,24960
2388,402800,405100,60,24900,10,"""33""",24960,25020
2388,405100,405902,60,24900,10,"""33""",25020,25080
2388,405902,406500,60,24900,10,"""33""",25080,25140
2388,406500,400601,120,24900,10,"""33""",25140,25260
2388,400601,404300,60,24900,10,"""33""",25260,25320
2388,404300,407401,60,24900,10,"""33""",25320,25380
2388,407401,404103,120,24900,10,"""33""",25380,25500
2388,404103,403104,120,24900,10,"""33""",25500,25620
2388,403104,112101,180,24900,10,"""33""",25620,25800
2388,112101,103001,180,24900,10,"""33""",25800,25980
2388,103001,106501,60,24900,10,"""33""",25980,26040
2388,106501,119006,180,24900,10,"""33""",26040,26220
2388,119006,302501,120,24900,10,"""33""",26220,26340
2388,302501,303001,60,24900,10,"""33""",26340,26400
2388,303001,302201,120,24900,10,"""33""",26400,26520
2388,302201,302001,60,24900,10,"""33""",26520,26580
2388,302001,302100,120,24900,10,"""33""",26580,26700
2388,405300,402800,60,26100,10,"""33""",26100,26160
2388,402800,405100,60,26100,10,"""33""",26160,26220
2388,405100,405902,60,26100,10,"""33""",26220,26280
2388,405902,406500,60,26100,10,"""33""",26280,26340
2388,406500,400601,120,26100,10,"""33""",26340,26460
2388,400601,404300,60,26100,10,"""33""",26460,26520
2388,404300,407401,60,26100,10,"""33""",26520,26580
2388,407401,404103,120,26100,10,"""33""",26580,26700
2388,404103,403104,120,26100,10,"""33""",26700,26820
2388,403104,112101,180,26100,10,"""33""",26820,27000
2388,112101,103001,180,26100,10,"""33""",27000,27180
2388,103001,106501,60,26100,10,"""33""",27180,27240
2388,106501,119006,180,26100,10,"""33""",27240,27420
2388,119006,302501,120,26100,10,"""33""",27420,27540
2388,302501,303001,60,26100,10,"""33""",27540,27600
2388,303001,302201,120,26100,10,"""33""",27600,27720
2388,302201,302001,60,26100,10,"""33""",27720,27780
2388,302001,302100,120,26100,10,"""33""",27780,27900
2388,405300,402800,60,28500,10,"""33""",28500,28560
2388,402800,405100,60,28500,10,"""33""",28560,28620
2388,405100,405902,60,28500,10,"""33""",28620,28680
2388,405902,406500,60,28500,10,"""33""",28680,28740
2388,406500,400601,120,28500,10,"""33""",28740,28860
2388,400601,404300,60,28500,10,"""33""",28860,28920
2388,404300,407401,60,28500,10,"""33""",28920,28980
2388,407401,404103,120,28500,10,"""33""",28980,29100
2388,404103,403104,120,28500,10,"""33""",29100,29220
2388,403104,112101,180,28500,10,"""33""",29220,29400
2388,112101,103001,180,28500,10,"""33""",29400,29580
2388,103001,106501,60,28500,10,"""33""",29580,29640
2388,106501,119006,180,28500,10,"""33""",29640,29820
2388,119006,302501,120,28500,10,"""33""",29820,29940
2388,302501,303001,60,28500,10,"""33""",29940,30000
2388,303001,302201,120,28500,10,"""33""",30000,30120
2388,302201,302001,60,28500,10,"""33""",30120,30180
2388,302001,302100,120,28500,10,"""33""",30180,30300
2388,405300,402800,60,29700,10,"""33""",29700,29760
2388,402800,405100,60,29700,10,"""33""",29760,29820
2388,405100,405902,60,29700,10,"""33""",29820,29880
2388,405902,406500,60,29700,10,"""33""",29880,29940
2388,406500,400601,120,29700,10,"""33""",29940,30060
2388,400601,404300,60,29700,10,"""33""",30060,30120
2388,404300,407401,60,29700,10,"""33""",30120,30180
2388,407401,404103,120,29700,10,"""33""",30180,30300
2388,404103,403104,120,29700,10,"""33""",30300,30420
2388,403104,112101,180,29700,10,"""33""",30420,30600
2388,112101,103001,180,29700,10,"""33""",30600,30780
2388,103001,106501,60,29700,10,"""33""",30780,30840
2388,106501,119006,180,29700,10,"""33""",30840,31020
2388,119006,302501,120,29700,10,"""33""",31020,31140
2388,302501,303001,60,29700,10,"""33""",31140,31200
2388,303001,302201,120,29700,10,"""33""",31200,31320
2388,302201,302001,60,29700,10,"""33""",31320,31380
2388,302001,302100,120,29700,10,"""33""",31380,31500
2388,405300,402800,60,30900,10,"""33""",30900,30960
2388,402800,405100,60,30900,10,"""33""",30960,31020
2388,405100,405902,60,30900,10,"""33""",31020,31080
2388,405902,406500,60,30900,10,"""33""",31080,31140
2388,406500,400601,120,30900,10,"""33""",31140,31260
2388,400601,404300,60,30900,10,"""33""",31260,31320
2388,404300,407401,60,30900,10,"""33""",31320,31380
2388,407401,404103,120,30900,10,"""33""",31380,31500
2388,404103,403104,120,30900,10,"""33""",31500,31620
2388,403104,112101,180,30900,10,"""33""",31620,31800
2388,112101,103001,180,30900,10,"""33""",31800,31980
2388,103001,106501,60,30900,10,"""33""",31980,32040
2388,106501,119006,180,30900,10,"""33""",32040,32220
2388,119006,302501,120,30900,10,"""33""",32220,32340
2388,302501,303001,60,30900,10,"""33""",32340,32400
2388,303001,302201,120,30900,10,"""33""",32400,32520
2388,302201,302001,60,30900,10,"""33""",32520,32580
2388,302001,302100,120,30900,10,"""33""",32580,32700
2388,405300,402800,60,32100,10,"""33""",32100,32160
2388,402800,405100,60,32100,10,"""33""",32160,32220
2388,405100,405902,60,32100,10,"""33""",32220,32280
2388,405902,406500,60,32100,10,"""33""",32280,32340
2388,406500,400601,120,32100,10,"""33""",32340,32460
2388,400601,404300,60,32100,10,"""33""",32460,32520
2388,404300,407401,60,32100,10,"""33""",32520,32580
2388,407401,404103,120,32100,10,"""33""",32580,32700
2388,404103,403104,120,32100,10,"""33""",32700,32820
2388,403104,112101,180,32100,10,"""33""",32820,33000
2388,112101,103001,180,32100,10,"""33""",33000,33180
2388,103001,106501,60,32100,10,"""33""",33180,33240
2388,106501,119006,180,32100,10,"""33""",33240,33420
2388,119006,302501,120,32100,10,"""33""",33420,33540
2388,302501,303001,60,32100,10,"""33""",33540,33600
2388,303001,302201,120,32100,10,"""33""",33600,33720
2388,302201,302001,60,32100,10,"""33""",33720,33780
2388,302001,302100,120,32100,10,"""33""",33780,33900
2388,405300,402800,60,33300,10,"""33""",33300,33360
2388,402800,405100,60,33300,10,"""33""",33360,33420
2388,405100,405902,60,33300,10,"""33""",33420,33480
2388,405902,406500,60,33300,10,"""33""",33480,33540
2388,406500,400601,120,33300,10,"""33""",33540,33660
2388,400601,404300,60,33300,10,"""33""",33660,33720
2388,404300,407401,60,33300,10,"""33""",33720,33780
2388,407401,404103,120,33300,10,"""33""",33780,33900
2388,404103,403104,120,33300,10,"""33""",33900,34020
2388,403104,112101,180,33300,10,"""33""",34020,34200
2388,112101,103001,180,33300,10,"""33""",34200,34380
2388,103001,106501,60,33300,10,"""33""",34380,34440
2388,106501,119006,180,33300,10,"""33""",34440,34620
2388,119006,302501,120,33300,10,"""33""",34620,34740
2388,302501,303001,60,33300,10,"""33""",34740,34800
2388,303001,302201,120,33300,10,"""33""",34800,34920
2388,302201,302001,60,33300,10,"""33""",34920,34980
2388,302001,302100,120,33300,10,"""33""",34980,35100
2388,405300,402800,60,34500,10,"""33""",34500,34560
2388,402800,405100,60,34500,10,"""33""",34560,34620
2388,405100,405902,60,34500,10,"""33""",34620,34680
2388,405902,406500,60,34500,10,"""33""",34680,34740
2388,406500,400601,120,34500,10,"""33""",34740,34860
2388,400601,404300,60,34500,10,"""33""",34860,34920
2388,404300,407401,60,34500,10,"""33""",34920,34980
2388,407401,404103,120,34500,10,"""33""",34980,35100
2388,404103,403104,120,34500,10,"""33""",35100,35220
2388,403104,112101,180,34500,10,"""33""",35220,35400
2388,112101,103001,180,34500,10,"""33""",35400,35580
2388,103001,106501,60,34500,10,"""33""",35580,35640
2388,106501,119006,180,34500,10,"""33""",35640,35820
2388,119006,302501,120,34500,10,"""33""",35820,35940
2388,302501,303001,60,34500,10,"""33""",35940,36000
2388,303001,302201,120,34500,10,"""33""",36000,36120
2388,302201,302001,60,34500,10,"""33""",36120,36180
2388,302001,302100,120,34500,10,"""33""",36180,36300
2388,405300,402800,60,35700,10,"""33""",35700,35760
2388,402800,405100,60,35700,10,"""33""",35760,35820
2388,405100,405902,60,35700,10,"""33""",35820,35880
2388,405902,406500,60,35700,10,"""33""",35880,35940
2388,406500,400601,120,35700,10,"""33""",35940,36060
2388,400601,404300,60,35700,10,"""33""",36060,36120
2388,404300,407401,60,35700,10,"""33""",36120,36180
2388,407401,404103,120,35700,10,"""33""",36180,36300
2388,404103,403104,120,35700,10,"""33""",36300,36420
2388,403104,112101,180,35700,10,"""33""",36420,36600
2388,112101,103001,180,35700,10,"""33""",36600,36780
2388,103001,106501,60,35700,10,"""33""",36780,36840
2388,106501,119006,180,35700,10,"""33""",36840,37020
2388,119006,302501,120,35700,10,"""33""",37020,37140
2388,302501,303001,60,35700,10,"""33""",37140,37200
2388,303001,302201,120,35700,10,"""33""",37200,37320
2388,302201,302001,60,35700,10,"""33""",37320,37380
2388,302001,302100,120,35700,10,"""33""",37380,37500
2388,405300,402800,60,36900,10,"""33""",36900,36960
2388,402800,405100,60,36900,10,"""33""",36960,37020
2388,405100,405902,60,36900,10,"""33""",37020,37080
2388,405902,406500,60,36900,10,"""33""",37080,37140
2388,406500,400601,120,36900,10,"""33""",37140,37260
2388,400601,404300,60,36900,10,"""33""",37260,37320
2388,404300,407401,60,36900,10,"""33""",37320,37380
2388,407401,404103,120,36900,10,"""33""",37380,37500
2388,404103,403104,120,36900,10,"""33""",37500,37620
2388,403104,112101,180,36900,10,"""33""",37620,37800
2388,112101,103001,180,36900,10,"""33""",37800,37980
2388,103001,106501,60,36900,10,"""33""",37980,38040
2388,106501,119006,180,36900,10,"""33""",38040,38220
2388,119006,302501,120,36900,10,"""33""",38220,38340
2388,302501,303001,60,36900,10,"""33""",38340,38400
2388,303001,302201,120,36900,10,"""33""",38400,38520
2388,302201,302001,60,36900,10,"""33""",38520,38580
2388,302001,302100,120,36900,10,"""33""",38580,38700
2388,405300,402800,60,38100,10,"""33""",38100,38160
2388,402800,405100,60,38100,10,"""33""",38160,38220
2388,405100,405902,60,38100,10,"""33""",38220,38280
2388,405902,406500,60,38100,10,"""33""",38280,38340
2388,406500,400601,120,38100,10,"""33""",38340,38460
2388,400601,404300,60,38100,10,"""33""",38460,38520
2388,404300,407401,60,38100,10,"""33""",38520,38580
2388,407401,404103,120,38100,10,"""33""",38580,38700
2388,404103,403104,120,38100,10,"""33""",38700,38820
2388,403104,112101,180,38100,10,"""33""",38820,39000
2388,112101,103001,180,38100,10,"""33""",39000,39180
2388,103001,106501,60,38100,10,"""33""",39180,39240
2388,106501,119006,180,38100,10,"""33""",39240,39420
2388,119006,302501,120,38100,10,"""33""",39420,39540
2388,302501,303001,60,38100,10,"""33""",39540,39600
2388,303001,302201,120,38100,10,"""33""",39600,39720
2388,302201,302001,60,38100,10,"""33""",39720,39780
2388,302001,302100,120,38100,10,"""33""",39780,39900
2388,405300,402800,60,39300,10,"""33""",39300,39360
2388,402800,405100,60,39300,10,"""33""",39360,39420
2388,405100,405902,60,39300,10,"""33""",39420,39480
2388,405902,406500,60,39300,10,"""33""",39480,39540
2388,406500,400601,120,39300,10,"""33""",39540,39660
2388,400601,404300,60,39300,10,"""33""",39660,39720
2388,404300,407401,60,39300,10,"""33""",39720,39780
2388,407401,404103,120,39300,10,"""33""",39780,39900
2388,404103,403104,120,39300,10,"""33""",39900,40020
2388,403104,112101,180,39300,10,"""33""",40020,40200
2388,112101,103001,180,39300,10,"""33""",40200,40380
2388,103001,106501,60,39300,10,"""33""",40380,40440
2388,106501,119006,180,39300,10,"""33""",40440,40620
2388,119006,302501,120,39300,10,"""33""",40620,40740
2388,302501,303001,60,39300,10,"""33""",40740,40800
2388,303001,302201,120,39300,10,"""33""",40800,40920
2388,302201,302001,60,39300,10,"""33""",40920,40980
2388,302001,302100,120,39300,10,"""33""",40980,41100
2388,405300,402800,60,40500,10,"""33""",40500,40560
2388,402800,405100,60,40500,10,"""33""",40560,40620
2388,405100,405902,60,40500,10,"""33""",40620,40680
2388,405902,406500,60,40500,10,"""33""",40680,40740
2388,406500,400601,120,40500,10,"""33""",40740,40860
2388,400601,404300,60,40500,10,"""33""",40860,40920
2388,404300,407401,60,40500,10,"""33""",40920,40980
2388,407401,404103,120,40500,10,"""33""",40980,41100
2388,404103,403104,120,40500,10,"""33""",41100,41220
2388,403104,112101,180,40500,10,"""33""",41220,41400
2388,112101,103001,180,40500,10,"""33""",41400,41580
2388,103001,106501,60,40500,10,"""33""",41580,41640
2388,106501,119006,180,40500,10,"""33""",41640,41820
2388,119006,302501,120,40500,10,"""33""",41820,41940
2388,302501,303001,60,40500,10,"""33""",41940,42000
2388,303001,302201,120,40500,10,"""33""",42000,42120
2388,302201,302001,60,40500,10,"""33""",42120,42180
2388,302001,302100,120,40500,10,"""33""",42180,42300
2388,405300,402800,60,41700,10,"""33""",41700,41760
2388,402800,405100,60,41700,10,"""33""",41760,41820
2388,405100,405902,60,41700,10,"""33""",41820,41880
2388,405902,406500,60,41700,10,"""33""",41880,41940
2388,406500,400601,120,41700,10,"""33""",41940,42060
2388,400601,404300,60,41700,10,"""33""",42060,42120
2388,404300,407401,60,41700,10,"""33""",42120,42180
2388,407401,404103,120,41700,10,"""33""",42180,42300
2388,404103,403104,120,41700,10,"""33""",42300,42420
2388,403104,112101,180,41700,10,"""33""",42420,42600
2388,112101,103001,180,41700,10,"""33""",42600,42780
2388,103001,106501,60,41700,10,"""33""",42780,42840
2388,106501,119006,180,41700,10,"""33""",42840,43020
2388,119006,302501,120,41700,10,"""33""",43020,43140
2388,302501,303001,60,41700,10,"""33""",43140,43200
2388,303001,302201,120,41700,10,"""33""",43200,43320
2388,302201,302001,60,41700,10,"""33""",43320,43380
2388,302001,302100,120,41700,10,"""33""",43380,43500
2388,405300,402800,60,42900,10,"""33""",42900,42960
2388,402800,405100,60,42900,10,"""33""",42960,43020
2388,405100,405902,60,42900,10,"""33""",43020,43080
2388,405902,406500,60,42900,10,"""33""",43080,43140
2388,406500,400601,120,42900,10,"""33""",43140,43260
2388,400601,404300,60,42900,10,"""33""",43260,43320
2388,404300,407401,60,42900,10,"""33""",43320,43380
2388,407401,404103,120,42900,10,"""33""",43380,43500
2388,404103,403104,120,42900,10,"""33""",43500,43620
2388,403104,112101,180,42900,10,"""33""",43620,43800
2388,112101,103001,180,42900,10,"""33""",43800,43980
2388,103001,106501,60,42900,10,"""33""",43980,44040
2388,106501,119006,180,42900,10,"""33""",44040,44220
2388,119006,302501,120,42900,10,"""33""",44220,44340
2388,302501,303001,60,42900,10,"""33""",44340,44400
2388,303001,302201,120,42900,10,"""33""",44400,44520
2388,302201,302001,60,42900,10,"""33""",44520,44580
2388,302001,302100,120,42900,10,"""33""",44580,44700
2388,405300,402800,60,44100,10,"""33""",44100,44160
2388,402800,405100,60,44100,10,"""33""",44160,44220
2388,405100,405902,60,44100,10,"""33""",44220,44280
2388,405902,406500,60,44100,10,"""33""",44280,44340
2388,406500,400601,120,44100,10,"""33""",44340,44460
2388,400601,404300,60,44100,10,"""33""",44460,44520
2388,404300,407401,60,44100,10,"""33""",44520,44580
2388,407401,404103,120,44100,10,"""33""",44580,44700
2388,404103,403104,120,44100,10,"""33""",44700,44820
2388,403104,112101,180,44100,10,"""33""",44820,45000
2388,112101,103001,180,44100,10,"""33""",45000,45180
2388,103001,106501,60,44100,10,"""33""",45180,45240
2388,106501,119006,180,44100,10,"""33""",45240,45420
2388,119006,302501,120,44100,10,"""33""",45420,45540
2388,302501,303001,60,44100,10,"""33""",45540,45600
2388,303001,302201,120,44100,10,"""33""",45600,45720
2388,302201,302001,60,44100,10,"""33""",45720,45780
2388,302001,302100,120,44100,10,"""33""",45780,45900
2388,405300,402800,60,45300,10,"""33""",45300,45360
2388,402800,405100,60,45300,10,"""33""",45360,45420
2388,405100,405902,60,45300,10,"""33""",45420,45480
2388,405902,406500,60,45300,10,"""33""",45480,45540
2388,406500,400601,120,45300,10,"""33""",45540,45660
2388,400601,404300,60,45300,10,"""33""",45660,45720
2388,404300,407401,60,45300,10,"""33""",45720,45780
2388,407401,404103,120,45300,10,"""33""",45780,45900
2388,404103,403104,120,45300,10,"""33""",45900,46020
2388,403104,112101,180,45300,10,"""33""",46020,46200
2388,112101,103001,180,45300,10,"""33""",46200,46380
2388,103001,106501,60,45300,10,"""33""",46380,46440
2388,106501,119006,180,45300,10,"""33""",46440,46620
2388,119006,302501,120,45300,10,"""33""",46620,46740
2388,302501,303001,60,45300,10,"""33""",46740,46800
2388,303001,302201,120,45300,10,"""33""",46800,46920
2388,302201,302001,60,45300,10,"""33""",46920,46980
2388,302001,302100,120,45300,10,"""33""",46980,47100
2388,405300,402800,60,46500,10,"""33""",46500,46560
2388,402800,405100,60,46500,10,"""33""",46560,46620
2388,405100,405902,60,46500,10,"""33""",46620,46680
2388,405902,406500,60,46500,10,"""33""",46680,46740
2388,406500,400601,120,46500,10,"""33""",46740,46860
2388,400601,404300,60,46500,10,"""33""",46860,46920
2388,404300,407401,60,46500,10,"""33""",46920,46980
2388,407401,404103,120,46500,10,"""33""",46980,47100
2388,404103,403104,120,46500,10,"""33""",47100,47220
2388,403104,112101,180,46500,10,"""33""",47220,47400
2388,112101,103001,180,46500,10,"""33""",47400,47580
2388,103001,106501,60,46500,10,"""33""",47580,47640
2388,106501,119006,180,46500,10,"""33""",47640,47820
2388,119006,302501,120,46500,10,"""33""",47820,47940
2388,302501,303001,60,46500,10,"""33""",47940,48000
2388,303001,302201,120,46500,10,"""33""",48000,48120
2388,302201,302001,60,46500,10,"""33""",48120,48180
2388,302001,302100,120,46500,10,"""33""",48180,48300
2388,405300,402800,60,47700,10,"""33""",47700,47760
2388,402800,405100,60,47700,10,"""33""",47760,47820
2388,405100,405902,60,47700,10,"""33""",47820,47880
2388,405902,406500,60,47700,10,"""33""",47880,47940
2388,406500,400601,120,47700,10,"""33""",47940,48060
2388,400601,404300,60,47700,10,"""33""",48060,48120
2388,404300,407401,60,47700,10,"""33""",48120,48180
2388,407401,404103,120,47700,10,"""33""",48180,48300
2388,404103,403104,120,47700,10,"""33""",48300,48420
2388,403104,112101,180,47700,10,"""33""",48420,48600
2388,112101,103001,180,47700,10,"""33""",48600,48780
2388,103001,106501,60,47700,10,"""33""",48780,48840
2388,106501,119006,180,47700,10,"""33""",48840,49020
2388,119006,302501,120,47700,10,"""33""",49020,49140
2388,302501,303001,60,47700,10,"""33""",49140,49200
2388,303001,302201,120,47700,10,"""33""",49200,49320
2388,302201,302001,60,47700,10,"""33""",49320,49380
2388,302001,302100,120,47700,10,"""33""",49380,49500
2388,405300,402800,60,48900,10,"""33""",48900,48960
2388,402800,405100,60,48900,10,"""33""",48960,49020
2388,405100,405902,60,48900,10,"""33""",49020,49080
2388,405902,406500,60,48900,10,"""33""",49080,49140
2388,406500,400601,120,48900,10,"""33""",49140,49260
2388,400601,404300,60,48900,10,"""33""",49260,49320
2388,404300,407401,60,48900,10,"""33""",49320,49380
2388,407401,404103,120,48900,10,"""33""",49380,49500
2388,404103,403104,120,48900,10,"""33""",49500,49620
2388,403104,112101,180,48900,10,"""33""",49620,49800
2388,112101,103001,180,48900,10,"""33""",49800,49980
2388,103001,106501,60,48900,10,"""33""",49980,50040
2388,106501,119006,180,48900,10,"""33""",50040,50220
2388,119006,302501,120,48900,10,"""33""",50220,50340
2388,302501,303001,60,48900,10,"""33""",50340,50400
2388,303001,302201,120,48900,10,"""33""",50400,50520
2388,302201,302001,60,48900,10,"""33""",50520,50580
2388,302001,302100,120,48900,10,"""33""",50580,50700
2388,405300,402800,60,50100,10,"""33""",50100,50160
2388,402800,405100,60,50100,10,"""33""",50160,50220
2388,405100,405902,60,50100,10,"""33""",50220,50280
2388,405902,406500,60,50100,10,"""33""",50280,50340
2388,406500,400601,120,50100,10,"""33""",50340,50460
2388,400601,404300,60,50100,10,"""33""",50460,50520
2388,404300,407401,60,50100,10,"""33""",50520,50580
2388,407401,404103,120,50100,10,"""33""",50580,50700
2388,404103,403104,120,50100,10,"""33""",50700,50820
2388,403104,112101,180,50100,10,"""33""",50820,51000
2388,112101,103001,180,50100,10,"""33""",51000,51180
2388,103001,106501,60,50100,10,"""33""",51180,51240
2388,106501,119006,180,50100,10,"""33""",51240,51420
2388,119006,302501,120,50100,10,"""33""",51420,51540
2388,302501,303001,60,50100,10,"""33""",51540,51600
2388,303001,302201,120,50100,10,"""33""",51600,51720
2388,302201,302001,60,50100,10,"""33""",51720,51780
2388,302001,302100,120,50100,10,"""33""",51780,51900
2388,405300,402800,60,51300,10,"""33""",51300,51360
2388,402800,405100,60,51300,10,"""33""",51360,51420
2388,405100,405902,60,51300,10,"""33""",51420,51480
2388,405902,406500,60,51300,10,"""33""",51480,51540
2388,406500,400601,120,51300,10,"""33""",51540,51660
2388,400601,404300,60,51300,10,"""33""",51660,51720
2388,404300,407401,60,51300,10,"""33""",51720,51780
2388,407401,404103,120,51300,10,"""33""",51780,51900
2388,404103,403104,120,51300,10,"""33""",51900,52020
2388,403104,112101,180,51300,10,"""33""",52020,52200
2388,112101,103001,180,51300,10,"""33""",52200,52380
2388,103001,106501,60,51300,10,"""33""",52380,52440
2388,106501,119006,180,51300,10,"""33""",52440,52620
2388,119006,302501,120,51300,10,"""33""",52620,52740
2388,302501,303001,60,51300,10,"""33""",52740,52800
2388,303001,302201,120,51300,10,"""33""",52800,52920
2388,302201,302001,60,51300,10,"""33""",52920,52980
2388,302001,302100,120,51300,10,"""33""",52980,53100
2388,405300,402800,60,52500,10,"""33""",52500,52560
2388,402800,405100,60,52500,10,"""33""",52560,52620
2388,405100,405902,60,52500,10,"""33""",52620,52680
2388,405902,406500,60,52500,10,"""33""",52680,52740
2388,406500,400601,120,52500,10,"""33""",52740,52860
2388,400601,404300,60,52500,10,"""33""",52860,52920
2388,404300,407401,60,52500,10,"""33""",52920,52980
2388,407401,404103,120,52500,10,"""33""",52980,53100
2388,404103,403104,120,52500,10,"""33""",53100,53220
2388,403104,112101,180,52500,10,"""33""",53220,53400
2388,112101,103001,180,52500,10,"""33""",53400,53580
2388,103001,106501,60,52500,10,"""33""",53580,53640
2388,106501,119006,180,52500,10,"""33""",53640,53820
2388,119006,302501,120,52500,10,"""33""",53820,53940
2388,302501,303001,60,52500,10,"""33""",53940,54000
2388,303001,302201,120,52500,10,"""33""",54000,54120
2388,302201,302001,60,52500,10,"""33""",54120,54180
2388,302001,302100,120,52500,10,"""33""",54180,54300
2388,405300,402800,60,53700,10,"""33""",53700,53760
2388,402800,405100,60,53700,10,"""33""",53760,53820
2388,405100,405902,60,53700,10,"""33""",53820,53880
2388,405902,406500,60,53700,10,"""33""",53880,53940
2388,406500,400601,120,53700,10,"""33""",53940,54060
2388,400601,404300,60,53700,10,"""33""",54060,54120
2388,404300,407401,60,53700,10,"""33""",54120,54180
2388,407401,404103,120,53700,10,"""33""",54180,54300
2388,404103,403104,120,53700,10,"""33""",54300,54420
2388,403104,112101,180,53700,10,"""33""",54420,54600
2388,112101,103001,180,53700,10,"""33""",54600,54780
2388,103001,106501,60,53700,10,"""33""",54780,54840
2388,106501,119006,180,53700,10,"""33""",54840,55020
2388,119006,302501,120,53700,10,"""33""",55020,55140
2388,302501,303001,60,53700,10,"""33""",55140,55200
2388,303001,302201,120,53700,10,"""33""",55200,55320
2388,302201,302001,60,53700,10,"""33""",55320,55380
2388,302001,302100,120,53700,10,"""33""",55380,55500
2388,405300,402800,60,54900,10,"""33""",54900,54960
2388,402800,405100,60,54900,10,"""33""",54960,55020
2388,405100,405902,60,54900,10,"""33""",55020,55080
2388,405902,406500,60,54900,10,"""33""",55080,55140
2388,406500,400601,120,54900,10,"""33""",55140,55260
2388,400601,404300,60,54900,10,"""33""",55260,55320
2388,404300,407401,60,54900,10,"""33""",55320,55380
2388,407401,404103,120,54900,10,"""33""",55380,55500
2388,404103,403104,120,54900,10,"""33""",55500,55620
2388,403104,112101,180,54900,10,"""33""",55620,55800
2388,112101,103001,180,54900,10,"""33""",55800,55980
2388,103001,106501,60,54900,10,"""33""",55980,56040
2388,106501,119006,180,54900,10,"""33""",56040,56220
2388,119006,302501,120,54900,10,"""33""",56220,56340
2388,302501,303001,60,54900,10,"""33""",56340,56400
2388,303001,302201,120,54900,10,"""33""",56400,56520
2388,302201,302001,60,54900,10,"""33""",56520,56580
2388,302001,302100,120,54900,10,"""33""",56580,56700
2388,405300,402800,60,56100,10,"""33""",56100,56160
2388,402800,405100,60,56100,10,"""33""",56160,56220
2388,405100,405902,60,56100,10,"""33""",56220,56280
2388,405902,406500,60,56100,10,"""33""",56280,56340
2388,406500,400601,120,56100,10,"""33""",56340,56460
2388,400601,404300,60,56100,10,"""33""",56460,56520
2388,404300,407401,60,56100,10,"""33""",56520,56580
2388,407401,404103,120,56100,10,"""33""",56580,56700
2388,404103,403104,120,56100,10,"""33""",56700,56820
2388,403104,112101,180,56100,10,"""33""",56820,57000
2388,112101,103001,180,56100,10,"""33""",57000,57180
2388,103001,106501,60,56100,10,"""33""",57180,57240
2388,106501,119006,180,56100,10,"""33""",57240,57420
2388,119006,302501,120,56100,10,"""33""",57420,57540
2388,302501,303001,60,56100,10,"""33""",57540,57600
2388,303001,302201,120,56100,10,"""33""",57600,57720
2388,302201,302001,60,56100,10,"""33""",57720,57780
2388,302001,302100,120,56100,10,"""33""",57780,57900
2388,405300,402800,60,57300,10,"""33""",57300,57360
2388,402800,405100,60,57300,10,"""33""",57360,57420
2388,405100,405902,60,57300,10,"""33""",57420,57480
2388,405902,406500,60,57300,10,"""33""",57480,57540
2388,406500,400601,120,57300,10,"""33""",57540,57660
2388,400601,404300,60,57300,10,"""33""",57660,57720
2388,404300,407401,60,57300,10,"""33""",57720,57780
2388,407401,404103,120,57300,10,"""33""",57780,57900
2388,404103,403104,120,57300,10,"""33""",57900,58020
2388,403104,112101,180,57300,10,"""33""",58020,58200
2388,112101,103001,180,57300,10,"""33""",58200,58380
2388,103001,106501,60,57300,10,"""33""",58380,58440
2388,106501,119006,180,57300,10,"""33""",58440,58620
2388,119006,302501,120,57300,10,"""33""",58620,58740
2388,302501,303001,60,57300,10,"""33""",58740,58800
2388,303001,302201,120,57300,10,"""33""",58800,58920
2388,302201,302001,60,57300,10,"""33""",58920,58980
2388,302001,302100,120,57300,10,"""33""",58980,59100
2388,405300,402800,60,58500,10,"""33""",58500,58560
2388,402800,405100,60,58500,10,"""33""",58560,58620
2388,405100,405902,60,58500,10,"""33""",58620,58680
2388,405902,406500,60,58500,10,"""33""",58680,58740
2388,406500,400601,120,58500,10,"""33""",58740,58860
2388,400601,404300,60,58500,10,"""33""",58860,58920
2388,404300,407401,60,58500,10,"""33""",58920,58980
2388,407401,404103,120,58500,10,"""33""",58980,59100
2388,404103,403104,120,58500,10,"""33""",59100,59220
2388,403104,112101,180,58500,10,"""33""",59220,59400
2388,112101,103001,180,58500,10,"""33""",59400,59580
2388,103001,106501,60,58500,10,"""33""",59580,59640
2388,106501,119006,180,58500,10,"""33""",59640,59820
2388,119006,302501,120,58500,10,"""33""",59820,59940
2388,302501,303001,60,58500,10,"""33""",59940,60000
2388,303001,302201,120,58500,10,"""33""",60000,60120
2388,302201,302001,60,58500,10,"""33""",60120,60180
2388,302001,302100,120,58500,10,"""33""",60180,60300
2388,405300,402800,60,59700,10,"""33""",59700,59760
2388,402800,405100,60,59700,10,"""33""",59760,59820
2388,405100,405902,60,59700,10,"""33""",59820,59880
2388,405902,406500,60,59700,10,"""33""",59880,59940
2388,406500,400601,120,59700,10,"""33""",59940,60060
2388,400601,404300,60,59700,10,"""33""",60060,60120
2388,404300,407401,60,59700,10,"""33""",60120,60180
2388,407401,404103,120,59700,10,"""33""",60180,60300
2388,404103,403104,120,59700,10,"""33""",60300,60420
2388,403104,112101,180,59700,10,"""33""",60420,60600
2388,112101,103001,180,59700,10,"""33""",60600,60780
2388,103001,106501,60,59700,10,"""33""",60780,60840
2388,106501,119006,180,59700,10,"""33""",60840,61020
2388,119006,302501,120,59700,10,"""33""",61020,61140
2388,302501,303001,60,59700,10,"""33""",61140,61200
2388,303001,302201,120,59700,10,"""33""",61200,61320
2388,302201,302001,60,59700,10,"""33""",61320,61380
2388,302001,302100,120,59700,10,"""33""",61380,61500
2388,405300,402800,60,60900,10,"""33""",60900,60960
2388,402800,405100,60,60900,10,"""33""",60960,61020
2388,405100,405902,60,60900,10,"""33""",61020,61080
2388,405902,406500,60,60900,10,"""33""",61080,61140
2388,406500,400601,120,60900,10,"""33""",61140,61260
2388,400601,404300,60,60900,10,"""33""",61260,61320
2388,404300,407401,60,60900,10,"""33""",61320,61380
2388,407401,404103,120,60900,10,"""33""",61380,61500
2388,404103,403104,120,60900,10,"""33""",61500,61620
2388,403104,112101,180,60900,10,"""33""",61620,61800
2388,112101,103001,180,60900,10,"""33""",61800,61980
2388,103001,106501,60,60900,10,"""33""",61980,62040
2388,106501,119006,180,60900,10,"""33""",62040,62220
2388,119006,302501,120,60900,10,"""33""",62220,62340
2388,302501,303001,60,60900,10,"""33""",62340,62400
2388,303001,302201,120,60900,10,"""33""",62400,62520
2388,302201,302001,60,60900,10,"""33""",62520,62580
2388,302001,302100,120,60900,10,"""33""",62580,62700
2388,405300,402800,60,62100,10,"""33""",62100,62160
2388,402800,405100,60,62100,10,"""33""",62160,62220
2388,405100,405902,60,62100,10,"""33""",62220,62280
2388,405902,406500,60,62100,10,"""33""",62280,62340
2388,406500,400601,120,62100,10,"""33""",62340,62460
2388,400601,404300,60,62100,10,"""33""",62460,62520
2388,404300,407401,60,62100,10,"""33""",62520,62580
2388,407401,404103,120,62100,10,"""33""",62580,62700
2388,404103,403104,120,62100,10,"""33""",62700,62820
2388,403104,112101,180,62100,10,"""33""",62820,63000
2388,112101,103001,180,62100,10,"""33""",63000,63180
2388,103001,106501,60,62100,10,"""33""",63180,63240
2388,106501,119006,180,62100,10,"""33""",63240,63420
2388,119006,302501,120,62100,10,"""33""",63420,63540
2388,302501,303001,60,62100,10,"""33""",63540,63600
2388,303001,302201,120,62100,10,"""33""",63600,63720
2388,302201,302001,60,62100,10,"""33""",63720,63780
2388,302001,302100,120,62100,10,"""33""",63780,63900
2388,405300,402800,60,63300,10,"""33""",63300,63360
2388,402800,405100,60,63300,10,"""33""",63360,63420
2388,405100,405902,60,63300,10,"""33""",63420,63480
2388,405902,406500,60,63300,10,"""33""",63480,63540
2388,406500,400601,120,63300,10,"""33""",63540,63660
2388,400601,404300,60,63300,10,"""33""",63660,63720
2388,404300,407401,60,63300,10,"""33""",63720,63780
2388,407401,404103,120,63300,10,"""33""",63780,63900
2388,404103,403104,120,63300,10,"""33""",63900,64020
2388,403104,112101,180,63300,10,"""33""",64020,64200
2388,112101,103001,180,63300,10,"""33""",64200,64380
2388,103001,106501,60,63300,10,"""33""",64380,64440
2388,106501,119006,180,63300,10,"""33""",64440,64620
2388,119006,302501,120,63300,10,"""33""",64620,64740
2388,302501,303001,60,63300,10,"""33""",64740,64800
2388,303001,302201,120,63300,10,"""33""",64800,64920
2388,302201,302001,60,63300,10,"""33""",64920,64980
2388,302001,302100,120,63300,10,"""33""",64980,65100
2388,405300,402800,60,64500,10,"""33""",64500,64560
2388,402800,405100,60,64500,10,"""33""",64560,64620
2388,405100,405902,60,64500,10,"""33""",64620,64680
2388,405902,406500,60,64500,10,"""33""",64680,64740
2388,406500,400601,120,64500,10,"""33""",64740,64860
2388,400601,404300,60,64500,10,"""33""",64860,64920
2388,404300,407401,60,64500,10,"""33""",64920,64980
2388,407401,404103,120,64500,10,"""33""",64980,65100
2388,404103,403104,120,64500,10,"""33""",65100,65220
2388,403104,112101,180,64500,10,"""33""",65220,65400
2388,112101,103001,180,64500,10,"""33""",65400,65580
2388,103001,106501,60,64500,10,"""33""",65580,65640
2388,106501,119006,180,64500,10,"""33""",65640,65820
2388,119006,302501,120,64500,10,"""33""",65820,65940
2388,302501,303001,60,64500,10,"""33""",65940,66000
2388,303001,302201,120,64500,10,"""33""",66000,66120
2388,302201,302001,60,64500,10,"""33""",66120,66180
2388,302001,302100,120,64500,10,"""33""",66180,66300
2388,405300,402800,60,65100,10,"""33""",65100,65160
2388,402800,405100,60,65100,10,"""33""",65160,65220
2388,405100,405902,60,65100,10,"""33""",65220,65280
2388,405902,406500,60,65100,10,"""33""",65280,65340
2388,406500,400601,120,65100,10,"""33""",65340,65460
2388,400601,404300,60,65100,10,"""33""",65460,65520
2388,404300,407401,60,65100,10,"""33""",65520,65580
2388,407401,404103,120,65100,10,"""33""",65580,65700
2388,404103,403104,120,65100,10,"""33""",65700,65820
2388,403104,112101,180,65100,10,"""33""",65820,66000
2388,112101,103001,180,65100,10,"""33""",66000,66180
2388,103001,106501,60,65100,10,"""33""",66180,66240
2388,106501,119006,180,65100,10,"""33""",66240,66420
2388,119006,302501,120,65100,10,"""33""",66420,66540
2388,302501,303001,60,65100,10,"""33""",66540,66600
2388,303001,302201,120,65100,10,"""33""",66600,66720
2388,302201,302001,60,65100,10,"""33""",66720,66780
2388,302001,302100,120,65100,10,"""33""",66780,66900
2388,405300,402800,60,66300,10,"""33""",66300,66360
2388,402800,405100,60,66300,10,"""33""",66360,66420
2388,405100,405902,60,66300,10,"""33""",66420,66480
2388,405902,406500,60,66300,10,"""33""",66480,66540
2388,406500,400601,120,66300,10,"""33""",66540,66660
2388,400601,404300,60,66300,10,"""33""",66660,66720
2388,404300,407401,60,66300,10,"""33""",66720,66780
2388,407401,404103,120,66300,10,"""33""",66780,66900
2388,404103,403104,120,66300,10,"""33""",66900,67020
2388,403104,112101,180,66300,10,"""33""",67020,67200
2388,112101,103001,180,66300,10,"""33""",67200,67380
2388,103001,106501,60,66300,10,"""33""",67380,67440
2388,106501,119006,180,66300,10,"""33""",67440,67620
2388,119006,302501,120,66300,10,"""33""",67620,67740
2388,302501,303001,60,66300,10,"""33""",67740,67800
2388,303001,302201,120,66300,10,"""33""",67800,67920
2388,302201,302001,60,66300,10,"""33""",67920,67980
2388,302001,302100,120,66300,10,"""33""",67980,68100
2388,405300,402800,60,67500,10,"""33""",67500,67560
2388,402800,405100,60,67500,10,"""33""",67560,67620
2388,405100,405902,60,67500,10,"""33""",67620,67680
2388,405902,406500,60,67500,10,"""33""",67680,67740
2388,406500,400601,120,67500,10,"""33""",67740,67860
2388,400601,404300,60,67500,10,"""33""",67860,67920
2388,404300,407401,60,67500,10,"""33""",67920,67980
2388,407401,404103,120,67500,10,"""33""",67980,68100
2388,404103,403104,120,67500,10,"""33""",68100,68220
2388,403104,112101,180,67500,10,"""33""",68220,68400
2388,112101,103001,180,67500,10,"""33""",68400,68580
2388,103001,106501,60,67500,10,"""33""",68580,68640
2388,106501,119006,180,67500,10,"""33""",68640,68820
2388,119006,302501,120,67500,10,"""33""",68820,68940
2388,302501,303001,60,67500,10,"""33""",68940,69000
2388,303001,302201,120,67500,10,"""33""",69000,69120
2388,302201,302001,60,67500,10,"""33""",69120,69180
2388,302001,302100,120,67500,10,"""33""",69180,69300
2389,112101,103001,180,26640,10,"""27""",26640,26820
2389,103001,106501,60,26640,10,"""27""",26820,26880
2389,106501,119006,180,26640,10,"""27""",26880,27060
2389,119006,302501,120,26640,10,"""27""",27060,27180
2389,302501,303001,60,26640,10,"""27""",27180,27240
2389,303001,302201,120,26640,10,"""27""",27240,27360
2389,302201,302001,60,26640,10,"""27""",27360,27420
2389,302001,302100,120,26640,10,"""27""",27420,27540
2390,103001,106501,60,27420,10,"""19""",27420,27480
2390,106501,119006,180,27420,10,"""19""",27480,27660
2390,119006,302501,120,27420,10,"""19""",27660,27780
2390,302501,303001,60,27420,10,"""19""",27780,27840
2390,303001,302201,120,27420,10,"""19""",27840,27960
2390,302201,302001,60,27420,10,"""19""",27960,28020
2390,302001,302100,120,27420,10,"""19""",28020,28140
2417,900,1000,60,27120,99,"""2""",27120,27180
2417,900,1000,60,28920,99,"""2""",28920,28980
2417,900,1000,60,30720,99,"""2""",30720,30780
2417,900,1000,60,32520,99,"""2""",32520,32580
2417,900,1000,60,34320,99,"""2""",34320,34380
2417,900,1000,60,36120,99,"""2""",36120,36180
2417,900,1000,60,37920,99,"""2""",37920,37980
2417,900,1000,60,39720,99,"""2""",39720,39780
2417,900,1000,60,41520,99,"""2""",41520,41580
2417,900,1000,60,43320,99,"""2""",43320,43380
2417,900,1000,60,45120,99,"""2""",45120,45180
2417,900,1000,60,46920,99,"""2""",46920,46980
2417,900,1000,60,48720,99,"""2""",48720,48780
2417,900,1000,60,50520,99,"""2""",50520,50580
2417,900,1000,60,52320,99,"""2""",52320,52380
2417,900,1000,60,54120,99,"""2""",54120,54180
2417,900,1000,60,55920,99,"""2""",55920,55980
2421,700,800,60,27000,99,"""1""",27000,27060
2421,800,900,60,27000,99,"""1""",27060,27120
2421,700,800,60,28800,99,"""1""",28800,28860
2421,800,900,60,28800,99,"""1""",28860,28920
2421,700,800,60,30600,99,"""1""",30600,30660
2421,800,900,60,30600,99,"""1""",30660,30720
2421,700,800,60,32400,99,"""1""",32400,32460
2421,800,900,60,32400,99,"""1""",32460,32520
2421,700,800,60,34200,99,"""1""",34200,34260
2421,800,900,60,34200,99,"""1""",34260,34320
2421,700,800,60,36000,99,"""1""",36000,36060
2421,800,900,60,36000,99,"""1""",36060,36120
2421,700,800,60,37800,99,"""1""",37800,37860
2421,800,900,60,37800,99,"""1""",37860,37920
2421,700,800,60,39600,99,"""1""",39600,39660
2421,800,900,60,39600,99,"""1""",39660,39720
2421,700,800,60,41400,99,"""1""",41400,41460
2421,800,900,60,41400,99,"""1""",41460,41520
2421,700,800,60,43200,99,"""1""",43200,43260
2421,800,900,60,43200,99,"""1""",43260,43320
2421,700,800,60,45000,99,"""1""",45000,45060
2421,800,900,60,45000,99,"""1""",45060,45120
2421,700,800,60,46800,99,"""1""",46800,46860
2421,800,900,60,46800,99,"""1""",46860,46920
2421,700,800,60,48600,99,"""1""",48600,48660
2421,800,900,60,48600,99,"""1""",48660,48720
2421,700,800,60,50400,99,"""1""",50400,50460
2421,800,900,60,50400,99,"""1""",50460,50520
2421,700,800,60,52200,99,"""1""",52200,52260
2421,800,900,60,52200,99,"""1""",52260,52320
2421,700,800,60,54000,99,"""1""",54000,54060
2421,800,900,60,54000,99,"""1""",54060,54120
2421,700,800,60,55800,99,"""1""",55800,55860
2421,800,900,60,55800,99,"""1""",55860,55920
2562,112107,403102,60,27660,61,"""5""",27660,27720
2562,403102,404102,120,27660,61,"""5""",27720,27840
2562,404102,407402,60,27660,61,"""5""",27840,27900
2562,407402,406602,120,27660,61,"""5""",27900,28020
2562,406602,402501,60,27660,61,"""5""",28020,28080
2562,402501,408004,120,27660,61,"""5""",28080,28200
2562,112107,403102,60,28260,61,"""5""",28260,28320
2562,403102,404102,120,28260,61,"""5""",28320,28440
2562,404102,407402,60,28260,61,"""5""",28440,28500
2562,407402,406602,120,28260,61,"""5""",28500,28620
2562,406602,402501,60,28260,61,"""5""",28620,28680
2562,402501,408004,120,28260,61,"""5""",28680,28800
2562,112107,403102,60,28860,61,"""5""",28860,28920
2562,403102,404102,120,28860,61,"""5""",28920,29040
2562,404102,407402,60,28860,61,"""5""",29040,29100
2562,407402,406602,120,28860,61,"""5""",29100,29220
2562,406602,402501,60,28860,61,"""5""",29220,29280
2562,402501,408004,120,28860,61,"""5""",29280,29400
2562,112107,403102,60,29460,61,"""5""",29460,29520
2562,403102,404102,120,29460,61,"""5""",29520,29640
2562,404102,407402,60,29460,61,"""5""",29640,29700
2562,407402,406602,120,29460,61,"""5""",29700,29820
2562,406602,402501,60,29460,61,"""5""",29820,29880
2562,402501,408004,120,29460,61,"""5""",29880,30000
2562,112107,403102,60,30060,61,"""5""",30060,30120
2562,403102,404102,120,30060,61,"""5""",30120,30240
2562,404102,407402,60,30060,61,"""5""",30240,30300
2562,407402,406602,120,30060,61,"""5""",30300,30420
2562,406602,402501,60,30060,61,"""5""",30420,30480
2562,402501,408004,120,30060,61,"""5""",30480,30600
2562,112107,403102,60,30660,61,"""5""",30660,30720
2562,403102,404102,120,30660,61,"""5""",30720,30840
2562,404102,407402,60,30660,61,"""5""",30840,30900
2562,407402,406602,120,30660,61,"""5""",30900,31020
2562,406602,402501,60,30660,61,"""5""",31020,31080
2562,402501,408004,120,30660,61,"""5""",31080,31200
2562,112107,403102,60,31260,61,"""5""",31260,31320
2562,403102,404102,120,31260,61,"""5""",31320,31440
2562,404102,407402,60,31260,61,"""5""",31440,31500
2562,407402,406602,120,31260,61,"""5""",31500,31620
2562,406602,402501,60,31260,61,"""5""",31620,31680
2562,402501,408004,120,31260,61,"""5""",31680,31800
2562,112107,403102,60,31860,61,"""5""",31860,31920
2562,403102,404102,120,31860,61,"""5""",31920,32040
2562,404102,407402,60,31860,61,"""5""",32040,32100
2562,407402,406602,120,31860,61,"""5""",32100,32220
2562,406602,402501,60,31860,61,"""5""",32220,32280
2562,402501,408004,120,31860,61,"""5""",32280,32400
2562,112107,403102,60,32460,61,"""5""",32460,32520
2562,403102,404102,120,32460,61,"""5""",32520,32640
2562,404102,407402,60,32460,61,"""5""",32640,32700
2562,407402,406602,120,32460,61,"""5""",32700,32820
2562,406602,402501,60,32460,61,"""5""",32820,32880
2562,402501,408004,120,32460,61,"""5""",32880,33000
2562,112107,403102,60,33060,61,"""5""",33060,33120
2562,403102,404102,120,33060,61,"""5""",33120,33240
2562,404102,407402,60,33060,61,"""5""",33240,33300
2562,407402,406602,120,33060,61,"""5""",33300,33420
2562,406602,402501,60,33060,61,"""5""",33420,33480
2562,402501,408004,120,33060,61,"""5""",33480,33600
2562,112107,403102,60,33660,61,"""5""",33660,33720
2562,403102,404102,120,33660,61,"""5""",33720,33840
2562,404102,407402,60,33660,61,"""5""",33840,33900
2562,407402,406602,120,33660,61,"""5""",33900,34020
2562,406602,402501,60,33660,61,"""5""",34020,34080
2562,402501,408004,120,33660,61,"""5""",34080,34200
2562,112107,403102,60,34260,61,"""5""",34260,34320
2562,403102,404102,120,34260,61,"""5""",34320,34440
2562,404102,407402,60,34260,61,"""5""",34440,34500
2562,407402,406602,120,34260,61,"""5""",34500,34620
2562,406602,402501,60,34260,61,"""5""",34620,34680
2562,402501,408004,120,34260,61,"""5""",34680,34800
2562,112107,403102,60,34860,61,"""5""",34860,34920
2562,403102,404102,120,34860,61,"""5""",34920,35040
2562,404102,407402,60,34860,61,"""5""",35040,35100
2562,407402,406602,120,34860,61,"""5""",35100,35220
2562,406602,402501,60,34860,61,"""5""",35220,35280
2562,402501,408004,120,34860,61,"""5""",35280,35400
2562,112107,403102,60,35460,61,"""5""",35460,35520
2562,403102,404102,120,35460,61,"""5""",35520,35640
2562,404102,407402,60,35460,61,"""5""",35640,35700
2562,407402,406602,120,35460,61,"""5""",35700,35820
2562,406602,402501,60,35460,61,"""5""",35820,35880
2562,402501,408004,120,35460,61,"""5""",35880,36000
2562,112107,403102,60,36060,61,"""5""",36060,36120
2562,403102,404102,120,36060,61,"""5""",36120,36240
2562,404102,407402,60,36060,61,"""5""",36240,36300
2562,407402,406602,120,36060,61,"""5""",36300,36420
2562,406602,402501,60,36060,61,"""5""",36420,36480
2562,402501,408004,120,36060,61,"""5""",36480,36600
2562,112107,403102,60,36660,61,"""5""",36660,36720
2562,403102,404102,120,36660,61,"""5""",36720,36840
2562,404102,407402,60,36660,61,"""5""",36840,36900
2562,407402,406602,120,36660,61,"""5""",36900,37020
2562,406602,402501,60,36660,61,"""5""",37020,37080
2562,402501,408004,120,36660,61,"""5""",37080,37200
2562,112107,403102,60,37260,61,"""5""",37260,37320
2562,403102,404102,120,37260,61,"""5""",37320,37440
2562,404102,407402,60,37260,61,"""5""",37440,37500
2562,407402,406602,120,37260,61,"""5""",37500,37620
2562,406602,402501,60,37260,61,"""5""",37620,37680
2562,402501,408004,120,37260,61,"""5""",37680,37800
2562,112107,403102,60,37860,61,"""5""",37860,37920
2562,403102,404102,120,37860,61,"""5""",37920,38040
2562,404102,407402,60,37860,61,"""5""",38040,38100
2562,407402,406602,120,37860,61,"""5""",38100,38220
2562,406602,402501,60,37860,61,"""5""",38220,38280
2562,402501,408004,120,37860,61,"""5""",38280,38400
2562,112107,403102,60,38460,61,"""5""",38460,38520
2562,403102,404102,120,38460,61,"""5""",38520,38640
2562,404102,407402,60,38460,61,"""5""",38640,38700
2562,407402,406602,120,38460,61,"""5""",38700,38820
2562,406602,402501,60,38460,61,"""5""",38820,38880
2562,402501,408004,120,38460,61,"""5""",38880,39000
2562,112107,403102,60,39060,61,"""5""",39060,39120
2562,403102,404102,120,39060,61,"""5""",39120,39240
2562,404102,407402,60,39060,61,"""5""",39240,39300
2562,407402,406602,120,39060,61,"""5""",39300,39420
2562,406602,402501,60,39060,61,"""5""",39420,39480
2562,402501,408004,120,39060,61,"""5""",39480,39600
2562,112107,403102,60,39660,61,"""5""",39660,39720
2562,403102,404102,120,39660,61,"""5""",39720,39840
2562,404102,407402,60,39660,61,"""5""",39840,39900
2562,407402,406602,120,39660,61,"""5""",39900,40020
2562,406602,402501,60,39660,61,"""5""",40020,40080
2562,402501,408004,120,39660,61,"""5""",40080,40200
2562,112107,403102,60,40260,61,"""5""",40260,40320
2562,403102,404102,120,40260,61,"""5""",40320,40440
2562,404102,407402,60,40260,61,"""5""",40440,40500
2562,407402,406602,120,40260,61,"""5""",40500,40620
2562,406602,402501,60,40260,61,"""5""",40620,40680
2562,402501,408004,120,40260,61,"""5""",40680,40800
2562,112107,403102,60,40860,61,"""5""",40860,40920
2562,403102,404102,120,40860,61,"""5""",40920,41040
2562,404102,407402,60,40860,61,"""5""",41040,41100
2562,407402,406602,120,40860,61,"""5""",41100,41220
2562,406602,402501,60,40860,61,"""5""",41220,41280
2562,402501,408004,120,40860,61,"""5""",41280,41400
2562,112107,403102,60,41460,61,"""5""",41460,41520
2562,403102,404102,120,41460,61,"""5""",41520,41640
2562,404102,407402,60,41460,61,"""5""",41640,41700
2562,407402,406602,120,41460,61,"""5""",41700,41820
2562,406602,402501,60,41460,61,"""5""",41820,41880
2562,402501,408004,120,41460,61,"""5""",41880,42000
2562,112107,403102,60,42060,61,"""5""",42060,42120
2562,403102,404102,120,42060,61,"""5""",42120,42240
2562,404102,407402,60,42060,61,"""5""",42240,42300
2562,407402,406602,120,42060,61,"""5""",42300,42420
2562,406602,402501,60,42060,61,"""5""",42420,42480
2562,402501,408004,120,42060,61,"""5""",42480,42600
2562,112107,403102,60,42660,61,"""5""",42660,42720
2562,403102,404102,120,42660,61,"""5""",42720,42840
2562,404102,407402,60,42660,61,"""5""",42840,42900
2562,407402,406602,120,42660,61,"""5""",42900,43020
2562,406602,402501,60,42660,61,"""5""",43020,43080
2562,402501,408004,120,42660,61,"""5""",43080,43200
2562,112107,403102,60,43260,61,"""5""",43260,43320
2562,403102,404102,120,43260,61,"""5""",43320,43440
2562,404102,407402,60,43260,61,"""5""",43440,43500
2562,407402,406602,120,43260,61,"""5""",43500,43620
2562,406602,402501,60,43260,61,"""5""",43620,43680
2562,402501,408004,120,43260,61,"""5""",43680,43800
2562,112107,403102,60,43860,61,"""5""",43860,43920
2562,403102,404102,120,43860,61,"""5""",43920,44040
2562,404102,407402,60,43860,61,"""5""",44040,44100
2562,407402,406602,120,43860,61,"""5""",44100,44220
2562,406602,402501,60,43860,61,"""5""",44220,44280
2562,402501,408004,120,43860,61,"""5""",44280,44400
2562,112107,403102,60,44460,61,"""5""",44460,44520
2562,403102,404102,120,44460,61,"""5""",44520,44640
2562,404102,407402,60,44460,61,"""5""",44640,44700
2562,407402,406602,120,44460,61,"""5""",44700,44820
2562,406602,402501,60,44460,61,"""5""",44820,44880
2562,402501,408004,120,44460,61,"""5""",44880,45000
2562,112107,403102,60,45060,61,"""5""",45060,45120
2562,403102,404102,120,45060,61,"""5""",45120,45240
2562,404102,407402,60,45060,61,"""5""",45240,45300
2562,407402,406602,120,45060,61,"""5""",45300,45420
2562,406602,402501,60,45060,61,"""5""",45420,45480
2562,402501,408004,120,45060,61,"""5""",45480,45600
2562,112107,403102,60,45660,61,"""5""",45660,45720
2562,403102,404102,120,45660,61,"""5""",45720,45840
2562,404102,407402,60,45660,61,"""5""",45840,45900
2562,407402,406602,120,45660,61,"""5""",45900,46020
2562,406602,402501,60,45660,61,"""5""",46020,46080
2562,402501,408004,120,45660,61,"""5""",46080,46200
2562,112107,403102,60,46260,61,"""5""",46260,46320
2562,403102,404102,120,46260,61,"""5""",46320,46440
2562,404102,407402,60,46260,61,"""5""",46440,46500
2562,407402,406602,120,46260,61,"""5""",46500,46620
2562,406602,402501,60,46260,61,"""5""",46620,46680
2562,402501,408004,120,46260,61,"""5""",46680,46800
2562,112107,403102,60,46860,61,"""5""",46860,46920
2562,403102,404102,120,46860,61,"""5""",46920,47040
2562,404102,407402,60,46860,61,"""5""",47040,47100
2562,407402,406602,120,46860,61,"""5""",47100,47220
2562,406602,402501,60,46860,61,"""5""",47220,47280
2562,402501,408004,120,46860,61,"""5""",47280,47400
2562,112107,403102,60,47460,61,"""5""",47460,47520
2562,403102,404102,120,47460,61,"""5""",47520,47640
2562,404102,407402,60,47460,61,"""5""",47640,47700
2562,407402,406602,120,47460,61,"""5""",47700,47820
2562,406602,402501,60,47460,61,"""5""",47820,47880
2562,402501,408004,120,47460,61,"""5""",47880,48000
2562,112107,403102,60,48060,61,"""5""",48060,48120
2562,403102,404102,120,48060,61,"""5""",48120,48240
2562,404102,407402,60,48060,61,"""5""",48240,48300
2562,407402,406602,120,48060,61,"""5""",48300,48420
2562,406602,402501,60,48060,61,"""5""",48420,48480
2562,402501,408004,120,48060,61,"""5""",48480,48600
2562,112107,403102,60,48660,61,"""5""",48660,48720
2562,403102,404102,120,48660,61,"""5""",48720,48840
2562,404102,407402,60,48660,61,"""5""",48840,48900
2562,407402,406602,120,48660,61,"""5""",48900,49020
2562,406602,402501,60,48660,61,"""5""",49020,49080
2562,402501,408004,120,48660,61,"""5""",49080,49200
2562,112107,403102,60,49260,61,"""5""",49260,49320
2562,403102,404102,120,49260,61,"""5""",49320,49440
2562,404102,407402,60,49260,61,"""5""",49440,49500
2562,407402,406602,120,49260,61,"""5""",49500,49620
2562,406602,402501,60,49260,61,"""5""",49620,49680
2562,402501,408004,120,49260,61,"""5""",49680,49800
2562,112107,403102,60,49860,61,"""5""",49860,49920
2562,403102,404102,120,49860,61,"""5""",49920,50040
2562,404102,407402,60,49860,61,"""5""",50040,50100
2562,407402,406602,120,49860,61,"""5""",50100,50220
2562,406602,402501,60,49860,61,"""5""",50220,50280
2562,402501,408004,120,49860,61,"""5""",50280,50400
2562,112107,403102,60,50460,61,"""5""",50460,50520
2562,403102,404102,120,50460,61,"""5""",50520,50640
2562,404102,407402,60,50460,61,"""5""",50640,50700
2562,407402,406602,120,50460,61,"""5""",50700,50820
2562,406602,402501,60,50460,61,"""5""",50820,50880
2562,402501,408004,120,50460,61,"""5""",50880,51000
2562,112107,403102,60,51060,61,"""5""",51060,51120
2562,403102,404102,120,51060,61,"""5""",51120,51240
2562,404102,407402,60,51060,61,"""5""",51240,51300
2562,407402,406602,120,51060,61,"""5""",51300,51420
2562,406602,402501,60,51060,61,"""5""",51420,51480
2562,402501,408004,120,51060,61,"""5""",51480,51600
2562,112107,403102,60,51660,61,"""5""",51660,51720
2562,403102,404102,120,51660,61,"""5""",51720,51840
2562,404102,407402,60,51660,61,"""5""",51840,51900
2562,407402,406602,120,51660,61,"""5""",51900,52020
2562,406602,402501,60,51660,61,"""5""",52020,52080
2562,402501,408004,120,51660,61,"""5""",52080,52200
2562,112107,403102,60,52260,61,"""5""",52260,52320
2562,403102,404102,120,52260,61,"""5""",52320,52440
2562,404102,407402,60,52260,61,"""5""",52440,52500
2562,407402,406602,120,52260,61,"""5""",52500,52620
2562,406602,402501,60,52260,61,"""5""",52620,52680
2562,402501,408004,120,52260,61,"""5""",52680,52800
2562,112107,403102,60,52860,61,"""5""",52860,52920
2562,403102,404102,120,52860,61,"""5""",52920,53040
2562,404102,407402,60,52860,61,"""5""",53040,53100
2562,407402,406602,120,52860,61,"""5""",53100,53220
2562,406602,402501,60,52860,61,"""5""",53220,53280
2562,402501,408004,120,52860,61,"""5""",53280,53400
2562,112107,403102,60,53460,61,"""5""",53460,53520
2562,403102,404102,120,53460,61,"""5""",53520,53640
2562,404102,407402,60,53460,61,"""5""",53640,53700
2562,407402,406602,120,53460,61,"""5""",53700,53820
2562,406602,402501,60,53460,61,"""5""",53820,53880
2562,402501,408004,120,53460,61,"""5""",53880,54000
2562,112107,403102,60,54060,61,"""5""",54060,54120
2562,403102,404102,120,54060,61,"""5""",54120,54240
2562,404102,407402,60,54060,61,"""5""",54240,54300
2562,407402,406602,120,54060,61,"""5""",54300,54420
2562,406602,402501,60,54060,61,"""5""",54420,54480
2562,402501,408004,120,54060,61,"""5""",54480,54600
2562,112107,403102,60,54660,61,"""5""",54660,54720
2562,403102,404102,120,54660,61,"""5""",54720,54840
2562,404102,407402,60,54660,61,"""5""",54840,54900
2562,407402,406602,120,54660,61,"""5""",54900,55020
2562,406602,402501,60,54660,61,"""5""",55020,55080
2562,402501,408004,120,54660,61,"""5""",55080,55200
2562,112107,403102,60,55260,61,"""5""",55260,55320
2562,403102,404102,120,55260,61,"""5""",55320,55440
2562,404102,407402,60,55260,61,"""5""",55440,55500
2562,407402,406602,120,55260,61,"""5""",55500,55620
2562,406602,402501,60,55260,61,"""5""",55620,55680
2562,402501,408004,120,55260,61,"""5""",55680,55800
2562,112107,403102,60,55860,61,"""5""",55860,55920
2562,403102,404102,120,55860,61,"""5""",55920,56040
2562,404102,407402,60,55860,61,"""5""",56040,56100
2562,407402,406602,120,55860,61,"""5""",56100,56220
2562,406602,402501,60,55860,61,"""5""",56220,56280
2562,402501,408004,120,55860,61,"""5""",56280,56400
2562,112107,403102,60,56460,61,"""5""",56460,56520
2562,403102,404102,120,56460,61,"""5""",56520,56640
2562,404102,407402,60,56460,61,"""5""",56640,56700
2562,407402,406602,120,56460,61,"""5""",56700,56820
2562,406602,402501,60,56460,61,"""5""",56820,56880
2562,402501,408004,120,56460,61,"""5""",56880,57000
2562,112107,403102,60,57060,61,"""5""",57060,57120
2562,403102,404102,120,57060,61,"""5""",57120,57240
2562,404102,407402,60,57060,61,"""5""",57240,57300
2562,407402,406602,120,57060,61,"""5""",57300,57420
2562,406602,402501,60,57060,61,"""5""",57420,57480
2562,402501,408004,120,57060,61,"""5""",57480,57600
2562,112107,403102,60,57660,61,"""5""",57660,57720
2562,403102,404102,120,57660,61,"""5""",57720,57840
2562,404102,407402,60,57660,61,"""5""",57840,57900
2562,407402,406602,120,57660,61,"""5""",57900,58020
2562,406602,402501,60,57660,61,"""5""",58020,58080
2562,402501,408004,120,57660,61,"""5""",58080,58200
2562,112107,403102,60,58260,61,"""5""",58260,58320
2562,403102,404102,120,58260,61,"""5""",58320,58440
2562,404102,407402,60,58260,61,"""5""",58440,58500
2562,407402,406602,120,58260,61,"""5""",58500,58620
2562,406602,402501,60,58260,61,"""5""",58620,58680
2562,402501,408004,120,58260,61,"""5""",58680,58800
2562,112107,403102,60,58860,61,"""5""",58860,58920
2562,403102,404102,120,58860,61,"""5""",58920,59040
2562,404102,407402,60,58860,61,"""5""",59040,59100
2562,407402,406602,120,58860,61,"""5""",59100,59220
2562,406602,402501,60,58860,61,"""5""",59220,59280
2562,402501,408004,120,58860,61,"""5""",59280,59400
2562,112107,403102,60,59460,61,"""5""",59460,59520
2562,403102,404102,120,59460,61,"""5""",59520,59640
2562,404102,407402,60,59460,61,"""5""",59640,59700
2562,407402,406602,120,59460,61,"""5""",59700,59820
2562,406602,402501,60,59460,61,"""5""",59820,59880
2562,402501,408004,120,59460,61,"""5""",59880,60000
2562,112107,403102,60,60060,61,"""5""",60060,60120
2562,403102,404102,120,60060,61,"""5""",60120,60240
2562,404102,407402,60,60060,61,"""5""",60240,60300
2562,407402,406602,120,60060,61,"""5""",60300,60420
2562,406602,402501,60,60060,61,"""5""",60420,60480
2562,402501,408004,120,60060,61,"""5""",60480,60600
2562,112107,403102,60,60660,61,"""5""",60660,60720
2562,403102,404102,120,60660,61,"""5""",60720,60840
2562,404102,407402,60,60660,61,"""5""",60840,60900
2562,407402,406602,120,60660,61,"""5""",60900,61020
2562,406602,402501,60,60660,61,"""5""",61020,61080
2562,402501,408004,120,60660,61,"""5""",61080,61200
2562,112107,403102,60,61260,61,"""5""",61260,61320
2562,403102,404102,120,61260,61,"""5""",61320,61440
2562,404102,407402,60,61260,61,"""5""",61440,61500
2562,407402,406602,120,61260,61,"""5""",61500,61620
2562,406602,402501,60,61260,61,"""5""",61620,61680
2562,402501,408004,120,61260,61,"""5""",61680,61800
2562,112107,403102,60,61860,61,"""5""",61860,61920
2562,403102,404102,120,61860,61,"""5""",61920,62040
2562,404102,407402,60,61860,61,"""5""",62040,62100
2562,407402,406602,120,61860,61,"""5""",62100,62220
2562,406602,402501,60,61860,61,"""5""",62220,62280
2562,402501,408004,120,61860,61,"""5""",62280,62400
2562,112107,403102,60,62460,61,"""5""",62460,62520
2562,403102,404102,120,62460,61,"""5""",62520,62640
2562,404102,407402,60,62460,61,"""5""",62640,62700
2562,407402,406602,120,62460,61,"""5""",62700,62820
2562,406602,402501,60,62460,61,"""5""",62820,62880
2562,402501,408004,120,62460,61,"""5""",62880,63000
2562,112107,403102,60,63060,61,"""5""",63060,63120
2562,403102,404102,120,63060,61,"""5""",63120,63240
2562,404102,407402,60,63060,61,"""5""",63240,63300
2562,407402,406602,120,63060,61,"""5""",63300,63420
2562,406602,402501,60,63060,61,"""5""",63420,63480
2562,402501,408004,120,63060,61,"""5""",63480,63600
2562,112107,403102,60,63660,61,"""5""",63660,63720
2562,403102,404102,120,63660,61,"""5""",63720,63840
2562,404102,407402,60,63660,61,"""5""",63840,63900
2562,407402,406602,120,63660,61,"""5""",63900,64020
2562,406602,402501,60,63660,61,"""5""",64020,64080
2562,402501,408004,120,63660,61,"""5""",64080,64200
2562,112107,403102,60,64260,61,"""5""",64260,64320
2562,403102,404102,120,64260,61,"""5""",64320,64440
2562,404102,407402,60,64260,61,"""5""",64440,64500
2562,407402,406602,120,64260,61,"""5""",64500,64620
2562,406602,402501,60,64260,61,"""5""",64620,64680
2562,402501,408004,120,64260,61,"""5""",64680,64800
2562,112107,403102,60,64860,61,"""5""",64860,64920
2562,403102,404102,120,64860,61,"""5""",64920,65040
2562,404102,407402,60,64860,61,"""5""",65040,65100
2562,407402,406602,120,64860,61,"""5""",65100,65220
2562,406602,402501,60,64860,61,"""5""",65220,65280
2562,402501,408004,120,64860,61,"""5""",65280,65400
2562,112107,403102,60,65460,61,"""5""",65460,65520
2562,403102,404102,120,65460,61,"""5""",65520,65640
2562,404102,407402,60,65460,61,"""5""",65640,65700
2562,407402,406602,120,65460,61,"""5""",65700,65820
2562,406602,402501,60,65460,61,"""5""",65820,65880
2562,402501,408004,120,65460,61,"""5""",65880,66000
2562,112107,403102,60,66060,61,"""5""",66060,66120
2562,403102,404102,120,66060,61,"""5""",66120,66240
2562,404102,407402,60,66060,61,"""5""",66240,66300
2562,407402,406602,120,66060,61,"""5""",66300,66420
2562,406602,402501,60,66060,61,"""5""",66420,66480
2562,402501,408004,120,66060,61,"""5""",66480,66600
2562,112107,403102,60,66660,61,"""5""",66660,66720
2562,403102,404102,120,66660,61,"""5""",66720,66840
2562,404102,407402,60,66660,61,"""5""",66840,66900
2562,407402,406602,120,66660,61,"""5""",66900,67020
2562,406602,402501,60,66660,61,"""5""",67020,67080
2562,402501,408004,120,66660,61,"""5""",67080,67200
2562,112107,403102,60,67860,61,"""5""",67860,67920
2562,403102,404102,120,67860,61,"""5""",67920,68040
2562,404102,407402,60,67860,61,"""5""",68040,68100
2562,407402,406602,120,67860,61,"""5""",68100,68220
2562,406602,402501,60,67860,61,"""5""",68220,68280
2562,402501,408004,120,67860,61,"""5""",68280,68400
2562,112107,403102,60,69060,61,"""5""",69060,69120
2562,403102,404102,120,69060,61,"""5""",69120,69240
2562,404102,407402,60,69060,61,"""5""",69240,69300
2562,407402,406602,120,69060,61,"""5""",69300,69420
2562,406602,402501,60,69060,61,"""5""",69420,69480
2562,402501,408004,120,69060,61,"""5""",69480,69600
2562,112107,403102,60,70260,61,"""5""",70260,70320
2562,403102,404102,120,70260,61,"""5""",70320,70440
2562,404102,407402,60,70260,61,"""5""",70440,70500
2562,407402,406602,120,70260,61,"""5""",70500,70620
2562,406602,402501,60,70260,61,"""5""",70620,70680
2562,402501,408004,120,70260,61,"""5""",70680,70800
2562,112107,403102,60,71460,61,"""5""",71460,71520
2562,403102,404102,120,71460,61,"""5""",71520,71640
2562,404102,407402,60,71460,61,"""5""",71640,71700
2562,407402,406602,120,71460,61,"""5""",71700,71820
2562,406602,402501,60,71460,61,"""5""",71820,71880
2562,402501,408004,120,71460,61,"""5""",71880,72000
2562,112107,403102,60,72660,61,"""5""",72660,72720
2562,403102,404102,120,72660,61,"""5""",72720,72840
2562,404102,407402,60,72660,61,"""5""",72840,72900
2562,407402,406602,120,72660,61,"""5""",72900,73020
2562,406602,402501,60,72660,61,"""5""",73020,73080
2562,402501,408004,120,72660,61,"""5""",73080,73200
2562,112107,403102,60,73860,61,"""5""",73860,73920
2562,403102,404102,120,73860,61,"""5""",73920,74040
2562,404102,407402,60,73860,61,"""5""",74040,74100
2562,407402,406602,120,73860,61,"""5""",74100,74220
2562,406602,402501,60,73860,61,"""5""",74220,74280
2562,402501,408004,120,73860,61,"""5""",74280,74400
2564,408002,402502,60,28080,61,"""6""",28080,28140
2564,402502,407401,60,28080,61,"""6""",28140,28200
2564,407401,404103,120,28080,61,"""6""",28200,28320
2564,404103,403104,120,28080,61,"""6""",28320,28440
2564,403104,112103,120,28080,61,"""6""",28440,28560
2564,408002,402502,60,28680,61,"""6""",28680,28740
2564,402502,407401,60,28680,61,"""6""",28740,28800
2564,407401,404103,120,28680,61,"""6""",28800,28920
2564,404103,403104,120,28680,61,"""6""",28920,29040
2564,403104,112103,120,28680,61,"""6""",29040,29160
2564,408002,402502,60,29280,61,"""6""",29280,29340
2564,402502,407401,60,29280,61,"""6""",29340,29400
2564,407401,404103,120,29280,61,"""6""",29400,29520
2564,404103,403104,120,29280,61,"""6""",29520,29640
2564,403104,112103,120,29280,61,"""6""",29640,29760
2564,408002,402502,60,29880,61,"""6""",29880,29940
2564,402502,407401,60,29880,61,"""6""",29940,30000
2564,407401,404103,120,29880,61,"""6""",30000,30120
2564,404103,403104,120,29880,61,"""6""",30120,30240
2564,403104,112103,120,29880,61,"""6""",30240,30360
2564,408002,402502,60,30480,61,"""6""",30480,30540
2564,402502,407401,60,30480,61,"""6""",30540,30600
2564,407401,404103,120,30480,61,"""6""",30600,30720
2564,404103,403104,120,30480,61,"""6""",30720,30840
2564,403104,112103,120,30480,61,"""6""",30840,30960
2564,408002,402502,60,31080,61,"""6""",31080,31140
2564,402502,407401,60,31080,61,"""6""",31140,31200
2564,407401,404103,120,31080,61,"""6""",31200,31320
2564,404103,403104,120,31080,61,"""6""",31320,31440
2564,403104,112103,120,31080,61,"""6""",31440,31560
2564,408002,402502,60,31680,61,"""6""",31680,31740
2564,402502,407401,60,31680,61,"""6""",31740,31800
2564,407401,404103,120,31680,61,"""6""",31800,31920
2564,404103,403104,120,31680,61,"""6""",31920,32040
2564,403104,112103,120,31680,61,"""6""",32040,32160
2564,408002,402502,60,32280,61,"""6""",32280,32340
2564,402502,407401,60,32280,61,"""6""",32340,32400
2564,407401,404103,120,32280,61,"""6""",32400,32520
2564,404103,403104,120,32280,61,"""6""",32520,32640
2564,403104,112103,120,32280,61,"""6""",32640,32760
2564,408002,402502,60,32880,61,"""6""",32880,32940
2564,402502,407401,60,32880,61,"""6""",32940,33000
2564,407401,404103,120,32880,61,"""6""",33000,33120
2564,404103,403104,120,32880,61,"""6""",33120,33240
2564,403104,112103,120,32880,61,"""6""",33240,33360
2564,408002,402502,60,33480,61,"""6""",33480,33540
2564,402502,407401,60,33480,61,"""6""",33540,33600
2564,407401,404103,120,33480,61,"""6""",33600,33720
2564,404103,403104,120,33480,61,"""6""",33720,33840
2564,403104,112103,120,33480,61,"""6""",33840,33960
2564,408002,402502,60,34080,61,"""6""",34080,34140
2564,402502,407401,60,34080,61,"""6""",34140,34200
2564,407401,404103,120,34080,61,"""6""",34200,34320
2564,404103,403104,120,34080,61,"""6""",34320,34440
2564,403104,112103,120,34080,61,"""6""",34440,34560
2564,408002,402502,60,34680,61,"""6""",34680,34740
2564,402502,407401,60,34680,61,"""6""",34740,34800
2564,407401,404103,120,34680,61,"""6""",34800,34920
2564,404103,403104,120,34680,61,"""6""",34920,35040
2564,403104,112103,120,34680,61,"""6""",35040,35160
2564,408002,402502,60,35280,61,"""6""",35280,35340
2564,402502,407401,60,35280,61,"""6""",35340,35400
2564,407401,404103,120,35280,61,"""6""",35400,35520
2564,404103,403104,120,35280,61,"""6""",35520,35640
2564,403104,112103,120,35280,61,"""6""",35640,35760
2564,408002,402502,60,35880,61,"""6""",35880,35940
2564,402502,407401,60,35880,61,"""6""",35940,36000
2564,407401,404103,120,35880,61,"""6""",36000,36120
2564,404103,403104,120,35880,61,"""6""",36120,36240
2564,403104,112103,120,35880,61,"""6""",36240,36360
2564,408002,402502,60,36480,61,"""6""",36480,36540
2564,402502,407401,60,36480,61,"""6""",36540,36600
2564,407401,404103,120,36480,61,"""6""",36600,36720
2564,404103,403104,120,36480,61,"""6""",36720,36840
2564,403104,112103,120,36480,61,"""6""",36840,36960
2564,408002,402502,60,37080,61,"""6""",37080,37140
2564,402502,407401,60,37080,61,"""6""",37140,37200
2564,407401,404103,120,37080,61,"""6""",37200,37320
2564,404103,403104,120,37080,61,"""6""",37320,37440
2564,403104,112103,120,37080,61,"""6""",37440,37560
2564,408002,402502,60,37680,61,"""6""",37680,37740
2564,402502,407401,60,37680,61,"""6""",37740,37800
2564,407401,404103,120,37680,61,"""6""",37800,37920
2564,404103,403104,120,37680,61,"""6""",37920,38040
2564,403104,112103,120,37680,61,"""6""",38040,38160
2564,408002,402502,60,38280,61,"""6""",38280,38340
2564,402502,407401,60,38280,61,"""6""",38340,38400
2564,407401,404103,120,38280,61,"""6""",38400,38520
2564,404103,403104,120,38280,61,"""6""",38520,38640
2564,403104,112103,120,38280,61,"""6""",38640,38760
2564,408002,402502,60,38880,61,"""6""",38880,38940
2564,402502,407401,60,38880,61,"""6""",38940,39000
2564,407401,404103,120,38880,61,"""6""",39000,39120
2564,404103,403104,120,38880,61,"""6""",39120,39240
2564,403104,112103,120,38880,61,"""6""",39240,39360
2564,408002,402502,60,39480,61,"""6""",39480,39540
2564,402502,407401,60,39480,61,"""6""",39540,39600
2564,407401,404103,120,39480,61,"""6""",39600,39720
2564,404103,403104,120,39480,61,"""6""",39720,39840
2564,403104,112103,120,39480,61,"""6""",39840,39960
2564,408002,402502,60,40080,61,"""6""",40080,40140
2564,402502,407401,60,40080,61,"""6""",40140,40200
2564,407401,404103,120,40080,61,"""6""",40200,40320
2564,404103,403104,120,40080,61,"""6""",40320,40440
2564,403104,112103,120,40080,61,"""6""",40440,40560
2564,408002,402502,60,40680,61,"""6""",40680,40740
2564,402502,407401,60,40680,61,"""6""",40740,40800
2564,407401,404103,120,40680,61,"""6""",40800,40920
2564,404103,403104,120,40680,61,"""6""",40920,41040
2564,403104,112103,120,40680,61,"""6""",41040,41160
2564,408002,402502,60,41280,61,"""6""",41280,41340
2564,402502,407401,60,41280,61,"""6""",41340,41400
2564,407401,404103,120,41280,61,"""6""",41400,41520
2564,404103,403104,120,41280,61,"""6""",41520,41640
2564,403104,112103,120,41280,61,"""6""",41640,41760
2564,408002,402502,60,41880,61,"""6""",41880,41940
2564,402502,407401,60,41880,61,"""6""",41940,42000
2564,407401,404103,120,41880,61,"""6""",42000,42120
2564,404103,403104,120,41880,61,"""6""",42120,42240
2564,403104,112103,120,41880,61,"""6""",42240,42360
2564,408002,402502,60,42480,61,"""6""",42480,42540
2564,402502,407401,60,42480,61,"""6""",42540,42600
2564,407401,404103,120,42480,61,"""6""",42600,42720
2564,404103,403104,120,42480,61,"""6""",42720,42840
2564,403104,112103,120,42480,61,"""6""",42840,42960
2564,408002,402502,60,43080,61,"""6""",43080,43140
2564,402502,407401,60,43080,61,"""6""",43140,43200
2564,407401,404103,120,43080,61,"""6""",43200,43320
2564,404103,403104,120,43080,61,"""6""",43320,43440
2564,403104,112103,120,43080,61,"""6""",43440,43560
2564,408002,402502,60,43680,61,"""6""",43680,43740
2564,402502,407401,60,43680,61,"""6""",43740,43800
2564,407401,404103,120,43680,61,"""6""",43800,43920
2564,404103,403104,120,43680,61,"""6""",43920,44040
2564,403104,112103,120,43680,61,"""6""",44040,44160
2564,408002,402502,60,44280,61,"""6""",44280,44340
2564,402502,407401,60,44280,61,"""6""",44340,44400
2564,407401,404103,120,44280,61,"""6""",44400,44520
2564,404103,403104,120,44280,61,"""6""",44520,44640
2564,403104,112103,120,44280,61,"""6""",44640,44760
2564,408002,402502,60,44880,61,"""6""",44880,44940
2564,402502,407401,60,44880,61,"""6""",44940,45000
2564,407401,404103,120,44880,61,"""6""",45000,45120
2564,404103,403104,120,44880,61,"""6""",45120,45240
2564,403104,112103,120,44880,61,"""6""",45240,45360
2564,408002,402502,60,45480,61,"""6""",45480,45540
2564,402502,407401,60,45480,61,"""6""",45540,45600
2564,407401,404103,120,45480,61,"""6""",45600,45720
2564,404103,403104,120,45480,61,"""6""",45720,45840
2564,403104,112103,120,45480,61,"""6""",45840,45960
2564,408002,402502,60,46080,61,"""6""",46080,46140
2564,402502,407401,60,46080,61,"""6""",46140,46200
2564,407401,404103,120,46080,61,"""6""",46200,46320
2564,404103,403104,120,46080,61,"""6""",46320,46440
2564,403104,112103,120,46080,61,"""6""",46440,46560
2564,408002,402502,60,46680,61,"""6""",46680,46740
2564,402502,407401,60,46680,61,"""6""",46740,46800
2564,407401,404103,120,46680,61,"""6""",46800,46920
2564,404103,403104,120,46680,61,"""6""",46920,47040
2564,403104,112103,120,46680,61,"""6""",47040,47160
2564,408002,402502,60,47280,61,"""6""",47280,47340
2564,402502,407401,60,47280,61,"""6""",47340,47400
2564,407401,404103,120,47280,61,"""6""",47400,47520
2564,404103,403104,120,47280,61,"""6""",47520,47640
2564,403104,112103,120,47280,61,"""6""",47640,47760
2564,408002,402502,60,47880,61,"""6""",47880,47940
2564,402502,407401,60,47880,61,"""6""",47940,48000
2564,407401,404103,120,47880,61,"""6""",48000,48120
2564,404103,403104,120,47880,61,"""6""",48120,48240
2564,403104,112103,120,47880,61,"""6""",48240,48360
2564,408002,402502,60,48480,61,"""6""",48480,48540
2564,402502,407401,60,48480,61,"""6""",48540,48600
2564,407401,404103,120,48480,61,"""6""",48600,48720
2564,404103,403104,120,48480,61,"""6""",48720,48840
2564,403104,112103,120,48480,61,"""6""",48840,48960
2564,408002,402502,60,49080,61,"""6""",49080,49140
2564,402502,407401,60,49080,61,"""6""",49140,49200
2564,407401,404103,120,49080,61,"""6""",49200,49320
2564,404103,403104,120,49080,61,"""6""",49320,49440
2564,403104,112103,120,49080,61,"""6""",49440,49560
2564,408002,402502,60,49680,61,"""6""",49680,49740
2564,402502,407401,60,49680,61,"""6""",49740,49800
2564,407401,404103,120,49680,61,"""6""",49800,49920
2564,404103,403104,120,49680,61,"""6""",49920,50040
2564,403104,112103,120,49680,61,"""6""",50040,50160
2564,408002,402502,60,50280,61,"""6""",50280,50340
2564,402502,407401,60,50280,61,"""6""",50340,50400
2564,407401,404103,120,50280,61,"""6""",50400,50520
2564,404103,403104,120,50280,61,"""6""",50520,50640
2564,403104,112103,120,50280,61,"""6""",50640,50760
2564,408002,402502,60,50880,61,"""6""",50880,50940
2564,402502,407401,60,50880,61,"""6""",50940,51000
2564,407401,404103,120,50880,61,"""6""",51000,51120
2564,404103,403104,120,50880,61,"""6""",51120,51240
2564,403104,112103,120,50880,61,"""6""",51240,51360
2564,408002,402502,60,51480,61,"""6""",51480,51540
2564,402502,407401,60,51480,61,"""6""",51540,51600
2564,407401,404103,120,51480,61,"""6""",51600,51720
2564,404103,403104,120,51480,61,"""6""",51720,51840
2564,403104,112103,120,51480,61,"""6""",51840,51960
2564,408002,402502,60,52080,61,"""6""",52080,52140
2564,402502,407401,60,52080,61,"""6""",52140,52200
2564,407401,404103,120,52080,61,"""6""",52200,52320
2564,404103,403104,120,52080,61,"""6""",52320,52440
2564,403104,112103,120,52080,61,"""6""",52440,52560
2564,408002,402502,60,52680,61,"""6""",52680,52740
2564,402502,407401,60,52680,61,"""6""",52740,52800
2564,407401,404103,120,52680,61,"""6""",52800,52920
2564,404103,403104,120,52680,61,"""6""",52920,53040
2564,403104,112103,120,52680,61,"""6""",53040,53160
2564,408002,402502,60,53280,61,"""6""",53280,53340
2564,402502,407401,60,53280,61,"""6""",53340,53400
2564,407401,404103,120,53280,61,"""6""",53400,53520
2564,404103,403104,120,53280,61,"""6""",53520,53640
2564,403104,112103,120,53280,61,"""6""",53640,53760
2564,408002,402502,60,53880,61,"""6""",53880,53940
2564,402502,407401,60,53880,61,"""6""",53940,54000
2564,407401,404103,120,53880,61,"""6""",54000,54120
2564,404103,403104,120,53880,61,"""6""",54120,54240
2564,403104,112103,120,53880,61,"""6""",54240,54360
2564,408002,402502,60,54480,61,"""6""",54480,54540
2564,402502,407401,60,54480,61,"""6""",54540,54600
2564,407401,404103,120,54480,61,"""6""",54600,54720
2564,404103,403104,120,54480,61,"""6""",54720,54840
2564,403104,112103,120,54480,61,"""6""",54840,54960
2564,408002,402502,60,55080,61,"""6""",55080,55140
2564,402502,407401,60,55080,61,"""6""",55140,55200
2564,407401,404103,120,55080,61,"""6""",55200,55320
2564,404103,403104,120,55080,61,"""6""",55320,55440
2564,403104,112103,120,55080,61,"""6""",55440,55560
2564,408002,402502,60,55680,61,"""6""",55680,55740
2564,402502,407401,60,55680,61,"""6""",55740,55800
2564,407401,404103,120,55680,61,"""6""",55800,55920
2564,404103,403104,120,55680,61,"""6""",55920,56040
2564,403104,112103,120,55680,61,"""6""",56040,56160
2564,408002,402502,60,56280,61,"""6""",56280,56340
2564,402502,407401,60,56280,61,"""6""",56340,56400
2564,407401,404103,120,56280,61,"""6""",56400,56520
2564,404103,403104,120,56280,61,"""6""",56520,56640
2564,403104,112103,120,56280,61,"""6""",56640,56760
2564,408002,402502,60,56880,61,"""6""",56880,56940
2564,402502,407401,60,56880,61,"""6""",56940,57000
2564,407401,404103,120,56880,61,"""6""",57000,57120
2564,404103,403104,120,56880,61,"""6""",57120,57240
2564,403104,112103,120,56880,61,"""6""",57240,57360
2564,408002,402502,60,57480,61,"""6""",57480,57540
2564,402502,407401,60,57480,61,"""6""",57540,57600
2564,407401,404103,120,57480,61,"""6""",57600,57720
2564,404103,403104,120,57480,61,"""6""",57720,57840
2564,403104,112103,120,57480,61,"""6""",57840,57960
2564,408002,402502,60,58080,61,"""6""",58080,58140
2564,402502,407401,60,58080,61,"""6""",58140,58200
2564,407401,404103,120,58080,61,"""6""",58200,58320
2564,404103,403104,120,58080,61,"""6""",58320,58440
2564,403104,112103,120,58080,61,"""6""",58440,58560
2564,408002,402502,60,58680,61,"""6""",58680,58740
2564,402502,407401,60,58680,61,"""6""",58740,58800
2564,407401,404103,120,58680,61,"""6""",58800,58920
2564,404103,403104,120,58680,61,"""6""",58920,59040
2564,403104,112103,120,58680,61,"""6""",59040,59160
2564,408002,402502,60,59280,61,"""6""",59280,59340
2564,402502,407401,60,59280,61,"""6""",59340,59400
2564,407401,404103,120,59280,61,"""6""",59400,59520
2564,404103,403104,120,59280,61,"""6""",59520,59640
2564,403104,112103,120,59280,61,"""6""",59640,59760
2564,408002,402502,60,59880,61,"""6""",59880,59940
2564,402502,407401,60,59880,61,"""6""",59940,60000
2564,407401,404103,120,59880,61,"""6""",60000,60120
2564,404103,403104,120,59880,61,"""6""",60120,60240
2564,403104,112103,120,59880,61,"""6""",60240,60360
2564,408002,402502,60,60480,61,"""6""",60480,60540
2564,402502,407401,60,60480,61,"""6""",60540,60600
2564,407401,404103,120,60480,61,"""6""",60600,60720
2564,404103,403104,120,60480,61,"""6""",60720,60840
2564,403104,112103,120,60480,61,"""6""",60840,60960
2564,408002,402502,60,61080,61,"""6""",61080,61140
2564,402502,407401,60,61080,61,"""6""",61140,61200
2564,407401,404103,120,61080,61,"""6""",61200,61320
2564,404103,403104,120,61080,61,"""6""",61320,61440
2564,403104,112103,120,61080,61,"""6""",61440,61560
2564,408002,402502,60,61680,61,"""6""",61680,61740
2564,402502,407401,60,61680,61,"""6""",61740,61800
2564,407401,404103,120,61680,61,"""6""",61800,61920
2564,404103,403104,120,61680,61,"""6""",61920,62040
2564,403104,112103,120,61680,61,"""6""",62040,62160
2564,408002,402502,60,62280,61,"""6""",62280,62340
2564,402502,407401,60,62280,61,"""6""",62340,62400
2564,407401,404103,120,62280,61,"""6""",62400,62520
2564,404103,403104,120,62280,61,"""6""",62520,62640
2564,403104,112103,120,62280,61,"""6""",62640,62760
2564,408002,402502,60,62880,61,"""6""",62880,62940
2564,402502,407401,60,62880,61,"""6""",62940,63000
2564,407401,404103,120,62880,61,"""6""",63000,63120
2564,404103,403104,120,62880,61,"""6""",63120,63240
2564,403104,112103,120,62880,61,"""6""",63240,63360
2564,408002,402502,60,63480,61,"""6""",63480,63540
2564,402502,407401,60,63480,61,"""6""",63540,63600
2564,407401,404103,120,63480,61,"""6""",63600,63720
2564,404103,403104,120,63480,61,"""6""",63720,63840
2564,403104,112103,120,63480,61,"""6""",63840,63960
2564,408002,402502,60,64080,61,"""6""",64080,64140
2564,402502,407401,60,64080,61,"""6""",64140,64200
2564,407401,404103,120,64080,61,"""6""",64200,64320
2564,404103,403104,120,64080,61,"""6""",64320,64440
2564,403104,112103,120,64080,61,"""6""",64440,64560
2564,408002,402502,60,64680,61,"""6""",64680,64740
2564,402502,407401,60,64680,61,"""6""",64740,64800
2564,407401,404103,120,64680,61,"""6""",64800,64920
2564,404103,403104,120,64680,61,"""6""",64920,65040
2564,403104,112103,120,64680,61,"""6""",65040,65160
2564,408002,402502,60,65280,61,"""6""",65280,65340
2564,402502,407401,60,65280,61,"""6""",65340,65400
2564,407401,404103,120,65280,61,"""6""",65400,65520
2564,404103,403104,120,65280,61,"""6""",65520,65640
2564,403104,112103,120,65280,61,"""6""",65640,65760
2564,408002,402502,60,65880,61,"""6""",65880,65940
2564,402502,407401,60,65880,61,"""6""",65940,66000
2564,407401,404103,120,65880,61,"""6""",66000,66120
2564,404103,403104,120,65880,61,"""6""",66120,66240
2564,403104,112103,120,65880,61,"""6""",66240,66360
2564,408002,402502,60,66480,61,"""6""",66480,66540
2564,402502,407401,60,66480,61,"""6""",66540,66600
2564,407401,404103,120,66480,61,"""6""",66600,66720
2564,404103,403104,120,66480,61,"""6""",66720,66840
2564,403104,112103,120,66480,61,"""6""",66840,66960
2564,408002,402502,60,67080,61,"""6""",67080,67140
2564,402502,407401,60,67080,61,"""6""",67140,67200
2564,407401,404103,120,67080,61,"""6""",67200,67320
2564,404103,403104,120,67080,61,"""6""",67320,67440
2564,403104,112103,120,67080,61,"""6""",67440,67560
2564,408002,402502,60,67680,61,"""6""",67680,67740
2564,402502,407401,60,67680,61,"""6""",67740,67800
2564,407401,404103,120,67680,61,"""6""",67800,67920
2564,404103,403104,120,67680,61,"""6""",67920,68040
2564,403104,112103,120,67680,61,"""6""",68040,68160
2564,408002,402502,60,68280,61,"""6""",68280,68340
2564,402502,407401,60,68280,61,"""6""",68340,68400
2564,407401,404103,120,68280,61,"""6""",68400,68520
2564,404103,403104,120,68280,61,"""6""",68520,68640
2564,403104,112103,120,68280,61,"""6""",68640,68760
2564,408002,402502,60,68880,61,"""6""",68880,68940
2564,402502,407401,60,68880,61,"""6""",68940,69000
2564,407401,404103,120,68880,61,"""6""",69000,69120
2564,404103,403104,120,68880,61,"""6""",69120,69240
2564,403104,112103,120,68880,61,"""6""",69240,69360
2564,408002,402502,60,70080,61,"""6""",70080,70140
2564,402502,407401,60,70080,61,"""6""",70140,70200
2564,407401,404103,120,70080,61,"""6""",70200,70320
2564,404103,403104,120,70080,61,"""6""",70320,70440
2564,403104,112103,120,70080,61,"""6""",70440,70560
2564,408002,402502,60,71280,61,"""6""",71280,71340
2564,402502,407401,60,71280,61,"""6""",71340,71400
2564,407401,404103,120,71280,61,"""6""",71400,71520
2564,404103,403104,120,71280,61,"""6""",71520,71640
2564,403104,112103,120,71280,61,"""6""",71640,71760
2565,408002,402502,60,72480,61,"""6""",72480,72540
2565,402502,407401,60,72480,61,"""6""",72540,72600
2565,407401,404103,120,72480,61,"""6""",72600,72720
2565,404103,403104,60,72480,61,"""6""",72720,72780
2565,403104,112103,120,72480,61,"""6""",72780,72900
2565,408002,402502,60,73680,61,"""6""",73680,73740
2565,402502,407401,60,73680,61,"""6""",73740,73800
2565,407401,404103,120,73680,61,"""6""",73800,73920
2565,404103,403104,60,73680,61,"""6""",73920,73980
2565,403104,112103,120,73680,61,"""6""",73980,74100
2850,200900,202002,60,20580,4,"""4""",20580,20640
2850,202002,204103,120,20580,4,"""4""",20640,20760
2850,204103,203604,60,20580,4,"""4""",20760,20820
2850,203604,201903,60,20580,4,"""4""",20820,20880
2850,201903,203900,120,20580,4,"""4""",20880,21000
2850,203900,201503,60,20580,4,"""4""",21000,21060
2850,201503,208103,120,20580,4,"""4""",21060,21180
2850,208103,34104,60,20580,4,"""4""",21180,21240
2850,34104,105002,60,20580,4,"""4""",21240,21300
2850,105002,118002,120,20580,4,"""4""",21300,21420
2850,118002,106002,60,20580,4,"""4""",21420,21480
2850,106002,118102,60,20580,4,"""4""",21480,21540
2850,118102,101004,120,20580,4,"""4""",21540,21660
2850,200900,202002,60,21780,4,"""4""",21780,21840
2850,202002,204103,120,21780,4,"""4""",21840,21960
2850,204103,203604,60,21780,4,"""4""",21960,22020
2850,203604,201903,60,21780,4,"""4""",22020,22080
2850,201903,203900,120,21780,4,"""4""",22080,22200
2850,203900,201503,60,21780,4,"""4""",22200,22260
2850,201503,208103,120,21780,4,"""4""",22260,22380
2850,208103,34104,60,21780,4,"""4""",22380,22440
2850,34104,105002,60,21780,4,"""4""",22440,22500
2850,105002,118002,120,21780,4,"""4""",22500,22620
2850,118002,106002,60,21780,4,"""4""",22620,22680
2850,106002,118102,60,21780,4,"""4""",22680,22740
2850,118102,101004,120,21780,4,"""4""",22740,22860
2850,200900,202002,60,64800,4,"""4""",64800,64860
2850,202002,204103,120,64800,4,"""4""",64860,64980
2850,204103,203604,60,64800,4,"""4""",64980,65040
2850,203604,201903,60,64800,4,"""4""",65040,65100
2850,201903,203900,120,64800,4,"""4""",65100,65220
2850,203900,201503,60,64800,4,"""4""",65220,65280
2850,201503,208103,120,64800,4,"""4""",65280,65400
2850,208103,34104,60,64800,4,"""4""",65400,65460
2850,34104,105002,60,64800,4,"""4""",65460,65520
2850,105002,118002,120,64800,4,"""4""",65520,65640
2850,118002,106002,60,64800,4,"""4""",65640,65700
2850,106002,118102,60,64800,4,"""4""",65700,65760
2850,118102,101004,120,64800,4,"""4""",65760,65880
2850,200900,202002,60,67200,4,"""4""",67200,67260
2850,202002,204103,120,67200,4,"""4""",67260,67380
2850,204103,203604,60,67200,4,"""4""",67380,67440
2850,203604,201903,60,67200,4,"""4""",67440,67500
2850,201903,203900,120,67200,4,"""4""",67500,67620
2850,203900,201503,60,67200,4,"""4""",67620,67680
2850,201503,208103,120,67200,4,"""4""",67680,67800
2850,208103,34104,60,67200,4,"""4""",67800,67860
2850,34104,105002,60,67200,4,"""4""",67860,67920
2850,105002,118002,120,67200,4,"""4""",67920,68040
2850,118002,106002,60,67200,4,"""4""",68040,68100
2850,106002,118102,60,67200,4,"""4""",68100,68160
2850,118102,101004,120,67200,4,"""4""",68160,68280
2850,200900,202002,60,69000,4,"""4""",69000,69060
2850,202002,204103,120,69000,4,"""4""",69060,69180
2850,204103,203604,60,69000,4,"""4""",69180,69240
2850,203604,201903,60,69000,4,"""4""",69240,69300
2850,201903,203900,120,69000,4,"""4""",69300,69420
2850,203900,201503,60,69000,4,"""4""",69420,69480
2850,201503,208103,120,69000,4,"""4""",69480,69600
2850,208103,34104,60,69000,4,"""4""",69600,69660
2850,34104,105002,60,69000,4,"""4""",69660,69720
2850,105002,118002,120,69000,4,"""4""",69720,69840
2850,118002,106002,60,69000,4,"""4""",69840,69900
2850,106002,118102,60,69000,4,"""4""",69900,69960
2850,118102,101004,120,69000,4,"""4""",69960,70080
2850,200900,202002,60,70800,4,"""4""",70800,70860
2850,202002,204103,120,70800,4,"""4""",70860,70980
2850,204103,203604,60,70800,4,"""4""",70980,71040
2850,203604,201903,60,70800,4,"""4""",71040,71100
2850,201903,203900,120,70800,4,"""4""",71100,71220
2850,203900,201503,60,70800,4,"""4""",71220,71280
2850,201503,208103,120,70800,4,"""4""",71280,71400
2850,208103,34104,60,70800,4,"""4""",71400,71460
2850,34104,105002,60,70800,4,"""4""",71460,71520
2850,105002,118002,120,70800,4,"""4""",71520,71640
2850,118002,106002,60,70800,4,"""4""",71640,71700
2850,106002,118102,60,70800,4,"""4""",71700,71760
2850,118102,101004,120,70800,4,"""4""",71760,71880
3486,407801,400301,60,47580,3,"""43""",47580,47640
3486,400301,401202,60,47580,3,"""43""",47640,47700
3486,401202,400101,60,47580,3,"""43""",47700,47760
3486,400101,407302,60,47580,3,"""43""",47760,47820
3486,407302,408202,60,47580,3,"""43""",47820,47880
3486,408202,403104,120,47580,3,"""43""",47880,48000
3486,403104,112103,120,47580,3,"""43""",48000,48120
3495,112104,403101,120,25980,3,"""6""",25980,26100
3495,403101,408203,60,25980,3,"""6""",26100,26160
3495,408203,407303,60,25980,3,"""6""",26160,26220
3495,407303,400102,60,25980,3,"""6""",26220,26280
3495,400102,401203,60,25980,3,"""6""",26280,26340
3495,401203,400302,60,25980,3,"""6""",26340,26400
3495,400302,407802,60,25980,3,"""6""",26400,26460
3495,407802,408602,60,25980,3,"""6""",26460,26520
3495,408602,404400,60,25980,3,"""6""",26520,26580
3495,112104,403101,120,27120,3,"""6""",27120,27240
3495,403101,408203,60,27120,3,"""6""",27240,27300
3495,408203,407303,60,27120,3,"""6""",27300,27360
3495,407303,400102,60,27120,3,"""6""",27360,27420
3495,400102,401203,60,27120,3,"""6""",27420,27480
3495,401203,400302,60,27120,3,"""6""",27480,27540
3495,400302,407802,60,27120,3,"""6""",27540,27600
3495,407802,408602,60,27120,3,"""6""",27600,27660
3495,408602,404400,60,27120,3,"""6""",27660,27720
3495,112104,403101,120,27180,3,"""6""",27180,27300
3495,403101,408203,60,27180,3,"""6""",27300,27360
3495,408203,407303,60,27180,3,"""6""",27360,27420
3495,407303,400102,60,27180,3,"""6""",27420,27480
3495,400102,401203,60,27180,3,"""6""",27480,27540
3495,401203,400302,60,27180,3,"""6""",27540,27600
3495,400302,407802,60,27180,3,"""6""",27600,27660
3495,407802,408602,60,27180,3,"""6""",27660,27720
3495,408602,404400,60,27180,3,"""6""",27720,27780
3495,112104,403101,120,27480,3,"""6""",27480,27600
3495,403101,408203,60,27480,3,"""6""",27600,27660
3495,408203,407303,60,27480,3,"""6""",27660,27720
3495,407303,400102,60,27480,3,"""6""",27720,27780
3495,400102,401203,60,27480,3,"""6""",27780,27840
3495,401203,400302,60,27480,3,"""6""",27840,27900
3495,400302,407802,60,27480,3,"""6""",27900,27960
3495,407802,408602,60,27480,3,"""6""",27960,28020
3495,408602,404400,60,27480,3,"""6""",28020,28080
3495,112104,403101,120,27720,3,"""6""",27720,27840
3495,403101,408203,60,27720,3,"""6""",27840,27900
3495,408203,407303,60,27720,3,"""6""",27900,27960
3495,407303,400102,60,27720,3,"""6""",27960,28020
3495,400102,401203,60,27720,3,"""6""",28020,28080
3495,401203,400302,60,27720,3,"""6""",28080,28140
3495,400302,407802,60,27720,3,"""6""",28140,28200
3495,407802,408602,60,27720,3,"""6""",28200,28260
3495,408602,404400,60,27720,3,"""6""",28260,28320
3495,112104,403101,120,28380,3,"""6""",28380,28500
3495,403101,408203,60,28380,3,"""6""",28500,28560
3495,408203,407303,60,28380,3,"""6""",28560,28620
3495,407303,400102,60,28380,3,"""6""",28620,28680
3495,400102,401203,60,28380,3,"""6""",28680,28740
3495,401203,400302,60,28380,3,"""6""",28740,28800
3495,400302,407802,60,28380,3,"""6""",28800,28860
3495,407802,408602,60,28380,3,"""6""",28860,28920
3495,408602,404400,60,28380,3,"""6""",28920,28980
3495,112104,403101,120,47820,3,"""6""",47820,47940
3495,403101,408203,60,47820,3,"""6""",47940,48000
3495,408203,407303,60,47820,3,"""6""",48000,48060
3495,407303,400102,60,47820,3,"""6""",48060,48120
3495,400102,401203,60,47820,3,"""6""",48120,48180
3495,401203,400302,60,47820,3,"""6""",48180,48240
3495,400302,407802,60,47820,3,"""6""",48240,48300
3495,407802,408602,60,47820,3,"""6""",48300,48360
3495,408602,404400,60,47820,3,"""6""",48360,48420
3532,112102,101101,120,27000,7,"""38""",27000,27120
3532,101101,403801,120,27000,7,"""38""",27120,27240
3532,403801,409002,60,27000,7,"""38""",27240,27300
3532,409002,407601,60,27000,7,"""38""",27300,27360
3532,407601,405106,120,27000,7,"""38""",27360,27480
3546,202302,700501,60,27360,55,"""1""",27360,27420
3546,700501,203201,60,27360,55,"""1""",27420,27480
3546,203201,203101,60,27360,55,"""1""",27480,27540
3546,203101,200201,60,27360,55,"""1""",27540,27600
3546,200201,201701,60,27360,55,"""1""",27600,27660
3546,201701,200701,60,27360,55,"""1""",27660,27720
3546,200701,208800,240,27360,55,"""1""",27720,27960
3547,208800,200702,240,47400,55,"""2""",47400,47640
3547,200702,201702,60,47400,55,"""2""",47640,47700
3547,201702,200202,60,47400,55,"""2""",47700,47760
3547,200202,203102,60,47400,55,"""2""",47760,47820
3547,203102,203202,60,47400,55,"""2""",47820,47880
3547,203202,700502,60,47400,55,"""2""",47880,47940
3547,700502,202303,60,47400,55,"""2""",47940,48000
3553,301502,301201,0,27060,9,"""9""",27060,27060
3553,301201,301600,60,27060,9,"""9""",27060,27120
3553,301600,301001,60,27060,9,"""9""",27120,27180
3553,301001,301302,60,27060,9,"""9""",27180,27240
3553,301302,305001,120,27060,9,"""9""",27240,27360
3553,305001,33902,120,27060,9,"""9""",27360,27480
3553,33902,26502,120,27060,9,"""9""",27480,27600
3553,26502,401302,60,27060,9,"""9""",27600,27660
3721,405200,406303,60,71160,6,"""2""",71160,71220
3721,406303,400502,60,71160,6,"""2""",71220,71280
3721,400502,408005,120,71160,6,"""2""",71280,71400
3721,408005,406804,120,71160,6,"""2""",71400,71520
3721,406804,403002,60,71160,6,"""2""",71520,71580
3721,403002,404103,60,71160,6,"""2""",71580,71640
3721,404103,403104,60,71160,6,"""2""",71640,71700
3721,403104,112103,120,71160,6,"""2""",71700,71820
3721,112103,101104,120,71160,6,"""2""",71820,71940
3721,101104,102001,180,71160,6,"""2""",71940,72120
3721,102001,502202,180,71160,6,"""2""",72120,72300
3721,502202,500802,60,71160,6,"""2""",72300,72360
3721,500802,500103,60,71160,6,"""2""",72360,72420
3721,500103,501202,60,71160,6,"""2""",72420,72480
3721,501202,500403,60,71160,6,"""2""",72480,72540
3721,500403,503902,60,71160,6,"""2""",72540,72600
3721,503902,503303,60,71160,6,"""2""",72600,72660
3721,503303,501102,60,71160,6,"""2""",72660,72720
3721,501102,504002,60,71160,6,"""2""",72720,72780
3721,504002,503801,120,71160,6,"""2""",72780,72900
3721,503801,503800,60,71160,6,"""2""",72900,72960
3721,405200,406303,60,72960,6,"""2""",72960,73020
3721,406303,400502,60,72960,6,"""2""",73020,73080
3721,400502,408005,120,72960,6,"""2""",73080,73200
3721,408005,406804,120,72960,6,"""2""",73200,73320
3721,406804,403002,60,72960,6,"""2""",73320,73380
3721,403002,404103,60,72960,6,"""2""",73380,73440
3721,404103,403104,60,72960,6,"""2""",73440,73500
3721,403104,112103,120,72960,6,"""2""",73500,73620
3721,112103,101104,120,72960,6,"""2""",73620,73740
3721,101104,102001,180,72960,6,"""2""",73740,73920
3721,102001,502202,180,72960,6,"""2""",73920,74100
3721,502202,500802,60,72960,6,"""2""",74100,74160
3721,500802,500103,60,72960,6,"""2""",74160,74220
3721,500103,501202,60,72960,6,"""2""",74220,74280
3721,501202,500403,60,72960,6,"""2""",74280,74340
3721,500403,503902,60,72960,6,"""2""",74340,74400
3721,503902,503303,60,72960,6,"""2""",74400,74460
3721,503303,501102,60,72960,6,"""2""",74460,74520
3721,501102,504002,60,72960,6,"""2""",74520,74580
3721,504002,503801,120,72960,6,"""2""",74580,74700
3721,503801,503800,60,72960,6,"""2""",74700,74760
3721,405200,406303,60,74760,6,"""2""",74760,74820
3721,406303,400502,60,74760,6,"""2""",74820,74880
3721,400502,408005,120,74760,6,"""2""",74880,75000
3721,408005,406804,120,74760,6,"""2""",75000,75120
3721,406804,403002,60,74760,6,"""2""",75120,75180
3721,403002,404103,60,74760,6,"""2""",75180,75240
3721,404103,403104,60,74760,6,"""2""",75240,75300
3721,403104,112103,120,74760,6,"""2""",75300,75420
3721,112103,101104,120,74760,6,"""2""",75420,75540
3721,101104,102001,180,74760,6,"""2""",75540,75720
3721,102001,502202,180,74760,6,"""2""",75720,75900
3721,502202,500802,60,74760,6,"""2""",75900,75960
3721,500802,500103,60,74760,6,"""2""",75960,76020
3721,500103,501202,60,74760,6,"""2""",76020,76080
3721,501202,500403,60,74760,6,"""2""",76080,76140
3721,500403,503902,60,74760,6,"""2""",76140,76200
3721,503902,503303,60,74760,6,"""2""",76200,76260
3721,503303,501102,60,74760,6,"""2""",76260,76320
3721,501102,504002,60,74760,6,"""2""",76320,76380
3721,504002,503801,120,74760,6,"""2""",76380,76500
3721,503801,503800,60,74760,6,"""2""",76500,76560
3721,405200,406303,60,76560,6,"""2""",76560,76620
3721,406303,400502,60,76560,6,"""2""",76620,76680
3721,400502,408005,120,76560,6,"""2""",76680,76800
3721,408005,406804,120,76560,6,"""2""",76800,76920
3721,406804,403002,60,76560,6,"""2""",76920,76980
3721,403002,404103,60,76560,6,"""2""",76980,77040
3721,404103,403104,60,76560,6,"""2""",77040,77100
3721,403104,112103,120,76560,6,"""2""",77100,77220
3721,112103,101104,120,76560,6,"""2""",77220,77340
3721,101104,102001,180,76560,6,"""2""",77340,77520
3721,102001,502202,180,76560,6,"""2""",77520,77700
3721,502202,500802,60,76560,6,"""2""",77700,77760
3721,500802,500103,60,76560,6,"""2""",77760,77820
3721,500103,501202,60,76560,6,"""2""",77820,77880
3721,501202,500403,60,76560,6,"""2""",77880,77940
3721,500403,503902,60,76560,6,"""2""",77940,78000
3721,503902,503303,60,76560,6,"""2""",78000,78060
3721,503303,501102,60,76560,6,"""2""",78060,78120
3721,501102,504002,60,76560,6,"""2""",78120,78180
3721,504002,503801,120,76560,6,"""2""",78180,78300
3721,503801,503800,60,76560,6,"""2""",78300,78360
3721,405200,406303,60,78360,6,"""2""",78360,78420
3721,406303,400502,60,78360,6,"""2""",78420,78480
3721,400502,408005,120,78360,6,"""2""",78480,78600
3721,408005,406804,120,78360,6,"""2""",78600,78720
3721,406804,403002,60,78360,6,"""2""",78720,78780
3721,403002,404103,60,78360,6,"""2""",78780,78840
3721,404103,403104,60,78360,6,"""2""",78840,78900
3721,403104,112103,120,78360,6,"""2""",78900,79020
3721,112103,101104,120,78360,6,"""2""",79020,79140
3721,101104,102001,180,78360,6,"""2""",79140,79320
3721,102001,502202,180,78360,6,"""2""",79320,79500
3721,502202,500802,60,78360,6,"""2""",79500,79560
3721,500802,500103,60,78360,6,"""2""",79560,79620
3721,500103,501202,60,78360,6,"""2""",79620,79680
3721,501202,500403,60,78360,6,"""2""",79680,79740
3721,500403,503902,60,78360,6,"""2""",79740,79800
3721,503902,503303,60,78360,6,"""2""",79800,79860
3721,503303,501102,60,78360,6,"""2""",79860,79920
3721,501102,504002,60,78360,6,"""2""",79920,79980
3721,504002,503801,120,78360,6,"""2""",79980,80100
3721,503801,503800,60,78360,6,"""2""",80100,80160
3721,405200,406303,60,80160,6,"""2""",80160,80220
3721,406303,400502,60,80160,6,"""2""",80220,80280
3721,400502,408005,120,80160,6,"""2""",80280,80400
3721,408005,406804,120,80160,6,"""2""",80400,80520
3721,406804,403002,60,80160,6,"""2""",80520,80580
3721,403002,404103,60,80160,6,"""2""",80580,80640
3721,404103,403104,60,80160,6,"""2""",80640,80700
3721,403104,112103,120,80160,6,"""2""",80700,80820
3721,112103,101104,120,80160,6,"""2""",80820,80940
3721,101104,102001,180,80160,6,"""2""",80940,81120
3721,102001,502202,180,80160,6,"""2""",81120,81300
3721,502202,500802,60,80160,6,"""2""",81300,81360
3721,500802,500103,60,80160,6,"""2""",81360,81420
3721,500103,501202,60,80160,6,"""2""",81420,81480
3721,501202,500403,60,80160,6,"""2""",81480,81540
3721,500403,503902,60,80160,6,"""2""",81540,81600
3721,503902,503303,60,80160,6,"""2""",81600,81660
3721,503303,501102,60,80160,6,"""2""",81660,81720
3721,501102,504002,60,80160,6,"""2""",81720,81780
3721,504002,503801,120,80160,6,"""2""",81780,81900
3721,503801,503800,60,80160,6,"""2""",81900,81960
3721,405200,406303,60,81960,6,"""2""",81960,82020
3721,406303,400502,60,81960,6,"""2""",82020,82080
3721,400502,408005,120,81960,6,"""2""",82080,82200
3721,408005,406804,120,81960,6,"""2""",82200,82320
3721,406804,403002,60,81960,6,"""2""",82320,82380
3721,403002,404103,60,81960,6,"""2""",82380,82440
3721,404103,403104,60,81960,6,"""2""",82440,82500
3721,403104,112103,120,81960,6,"""2""",82500,82620
3721,112103,101104,120,81960,6,"""2""",82620,82740
3721,101104,102001,180,81960,6,"""2""",82740,82920
3721,102001,502202,180,81960,6,"""2""",82920,83100
3721,502202,500802,60,81960,6,"""2""",83100,83160
3721,500802,500103,60,81960,6,"""2""",83160,83220
3721,500103,501202,60,81960,6,"""2""",83220,83280
3721,501202,500403,60,81960,6,"""2""",83280,83340
3721,500403,503902,60,81960,6,"""2""",83340,83400
3721,503902,503303,60,81960,6,"""2""",83400,83460
3721,503303,501102,60,81960,6,"""2""",83460,83520
3721,501102,504002,60,81960,6,"""2""",83520,83580
3721,504002,503801,120,81960,6,"""2""",83580,83700
3721,503801,503800,60,81960,6,"""2""",83700,83760
3721,405200,406303,60,83760,6,"""2""",83760,83820
3721,406303,400502,60,83760,6,"""2""",83820,83880
3721,400502,408005,120,83760,6,"""2""",83880,84000
3721,408005,406804,120,83760,6,"""2""",84000,84120
3721,406804,403002,60,83760,6,"""2""",84120,84180
3721,403002,404103,60,83760,6,"""2""",84180,84240
3721,404103,403104,60,83760,6,"""2""",84240,84300
3721,403104,112103,120,83760,6,"""2""",84300,84420
3721,112103,101104,120,83760,6,"""2""",84420,84540
3721,101104,102001,180,83760,6,"""2""",84540,84720
3721,102001,502202,180,83760,6,"""2""",84720,84900
3721,502202,500802,60,83760,6,"""2""",84900,84960
3721,500802,500103,60,83760,6,"""2""",84960,85020
3721,500103,501202,60,83760,6,"""2""",85020,85080
3721,501202,500403,60,83760,6,"""2""",85080,85140
3721,500403,503902,60,83760,6,"""2""",85140,85200
3721,503902,503303,60,83760,6,"""2""",85200,85260
3721,503303,501102,60,83760,6,"""2""",85260,85320
3721,501102,504002,60,83760,6,"""2""",85320,85380
3721,504002,503801,120,83760,6,"""2""",85380,85500
3721,503801,503800,60,83760,6,"""2""",85500,85560
3721,405200,406303,60,85560,6,"""2""",85560,85620
3721,406303,400502,60,85560,6,"""2""",85620,85680
3721,400502,408005,120,85560,6,"""2""",85680,85800
3721,408005,406804,120,85560,6,"""2""",85800,85920
3721,406804,403002,60,85560,6,"""2""",85920,85980
3721,403002,404103,60,85560,6,"""2""",85980,86040
3721,404103,403104,60,85560,6,"""2""",86040,86100
3721,403104,112103,120,85560,6,"""2""",86100,86220
3721,112103,101104,120,85560,6,"""2""",86220,86340
3721,101104,102001,180,85560,6,"""2""",86340,86520
3721,102001,502202,180,85560,6,"""2""",86520,86700
3721,502202,500802,60,85560,6,"""2""",86700,86760
3721,500802,500103,60,85560,6,"""2""",86760,86820
3721,500103,501202,60,85560,6,"""2""",86820,86880
3721,501202,500403,60,85560,6,"""2""",86880,86940
3721,500403,503902,60,85560,6,"""2""",86940,87000
3721,503902,503303,60,85560,6,"""2""",87000,87060
3721,503303,501102,60,85560,6,"""2""",87060,87120
3721,501102,504002,60,85560,6,"""2""",87120,87180
3721,504002,503801,120,85560,6,"""2""",87180,87300
3721,503801,503800,60,85560,6,"""2""",87300,87360
3759,304302,109202,0,71940,9,"""3""",71940,71940
3759,109202,304803,60,71940,9,"""3""",71940,72000
3759,304803,306001,60,71940,9,"""3""",72000,72060
3759,306001,304401,120,71940,9,"""3""",72060,72180
3759,304401,305202,120,71940,9,"""3""",72180,72300
3759,305202,301101,60,71940,9,"""3""",72300,72360
3759,301101,301502,60,71940,9,"""3""",72360,72420
3759,301502,301201,0,71940,9,"""3""",72420,72420
3759,301201,301600,60,71940,9,"""3""",72420,72480
3759,301600,301001,60,71940,9,"""3""",72480,72540
3759,301001,301302,60,71940,9,"""3""",72540,72600
3759,301302,305001,60,71940,9,"""3""",72600,72660
3759,305001,33902,120,71940,9,"""3""",72660,72780
3759,33902,26502,120,71940,9,"""3""",72780,72900
3759,26502,401302,60,71940,9,"""3""",72900,72960
3759,401302,400801,120,71940,9,"""3""",72960,73080
3759,400801,400704,60,71940,9,"""3""",73080,73140
3759,400704,408503,60,71940,9,"""3""",73140,73200
3759,408503,405602,60,71940,9,"""3""",73200,73260
3759,405602,407102,60,71940,9,"""3""",73260,73320
3759,407102,404202,60,71940,9,"""3""",73320,73380
3759,404202,117000,60,71940,9,"""3""",73380,73440
3759,117000,112103,180,71940,9,"""3""",73440,73620
3783,302100,302002,60,73860,10,"""4""",73860,73920
3783,302002,302202,60,73860,10,"""4""",73920,73980
3783,302202,303002,60,73860,10,"""4""",73980,74040
3783,303002,302502,60,73860,10,"""4""",74040,74100
3783,302502,119005,120,73860,10,"""4""",74100,74220
3783,119005,106503,60,73860,10,"""4""",74220,74280
3783,106503,103005,120,73860,10,"""4""",74280,74400
3783,103005,112107,120,73860,10,"""4""",74400,74520
3783,112107,403102,60,73860,10,"""4""",74520,74580
3783,403102,404102,120,73860,10,"""4""",74580,74700
3783,404102,407402,60,73860,10,"""4""",74700,74760
3783,407402,406604,60,73860,10,"""4""",74760,74820
3783,406604,400602,60,73860,10,"""4""",74820,74880
3783,400602,408300,60,73860,10,"""4""",74880,74940
3783,408300,406501,60,73860,10,"""4""",74940,75000
3783,406501,405901,60,73860,10,"""4""",75000,75060
3783,405901,405101,60,73860,10,"""4""",75060,75120
3783,405101,402900,60,73860,10,"""4""",75120,75180
3783,402900,405300,60,73860,10,"""4""",75180,75240
3783,405300,402800,60,73860,10,"""4""",75240,75300
3783,402800,402203,60,73860,10,"""4""",75300,75360
3783,402203,500701,60,73860,10,"""4""",75360,75420
3783,500701,402001,60,73860,10,"""4""",75420,75480
3783,402001,400401,60,73860,10,"""4""",75480,75540
3783,400401,400200,60,73860,10,"""4""",75540,75600
3783,302100,302002,60,77460,10,"""4""",77460,77520
3783,302002,302202,60,77460,10,"""4""",77520,77580
3783,302202,303002,60,77460,10,"""4""",77580,77640
3783,303002,302502,60,77460,10,"""4""",77640,77700
3783,302502,119005,120,77460,10,"""4""",77700,77820
3783,119005,106503,60,77460,10,"""4""",77820,77880
3783,106503,103005,120,77460,10,"""4""",77880,78000
3783,103005,112107,120,77460,10,"""4""",78000,78120
3783,112107,403102,60,77460,10,"""4""",78120,78180
3783,403102,404102,120,77460,10,"""4""",78180,78300
3783,404102,407402,60,77460,10,"""4""",78300,78360
3783,407402,406604,60,77460,10,"""4""",78360,78420
3783,406604,400602,60,77460,10,"""4""",78420,78480
3783,400602,408300,60,77460,10,"""4""",78480,78540
3783,408300,406501,60,77460,10,"""4""",78540,78600
3783,406501,405901,60,77460,10,"""4""",78600,78660
3783,405901,405101,60,77460,10,"""4""",78660,78720
3783,405101,402900,60,77460,10,"""4""",78720,78780
3783,402900,405300,60,77460,10,"""4""",78780,78840
3783,405300,402800,60,77460,10,"""4""",78840,78900
3783,402800,402203,60,77460,10,"""4""",78900,78960
3783,402203,500701,60,77460,10,"""4""",78960,79020
3783,500701,402001,60,77460,10,"""4""",79020,79080
3783,402001,400401,60,77460,10,"""4""",79080,79140
3783,400401,400200,60,77460,10,"""4""",79140,79200
3783,302100,302002,60,81060,10,"""4""",81060,81120
3783,302002,302202,60,81060,10,"""4""",81120,81180
3783,302202,303002,60,81060,10,"""4""",81180,81240
3783,303002,302502,60,81060,10,"""4""",81240,81300
3783,302502,119005,120,81060,10,"""4""",81300,81420
3783,119005,106503,60,81060,10,"""4""",81420,81480
3783,106503,103005,120,81060,10,"""4""",81480,81600
3783,103005,112107,120,81060,10,"""4""",81600,81720
3783,112107,403102,60,81060,10,"""4""",81720,81780
3783,403102,404102,120,81060,10,"""4""",81780,81900
3783,404102,407402,60,81060,10,"""4""",81900,81960
3783,407402,406604,60,81060,10,"""4""",81960,82020
3783,406604,400602,60,81060,10,"""4""",82020,82080
3783,400602,408300,60,81060,10,"""4""",82080,82140
3783,408300,406501,60,81060,10,"""4""",82140,82200
3783,406501,405901,60,81060,10,"""4""",82200,82260
3783,405901,405101,60,81060,10,"""4""",82260,82320
3783,405101,402900,60,81060,10,"""4""",82320,82380
3783,402900,405300,60,81060,10,"""4""",82380,82440
3783,405300,402800,60,81060,10,"""4""",82440,82500
3783,402800,402203,60,81060,10,"""4""",82500,82560
3783,402203,500701,60,81060,10,"""4""",82560,82620
3783,500701,402001,60,81060,10,"""4""",82620,82680
3783,402001,400401,60,81060,10,"""4""",82680,82740
3783,400401,400200,60,81060,10,"""4""",82740,82800
3783,302100,302002,60,84660,10,"""4""",84660,84720
3783,302002,302202,60,84660,10,"""4""",84720,84780
3783,302202,303002,60,84660,10,"""4""",84780,84840
3783,303002,302502,60,84660,10,"""4""",84840,84900
3783,302502,119005,120,84660,10,"""4""",84900,85020
3783,119005,106503,60,84660,10,"""4""",85020,85080
3783,106503,103005,120,84660,10,"""4""",85080,85200
3783,103005,112107,120,84660,10,"""4""",85200,85320
3783,112107,403102,60,84660,10,"""4""",85320,85380
3783,403102,404102,120,84660,10,"""4""",85380,85500
3783,404102,407402,60,84660,10,"""4""",85500,85560
3783,407402,406604,60,84660,10,"""4""",85560,85620
3783,406604,400602,60,84660,10,"""4""",85620,85680
3783,400602,408300,60,84660,10,"""4""",85680,85740
3783,408300,406501,60,84660,10,"""4""",85740,85800
3783,406501,405901,60,84660,10,"""4""",85800,85860
3783,405901,405101,60,84660,10,"""4""",85860,85920
3783,405101,402900,60,84660,10,"""4""",85920,85980
3783,402900,405300,60,84660,10,"""4""",85980,86040
3783,405300,402800,60,84660,10,"""4""",86040,86100
3783,402800,402203,60,84660,10,"""4""",86100,86160
3783,402203,500701,60,84660,10,"""4""",86160,86220
3783,500701,402001,60,84660,10,"""4""",86220,86280
3783,402001,400401,60,84660,10,"""4""",86280,86340
3783,400401,400200,60,84660,10,"""4""",86340,86400
3786,302100,302002,60,72060,10,"""8""",72060,72120
3786,302002,302202,60,72060,10,"""8""",72120,72180
3786,302202,303002,60,72060,10,"""8""",72180,72240
3786,303002,302502,60,72060,10,"""8""",72240,72300
3786,302502,119005,120,72060,10,"""8""",72300,72420
3786,119005,106503,60,72060,10,"""8""",72420,72480
3786,106503,103005,120,72060,10,"""8""",72480,72600
3786,103005,112107,120,72060,10,"""8""",72600,72720
3786,112107,403102,60,72060,10,"""8""",72720,72780
3786,403102,404102,120,72060,10,"""8""",72780,72900
3786,404102,407402,60,72060,10,"""8""",72900,72960
3786,407402,406604,60,72060,10,"""8""",72960,73020
3786,406604,400602,60,72060,10,"""8""",73020,73080
3786,400602,408300,60,72060,10,"""8""",73080,73140
3786,408300,406501,60,72060,10,"""8""",73140,73200
3786,406501,405901,60,72060,10,"""8""",73200,73260
3786,405901,405101,60,72060,10,"""8""",73260,73320
3786,405101,402900,60,72060,10,"""8""",73320,73380
3786,402900,405300,60,72060,10,"""8""",73380,73440
3786,302100,302002,60,75660,10,"""8""",75660,75720
3786,302002,302202,60,75660,10,"""8""",75720,75780
3786,302202,303002,60,75660,10,"""8""",75780,75840
3786,303002,302502,60,75660,10,"""8""",75840,75900
3786,302502,119005,120,75660,10,"""8""",75900,76020
3786,119005,106503,60,75660,10,"""8""",76020,76080
3786,106503,103005,120,75660,10,"""8""",76080,76200
3786,103005,112107,120,75660,10,"""8""",76200,76320
3786,112107,403102,60,75660,10,"""8""",76320,76380
3786,403102,404102,120,75660,10,"""8""",76380,76500
3786,404102,407402,60,75660,10,"""8""",76500,76560
3786,407402,406604,60,75660,10,"""8""",76560,76620
3786,406604,400602,60,75660,10,"""8""",76620,76680
3786,400602,408300,60,75660,10,"""8""",76680,76740
3786,408300,406501,60,75660,10,"""8""",76740,76800
3786,406501,405901,60,75660,10,"""8""",76800,76860
3786,405901,405101,60,75660,10,"""8""",76860,76920
3786,405101,402900,60,75660,10,"""8""",76920,76980
3786,402900,405300,60,75660,10,"""8""",76980,77040
3786,302100,302002,60,79260,10,"""8""",79260,79320
3786,302002,302202,60,79260,10,"""8""",79320,79380
3786,302202,303002,60,79260,10,"""8""",79380,79440
3786,303002,302502,60,79260,10,"""8""",79440,79500
3786,302502,119005,120,79260,10,"""8""",79500,79620
3786,119005,106503,60,79260,10,"""8""",79620,79680
3786,106503,103005,120,79260,10,"""8""",79680,79800
3786,103005,112107,120,79260,10,"""8""",79800,79920
3786,112107,403102,60,79260,10,"""8""",79920,79980
3786,403102,404102,120,79260,10,"""8""",79980,80100
3786,404102,407402,60,79260,10,"""8""",80100,80160
3786,407402,406604,60,79260,10,"""8""",80160,80220
3786,406604,400602,60,79260,10,"""8""",80220,80280
3786,400602,408300,60,79260,10,"""8""",80280,80340
3786,408300,406501,60,79260,10,"""8""",80340,80400
3786,406501,405901,60,79260,10,"""8""",80400,80460
3786,405901,405101,60,79260,10,"""8""",80460,80520
3786,405101,402900,60,79260,10,"""8""",80520,80580
3786,402900,405300,60,79260,10,"""8""",80580,80640
3816,404601,403700,60,74220,2,"""3""",74220,74280
3816,403700,403501,0,74220,2,"""3""",74280,74280
3816,403501,408402,60,74220,2,"""3""",74280,74340
3816,408402,407701,60,74220,2,"""3""",74340,74400
3816,407701,400601,60,74220,2,"""3""",74400,74460
3816,400601,407200,60,74220,2,"""3""",74460,74520
3816,407200,101102,120,74220,2,"""3""",74520,74640
3816,101102,102001,120,74220,2,"""3""",74640,74760
3816,102001,101001,120,74220,2,"""3""",74760,74880
3816,101001,118101,60,74220,2,"""3""",74880,74940
3816,118101,106001,60,74220,2,"""3""",74940,75000
3816,106001,118001,120,74220,2,"""3""",75000,75120
3816,118001,103004,180,74220,2,"""3""",75120,75300
3816,103004,112102,120,74220,2,"""3""",75300,75420
3816,112102,117001,180,74220,2,"""3""",75420,75600
3816,117001,404201,60,74220,2,"""3""",75600,75660
3816,404201,407101,60,74220,2,"""3""",75660,75720
3816,407101,405601,60,74220,2,"""3""",75720,75780
3816,405601,408502,60,74220,2,"""3""",75780,75840
3816,408502,400703,60,74220,2,"""3""",75840,75900
3816,400703,400800,60,74220,2,"""3""",75900,75960
3816,400800,408901,60,74220,2,"""3""",75960,76020
3816,408901,407501,120,74220,2,"""3""",76020,76140
3816,407501,407500,60,74220,2,"""3""",76140,76200
3816,404601,403700,60,77820,2,"""3""",77820,77880
3816,403700,403501,0,77820,2,"""3""",77880,77880
3816,403501,408402,60,77820,2,"""3""",77880,77940
3816,408402,407701,60,77820,2,"""3""",77940,78000
3816,407701,400601,60,77820,2,"""3""",78000,78060
3816,400601,407200,60,77820,2,"""3""",78060,78120
3816,407200,101102,120,77820,2,"""3""",78120,78240
3816,101102,102001,120,77820,2,"""3""",78240,78360
3816,102001,101001,120,77820,2,"""3""",78360,78480
3816,101001,118101,60,77820,2,"""3""",78480,78540
3816,118101,106001,60,77820,2,"""3""",78540,78600
3816,106001,118001,120,77820,2,"""3""",78600,78720
3816,118001,103004,180,77820,2,"""3""",78720,78900
3816,103004,112102,120,77820,2,"""3""",78900,79020
3816,112102,117001,180,77820,2,"""3""",79020,79200
3816,117001,404201,60,77820,2,"""3""",79200,79260
3816,404201,407101,60,77820,2,"""3""",79260,79320
3816,407101,405601,60,77820,2,"""3""",79320,79380
3816,405601,408502,60,77820,2,"""3""",79380,79440
3816,408502,400703,60,77820,2,"""3""",79440,79500
3816,400703,400800,60,77820,2,"""3""",79500,79560
3816,400800,408901,60,77820,2,"""3""",79560,79620
3816,408901,407501,120,77820,2,"""3""",79620,79740
3816,407501,407500,60,77820,2,"""3""",79740,79800
3816,404601,403700,60,81420,2,"""3""",81420,81480
3816,403700,403501,0,81420,2,"""3""",81480,81480
3816,403501,408402,60,81420,2,"""3""",81480,81540
3816,408402,407701,60,81420,2,"""3""",81540,81600
3816,407701,400601,60,81420,2,"""3""",81600,81660
3816,400601,407200,60,81420,2,"""3""",81660,81720
3816,407200,101102,120,81420,2,"""3""",81720,81840
3816,101102,102001,120,81420,2,"""3""",81840,81960
3816,102001,101001,120,81420,2,"""3""",81960,82080
3816,101001,118101,60,81420,2,"""3""",82080,82140
3816,118101,106001,60,81420,2,"""3""",82140,82200
3816,106001,118001,120,81420,2,"""3""",82200,82320
3816,118001,103004,180,81420,2,"""3""",82320,82500
3816,103004,112102,120,81420,2,"""3""",82500,82620
3816,112102,117001,180,81420,2,"""3""",82620,82800
3816,117001,404201,60,81420,2,"""3""",82800,82860
3816,404201,407101,60,81420,2,"""3""",82860,82920
3816,407101,405601,60,81420,2,"""3""",82920,82980
3816,405601,408502,60,81420,2,"""3""",82980,83040
3816,408502,400703,60,81420,2,"""3""",83040,83100
3816,400703,400800,60,81420,2,"""3""",83100,83160
3816,400800,408901,60,81420,2,"""3""",83160,83220
3816,408901,407501,120,81420,2,"""3""",83220,83340
3816,407501,407500,60,81420,2,"""3""",83340,83400
3816,404601,403700,60,85020,2,"""3""",85020,85080
3816,403700,403501,0,85020,2,"""3""",85080,85080
3816,403501,408402,60,85020,2,"""3""",85080,85140
3816,408402,407701,60,85020,2,"""3""",85140,85200
3816,407701,400601,60,85020,2,"""3""",85200,85260
3816,400601,407200,60,85020,2,"""3""",85260,85320
3816,407200,101102,120,85020,2,"""3""",85320,85440
3816,101102,102001,120,85020,2,"""3""",85440,85560
3816,102001,101001,120,85020,2,"""3""",85560,85680
3816,101001,118101,60,85020,2,"""3""",85680,85740
3816,118101,106001,60,85020,2,"""3""",85740,85800
3816,106001,118001,120,85020,2,"""3""",85800,85920
3816,118001,103004,180,85020,2,"""3""",85920,86100
3816,103004,112102,120,85020,2,"""3""",86100,86220
3816,112102,117001,180,85020,2,"""3""",86220,86400
3816,117001,404201,60,85020,2,"""3""",86400,86460
3816,404201,407101,60,85020,2,"""3""",86460,86520
3816,407101,405601,60,85020,2,"""3""",86520,86580
3816,405601,408502,60,85020,2,"""3""",86580,86640
3816,408502,400703,60,85020,2,"""3""",86640,86700
3816,400703,400800,60,85020,2,"""3""",86700,86760
3816,400800,408901,60,85020,2,"""3""",86760,86820
3816,408901,407501,120,85020,2,"""3""",86820,86940
3816,407501,407500,60,85020,2,"""3""",86940,87000
3838,404701,403601,0,70440,2,"""1""",70440,70440
3838,403601,402601,60,70440,2,"""1""",70440,70500
3838,402601,403701,60,70440,2,"""1""",70500,70560
3838,403701,404600,60,70440,2,"""1""",70560,70620
3838,404600,403700,60,70440,2,"""1""",70620,70680
3838,403700,403501,0,70440,2,"""1""",70680,70680
3838,403501,408402,60,70440,2,"""1""",70680,70740
3838,408402,407701,60,70440,2,"""1""",70740,70800
3838,407701,400601,60,70440,2,"""1""",70800,70860
3838,400601,407200,60,70440,2,"""1""",70860,70920
3838,407200,101102,120,70440,2,"""1""",70920,71040
3838,101102,102001,120,70440,2,"""1""",71040,71160
3838,102001,101001,120,70440,2,"""1""",71160,71280
3838,101001,118101,60,70440,2,"""1""",71280,71340
3838,118101,106001,60,70440,2,"""1""",71340,71400
3838,106001,118001,120,70440,2,"""1""",71400,71520
3838,118001,103004,180,70440,2,"""1""",71520,71700
3838,103004,112102,120,70440,2,"""1""",71700,71820
3838,112102,117001,180,70440,2,"""1""",71820,72000
3838,117001,404201,60,70440,2,"""1""",72000,72060
3838,404201,407101,60,70440,2,"""1""",72060,72120
3838,407101,405601,60,70440,2,"""1""",72120,72180
3838,405601,408502,60,70440,2,"""1""",72180,72240
3838,408502,400703,60,70440,2,"""1""",72240,72300
3838,400703,400800,60,70440,2,"""1""",72300,72360
3838,400800,408901,60,70440,2,"""1""",72360,72420
3838,408901,407501,120,70440,2,"""1""",72420,72540
3838,407501,407500,60,70440,2,"""1""",72540,72600
3838,404701,403601,0,72240,2,"""1""",72240,72240
3838,403601,402601,60,72240,2,"""1""",72240,72300
3838,402601,403701,60,72240,2,"""1""",72300,72360
3838,403701,404600,60,72240,2,"""1""",72360,72420
3838,404600,403700,60,72240,2,"""1""",72420,72480
3838,403700,403501,0,72240,2,"""1""",72480,72480
3838,403501,408402,60,72240,2,"""1""",72480,72540
3838,408402,407701,60,72240,2,"""1""",72540,72600
3838,407701,400601,60,72240,2,"""1""",72600,72660
3838,400601,407200,60,72240,2,"""1""",72660,72720
3838,407200,101102,120,72240,2,"""1""",72720,72840
3838,101102,102001,120,72240,2,"""1""",72840,72960
3838,102001,101001,120,72240,2,"""1""",72960,73080
3838,101001,118101,60,72240,2,"""1""",73080,73140
3838,118101,106001,60,72240,2,"""1""",73140,73200
3838,106001,118001,120,72240,2,"""1""",73200,73320
3838,118001,103004,180,72240,2,"""1""",73320,73500
3838,103004,112102,120,72240,2,"""1""",73500,73620
3838,112102,117001,180,72240,2,"""1""",73620,73800
3838,117001,404201,60,72240,2,"""1""",73800,73860
3838,404201,407101,60,72240,2,"""1""",73860,73920
3838,407101,405601,60,72240,2,"""1""",73920,73980
3838,405601,408502,60,72240,2,"""1""",73980,74040
3838,408502,400703,60,72240,2,"""1""",74040,74100
3838,400703,400800,60,72240,2,"""1""",74100,74160
3838,400800,408901,60,72240,2,"""1""",74160,74220
3838,408901,407501,120,72240,2,"""1""",74220,74340
3838,407501,407500,60,72240,2,"""1""",74340,74400
3838,404701,403601,0,75840,2,"""1""",75840,75840
3838,403601,402601,60,75840,2,"""1""",75840,75900
3838,402601,403701,60,75840,2,"""1""",75900,75960
3838,403701,404600,60,75840,2,"""1""",75960,76020
3838,404600,403700,60,75840,2,"""1""",76020,76080
3838,403700,403501,0,75840,2,"""1""",76080,76080
3838,403501,408402,60,75840,2,"""1""",76080,76140
3838,408402,407701,60,75840,2,"""1""",76140,76200
3838,407701,400601,60,75840,2,"""1""",76200,76260
3838,400601,407200,60,75840,2,"""1""",76260,76320
3838,407200,101102,120,75840,2,"""1""",76320,76440
3838,101102,102001,120,75840,2,"""1""",76440,76560
3838,102001,101001,120,75840,2,"""1""",76560,76680
3838,101001,118101,60,75840,2,"""1""",76680,76740
3838,118101,106001,60,75840,2,"""1""",76740,76800
3838,106001,118001,120,75840,2,"""1""",76800,76920
3838,118001,103004,180,75840,2,"""1""",76920,77100
3838,103004,112102,120,75840,2,"""1""",77100,77220
3838,112102,117001,180,75840,2,"""1""",77220,77400
3838,117001,404201,60,75840,2,"""1""",77400,77460
3838,404201,407101,60,75840,2,"""1""",77460,77520
3838,407101,405601,60,75840,2,"""1""",77520,77580
3838,405601,408502,60,75840,2,"""1""",77580,77640
3838,408502,400703,60,75840,2,"""1""",77640,77700
3838,400703,400800,60,75840,2,"""1""",77700,77760
3838,400800,408901,60,75840,2,"""1""",77760,77820
3838,408901,407501,120,75840,2,"""1""",77820,77940
3838,407501,407500,60,75840,2,"""1""",77940,78000
3838,404701,403601,0,79440,2,"""1""",79440,79440
3838,403601,402601,60,79440,2,"""1""",79440,79500
3838,402601,403701,60,79440,2,"""1""",79500,79560
3838,403701,404600,60,79440,2,"""1""",79560,79620
3838,404600,403700,60,79440,2,"""1""",79620,79680
3838,403700,403501,0,79440,2,"""1""",79680,79680
3838,403501,408402,60,79440,2,"""1""",79680,79740
3838,408402,407701,60,79440,2,"""1""",79740,79800
3838,407701,400601,60,79440,2,"""1""",79800,79860
3838,400601,407200,60,79440,2,"""1""",79860,79920
3838,407200,101102,120,79440,2,"""1""",79920,80040
3838,101102,102001,120,79440,2,"""1""",80040,80160
3838,102001,101001,120,79440,2,"""1""",80160,80280
3838,101001,118101,60,79440,2,"""1""",80280,80340
3838,118101,106001,60,79440,2,"""1""",80340,80400
3838,106001,118001,120,79440,2,"""1""",80400,80520
3838,118001,103004,180,79440,2,"""1""",80520,80700
3838,103004,112102,120,79440,2,"""1""",80700,80820
3838,112102,117001,180,79440,2,"""1""",80820,81000
3838,117001,404201,60,79440,2,"""1""",81000,81060
3838,404201,407101,60,79440,2,"""1""",81060,81120
3838,407101,405601,60,79440,2,"""1""",81120,81180
3838,405601,408502,60,79440,2,"""1""",81180,81240
3838,408502,400703,60,79440,2,"""1""",81240,81300
3838,400703,400800,60,79440,2,"""1""",81300,81360
3838,400800,408901,60,79440,2,"""1""",81360,81420
3838,408901,407501,120,79440,2,"""1""",81420,81540
3838,407501,407500,60,79440,2,"""1""",81540,81600
3838,404701,403601,0,83040,2,"""1""",83040,83040
3838,403601,402601,60,83040,2,"""1""",83040,83100
3838,402601,403701,60,83040,2,"""1""",83100,83160
3838,403701,404600,60,83040,2,"""1""",83160,83220
3838,404600,403700,60,83040,2,"""1""",83220,83280
3838,403700,403501,0,83040,2,"""1""",83280,83280
3838,403501,408402,60,83040,2,"""1""",83280,83340
3838,408402,407701,60,83040,2,"""1""",83340,83400
3838,407701,400601,60,83040,2,"""1""",83400,83460
3838,400601,407200,60,83040,2,"""1""",83460,83520
3838,407200,101102,120,83040,2,"""1""",83520,83640
3838,101102,102001,120,83040,2,"""1""",83640,83760
3838,102001,101001,120,83040,2,"""1""",83760,83880
3838,101001,118101,60,83040,2,"""1""",83880,83940
3838,118101,106001,60,83040,2,"""1""",83940,84000
3838,106001,118001,120,83040,2,"""1""",84000,84120
3838,118001,103004,180,83040,2,"""1""",84120,84300
3838,103004,112102,120,83040,2,"""1""",84300,84420
3838,112102,117001,180,83040,2,"""1""",84420,84600
3838,117001,404201,60,83040,2,"""1""",84600,84660
3838,404201,407101,60,83040,2,"""1""",84660,84720
3838,407101,405601,60,83040,2,"""1""",84720,84780
3838,405601,408502,60,83040,2,"""1""",84780,84840
3838,408502,400703,60,83040,2,"""1""",84840,84900
3838,400703,400800,60,83040,2,"""1""",84900,84960
3838,400800,408901,60,83040,2,"""1""",84960,85020
3838,408901,407501,120,83040,2,"""1""",85020,85140
3838,407501,407500,60,83040,2,"""1""",85140,85200
3840,407500,407503,60,73800,2,"""2""",73800,73860
3840,407503,408900,60,73800,2,"""2""",73860,73920
3840,408900,400802,60,73800,2,"""2""",73920,73980
3840,400802,400704,120,73800,2,"""2""",73980,74100
3840,400704,408503,60,73800,2,"""2""",74100,74160
3840,408503,405602,60,73800,2,"""2""",74160,74220
3840,405602,407102,60,73800,2,"""2""",74220,74280
3840,407102,404202,60,73800,2,"""2""",74280,74340
3840,404202,117000,60,73800,2,"""2""",74340,74400
3840,117000,112106,120,73800,2,"""2""",74400,74520
3840,112106,103003,120,73800,2,"""2""",74520,74640
3840,103003,118002,120,73800,2,"""2""",74640,74760
3840,118002,106002,60,73800,2,"""2""",74760,74820
3840,106002,118102,60,73800,2,"""2""",74820,74880
3840,118102,101002,120,73800,2,"""2""",74880,75000
3840,101002,102002,60,73800,2,"""2""",75000,75060
3840,102002,101101,120,73800,2,"""2""",75060,75180
3840,101101,403802,120,73800,2,"""2""",75180,75300
3840,403802,408300,60,73800,2,"""2""",75300,75360
3840,408300,406502,60,73800,2,"""2""",75360,75420
3840,406502,407702,60,73800,2,"""2""",75420,75480
3840,407702,408403,60,73800,2,"""2""",75480,75540
3840,408403,403502,60,73800,2,"""2""",75540,75600
3840,403502,403701,60,73800,2,"""2""",75600,75660
3840,403701,404600,60,73800,2,"""2""",75660,75720
3840,404600,402602,60,73800,2,"""2""",75720,75780
3840,402602,403602,120,73800,2,"""2""",75780,75900
3840,403602,404700,60,73800,2,"""2""",75900,75960
3840,404700,404701,0,73800,2,"""2""",75960,75960
3840,407500,407503,60,77400,2,"""2""",77400,77460
3840,407503,408900,60,77400,2,"""2""",77460,77520
3840,408900,400802,60,77400,2,"""2""",77520,77580
3840,400802,400704,120,77400,2,"""2""",77580,77700
3840,400704,408503,60,77400,2,"""2""",77700,77760
3840,408503,405602,60,77400,2,"""2""",77760,77820
3840,405602,407102,60,77400,2,"""2""",77820,77880
3840,407102,404202,60,77400,2,"""2""",77880,77940
3840,404202,117000,60,77400,2,"""2""",77940,78000
3840,117000,112106,120,77400,2,"""2""",78000,78120
3840,112106,103003,120,77400,2,"""2""",78120,78240
3840,103003,118002,120,77400,2,"""2""",78240,78360
3840,118002,106002,60,77400,2,"""2""",78360,78420
3840,106002,118102,60,77400,2,"""2""",78420,78480
3840,118102,101002,120,77400,2,"""2""",78480,78600
3840,101002,102002,60,77400,2,"""2""",78600,78660
3840,102002,101101,120,77400,2,"""2""",78660,78780
3840,101101,403802,120,77400,2,"""2""",78780,78900
3840,403802,408300,60,77400,2,"""2""",78900,78960
3840,408300,406502,60,77400,2,"""2""",78960,79020
3840,406502,407702,60,77400,2,"""2""",79020,79080
3840,407702,408403,60,77400,2,"""2""",79080,79140
3840,408403,403502,60,77400,2,"""2""",79140,79200
3840,403502,403701,60,77400,2,"""2""",79200,79260
3840,403701,404600,60,77400,2,"""2""",79260,79320
3840,404600,402602,60,77400,2,"""2""",79320,79380
3840,402602,403602,120,77400,2,"""2""",79380,79500
3840,403602,404700,60,77400,2,"""2""",79500,79560
3840,404700,404701,0,77400,2,"""2""",79560,79560
3840,407500,407503,60,81000,2,"""2""",81000,81060
3840,407503,408900,60,81000,2,"""2""",81060,81120
3840,408900,400802,60,81000,2,"""2""",81120,81180
3840,400802,400704,120,81000,2,"""2""",81180,81300
3840,400704,408503,60,81000,2,"""2""",81300,81360
3840,408503,405602,60,81000,2,"""2""",81360,81420
3840,405602,407102,60,81000,2,"""2""",81420,81480
3840,407102,404202,60,81000,2,"""2""",81480,81540
3840,404202,117000,60,81000,2,"""2""",81540,81600
3840,117000,112106,120,81000,2,"""2""",81600,81720
3840,112106,103003,120,81000,2,"""2""",81720,81840
3840,103003,118002,120,81000,2,"""2""",81840,81960
3840,118002,106002,60,81000,2,"""2""",81960,82020
3840,106002,118102,60,81000,2,"""2""",82020,82080
3840,118102,101002,120,81000,2,"""2""",82080,82200
3840,101002,102002,60,81000,2,"""2""",82200,82260
3840,102002,101101,120,81000,2,"""2""",82260,82380
3840,101101,403802,120,81000,2,"""2""",82380,82500
3840,403802,408300,60,81000,2,"""2""",82500,82560
3840,408300,406502,60,81000,2,"""2""",82560,82620
3840,406502,407702,60,81000,2,"""2""",82620,82680
3840,407702,408403,60,81000,2,"""2""",82680,82740
3840,408403,403502,60,81000,2,"""2""",82740,82800
3840,403502,403701,60,81000,2,"""2""",82800,82860
3840,403701,404600,60,81000,2,"""2""",82860,82920
3840,404600,402602,60,81000,2,"""2""",82920,82980
3840,402602,403602,120,81000,2,"""2""",82980,83100
3840,403602,404700,60,81000,2,"""2""",83100,83160
3840,404700,404701,0,81000,2,"""2""",83160,83160
3842,407500,407503,60,72000,2,"""4""",72000,72060
3842,407503,408900,60,72000,2,"""4""",72060,72120
3842,408900,400802,60,72000,2,"""4""",72120,72180
3842,400802,400704,120,72000,2,"""4""",72180,72300
3842,400704,408503,60,72000,2,"""4""",72300,72360
3842,408503,405602,60,72000,2,"""4""",72360,72420
3842,405602,407102,60,72000,2,"""4""",72420,72480
3842,407102,404202,60,72000,2,"""4""",72480,72540
3842,404202,117000,60,72000,2,"""4""",72540,72600
3842,117000,112106,120,72000,2,"""4""",72600,72720
3842,112106,103003,120,72000,2,"""4""",72720,72840
3842,103003,118002,120,72000,2,"""4""",72840,72960
3842,118002,106002,60,72000,2,"""4""",72960,73020
3842,106002,118102,60,72000,2,"""4""",73020,73080
3842,118102,101002,120,72000,2,"""4""",73080,73200
3842,101002,102002,60,72000,2,"""4""",73200,73260
3842,102002,101101,120,72000,2,"""4""",73260,73380
3842,101101,403802,120,72000,2,"""4""",73380,73500
3842,403802,408300,60,72000,2,"""4""",73500,73560
3842,408300,406502,60,72000,2,"""4""",73560,73620
3842,406502,407702,60,72000,2,"""4""",73620,73680
3842,407702,408403,60,72000,2,"""4""",73680,73740
3842,408403,403502,60,72000,2,"""4""",73740,73800
3842,403502,403701,60,72000,2,"""4""",73800,73860
3842,403701,404601,60,72000,2,"""4""",73860,73920
3842,407500,407503,60,75600,2,"""4""",75600,75660
3842,407503,408900,60,75600,2,"""4""",75660,75720
3842,408900,400802,60,75600,2,"""4""",75720,75780
3842,400802,400704,120,75600,2,"""4""",75780,75900
3842,400704,408503,60,75600,2,"""4""",75900,75960
3842,408503,405602,60,75600,2,"""4""",75960,76020
3842,405602,407102,60,75600,2,"""4""",76020,76080
3842,407102,404202,60,75600,2,"""4""",76080,76140
3842,404202,117000,60,75600,2,"""4""",76140,76200
3842,117000,112106,120,75600,2,"""4""",76200,76320
3842,112106,103003,120,75600,2,"""4""",76320,76440
3842,103003,118002,120,75600,2,"""4""",76440,76560
3842,118002,106002,60,75600,2,"""4""",76560,76620
3842,106002,118102,60,75600,2,"""4""",76620,76680
3842,118102,101002,120,75600,2,"""4""",76680,76800
3842,101002,102002,60,75600,2,"""4""",76800,76860
3842,102002,101101,120,75600,2,"""4""",76860,76980
3842,101101,403802,120,75600,2,"""4""",76980,77100
3842,403802,408300,60,75600,2,"""4""",77100,77160
3842,408300,406502,60,75600,2,"""4""",77160,77220
3842,406502,407702,60,75600,2,"""4""",77220,77280
3842,407702,408403,60,75600,2,"""4""",77280,77340
3842,408403,403502,60,75600,2,"""4""",77340,77400
3842,403502,403701,60,75600,2,"""4""",77400,77460
3842,403701,404601,60,75600,2,"""4""",77460,77520
3842,407500,407503,60,79200,2,"""4""",79200,79260
3842,407503,408900,60,79200,2,"""4""",79260,79320
3842,408900,400802,60,79200,2,"""4""",79320,79380
3842,400802,400704,120,79200,2,"""4""",79380,79500
3842,400704,408503,60,79200,2,"""4""",79500,79560
3842,408503,405602,60,79200,2,"""4""",79560,79620
3842,405602,407102,60,79200,2,"""4""",79620,79680
3842,407102,404202,60,79200,2,"""4""",79680,79740
3842,404202,117000,60,79200,2,"""4""",79740,79800
3842,117000,112106,120,79200,2,"""4""",79800,79920
3842,112106,103003,120,79200,2,"""4""",79920,80040
3842,103003,118002,120,79200,2,"""4""",80040,80160
3842,118002,106002,60,79200,2,"""4""",80160,80220
3842,106002,118102,60,79200,2,"""4""",80220,80280
3842,118102,101002,120,79200,2,"""4""",80280,80400
3842,101002,102002,60,79200,2,"""4""",80400,80460
3842,102002,101101,120,79200,2,"""4""",80460,80580
3842,101101,403802,120,79200,2,"""4""",80580,80700
3842,403802,408300,60,79200,2,"""4""",80700,80760
3842,408300,406502,60,79200,2,"""4""",80760,80820
3842,406502,407702,60,79200,2,"""4""",80820,80880
3842,407702,408403,60,79200,2,"""4""",80880,80940
3842,408403,403502,60,79200,2,"""4""",80940,81000
3842,403502,403701,60,79200,2,"""4""",81000,81060
3842,403701,404601,60,79200,2,"""4""",81060,81120
3842,407500,407503,60,82800,2,"""4""",82800,82860
3842,407503,408900,60,82800,2,"""4""",82860,82920
3842,408900,400802,60,82800,2,"""4""",82920,82980
3842,400802,400704,120,82800,2,"""4""",82980,83100
3842,400704,408503,60,82800,2,"""4""",83100,83160
3842,408503,405602,60,82800,2,"""4""",83160,83220
3842,405602,407102,60,82800,2,"""4""",83220,83280
3842,407102,404202,60,82800,2,"""4""",83280,83340
3842,404202,117000,60,82800,2,"""4""",83340,83400
3842,117000,112106,120,82800,2,"""4""",83400,83520
3842,112106,103003,120,82800,2,"""4""",83520,83640
3842,103003,118002,120,82800,2,"""4""",83640,83760
3842,118002,106002,60,82800,2,"""4""",83760,83820
3842,106002,118102,60,82800,2,"""4""",83820,83880
3842,118102,101002,120,82800,2,"""4""",83880,84000
3842,101002,102002,60,82800,2,"""4""",84000,84060
3842,102002,101101,120,82800,2,"""4""",84060,84180
3842,101101,403802,120,82800,2,"""4""",84180,84300
3842,403802,408300,60,82800,2,"""4""",84300,84360
3842,408300,406502,60,82800,2,"""4""",84360,84420
3842,406502,407702,60,82800,2,"""4""",84420,84480
3842,407702,408403,60,82800,2,"""4""",84480,84540
3842,408403,403502,60,82800,2,"""4""",84540,84600
3842,403502,403701,60,82800,2,"""4""",84600,84660
3842,403701,404601,60,82800,2,"""4""",84660,84720
3975,101001,118101,60,20460,4,"""3""",20460,20520
3975,118101,106001,60,20460,4,"""3""",20520,20580
3975,106001,118001,60,20460,4,"""3""",20580,20640
3975,118001,105001,120,20460,4,"""3""",20640,20760
3975,105001,34103,60,20460,4,"""3""",20760,20820
3975,34103,208102,120,20460,4,"""3""",20820,20940
3975,208102,201502,120,20460,4,"""3""",20940,21060
3975,201502,203903,60,20460,4,"""3""",21060,21120
3975,203903,201902,60,20460,4,"""3""",21120,21180
3975,201902,203601,60,20460,4,"""3""",21180,21240
3975,203601,204102,120,20460,4,"""3""",21240,21360
3975,204102,202001,120,20460,4,"""3""",21360,21480
3975,202001,200900,120,20460,4,"""3""",21480,21600
3980,203604,201903,60,34200,50,"""1""",34200,34260
3980,201903,203904,120,34200,50,"""1""",34260,34380
3980,203904,204802,60,34200,50,"""1""",34380,34440
3980,204802,204704,60,34200,50,"""1""",34440,34500
3980,204704,601103,120,34200,50,"""1""",34500,34620
3980,601103,600601,60,34200,50,"""1""",34620,34680
3980,600601,600901,60,34200,50,"""1""",34680,34740
3980,600901,603604,240,34200,50,"""1""",34740,34980
3980,603604,603600,60,34200,50,"""1""",34980,35040
3980,203604,201903,60,48600,50,"""1""",48600,48660
3980,201903,203904,120,48600,50,"""1""",48660,48780
3980,203904,204802,60,48600,50,"""1""",48780,48840
3980,204802,204704,60,48600,50,"""1""",48840,48900
3980,204704,601103,120,48600,50,"""1""",48900,49020
3980,601103,600601,60,48600,50,"""1""",49020,49080
3980,600601,600901,60,48600,50,"""1""",49080,49140
3980,600901,603604,240,48600,50,"""1""",49140,49380
3980,603604,603600,60,48600,50,"""1""",49380,49440
3980,203604,201903,60,51300,50,"""1""",51300,51360
3980,201903,203904,120,51300,50,"""1""",51360,51480
3980,203904,204802,60,51300,50,"""1""",51480,51540
3980,204802,204704,60,51300,50,"""1""",51540,51600
3980,204704,601103,120,51300,50,"""1""",51600,51720
3980,601103,600601,60,51300,50,"""1""",51720,51780
3980,600601,600901,60,51300,50,"""1""",51780,51840
3980,600901,603604,240,51300,50,"""1""",51840,52080
3980,603604,603600,60,51300,50,"""1""",52080,52140
3981,603600,603605,60,36840,50,"""2""",36840,36900
3981,603605,600902,120,36840,50,"""2""",36900,37020
3981,600902,601202,60,36840,50,"""2""",37020,37080
3981,601202,600602,60,36840,50,"""2""",37080,37140
3981,600602,601106,120,36840,50,"""2""",37140,37260
3981,601106,204703,120,36840,50,"""2""",37260,37380
3981,204703,204801,120,36840,50,"""2""",37380,37500
3981,204801,203903,120,36840,50,"""2""",37500,37620
3981,203903,207801,60,36840,50,"""2""",37620,37680
3981,207801,205501,120,36840,50,"""2""",37680,37800
3981,205501,203604,240,36840,50,"""2""",37800,38040
3981,603600,603605,60,50040,50,"""2""",50040,50100
3981,603605,600902,120,50040,50,"""2""",50100,50220
3981,600902,601202,60,50040,50,"""2""",50220,50280
3981,601202,600602,60,50040,50,"""2""",50280,50340
3981,600602,601106,120,50040,50,"""2""",50340,50460
3981,601106,204703,120,50040,50,"""2""",50460,50580
3981,204703,204801,120,50040,50,"""2""",50580,50700
3981,204801,203903,120,50040,50,"""2""",50700,50820
3981,203903,207801,60,50040,50,"""2""",50820,50880
3981,207801,205501,120,50040,50,"""2""",50880,51000
3981,205501,203604,240,50040,50,"""2""",51000,51240
3981,603600,603605,60,53940,50,"""2""",53940,54000
3981,603605,600902,120,53940,50,"""2""",54000,54120
3981,600902,601202,60,53940,50,"""2""",54120,54180
3981,601202,600602,60,53940,50,"""2""",54180,54240
3981,600602,601106,120,53940,50,"""2""",54240,54360
3981,601106,204703,120,53940,50,"""2""",54360,54480
3981,204703,204801,120,53940,50,"""2""",54480,54600
3981,204801,203903,120,53940,50,"""2""",54600,54720
3981,203903,207801,60,53940,50,"""2""",54720,54780
3981,207801,205501,120,53940,50,"""2""",54780,54900
3981,205501,203604,240,53940,50,"""2""",54900,55140
4119,502300,502600,0,23940,1,"""1""",23940,23940
4119,502600,502501,60,23940,1,"""1""",23940,24000
4119,502501,501702,120,23940,1,"""1""",24000,24120
4119,501702,501801,120,23940,1,"""1""",24120,24240
4119,501801,501601,60,23940,1,"""1""",24240,24300
4119,501601,500903,120,23940,1,"""1""",24300,24420
4119,500903,502801,60,23940,1,"""1""",24420,24480
4119,502801,101001,180,23940,1,"""1""",24480,24660
4119,101001,118101,60,23940,1,"""1""",24660,24720
4119,118101,106001,60,23940,1,"""1""",24720,24780
4119,106001,118001,120,23940,1,"""1""",24780,24900
4119,118001,103004,180,23940,1,"""1""",24900,25080
4119,103004,112101,180,23940,1,"""1""",25080,25260
4119,112101,117001,180,23940,1,"""1""",25260,25440
4119,117001,119003,120,23940,1,"""1""",25440,25560
4119,119003,208102,180,23940,1,"""1""",25560,25740
4119,208102,201502,120,23940,1,"""1""",25740,25860
4119,201502,203903,60,23940,1,"""1""",25860,25920
4119,203903,207801,60,23940,1,"""1""",25920,25980
4119,207801,205501,120,23940,1,"""1""",25980,26100
4119,205501,205602,60,23940,1,"""1""",26100,26160
4119,205602,201000,60,23940,1,"""1""",26160,26220
4119,201000,200400,60,23940,1,"""1""",26220,26280
4119,200400,204600,120,23940,1,"""1""",26280,26400
4119,502300,502600,0,24540,1,"""1""",24540,24540
4119,502600,502501,60,24540,1,"""1""",24540,24600
4119,502501,501702,120,24540,1,"""1""",24600,24720
4119,501702,501801,120,24540,1,"""1""",24720,24840
4119,501801,501601,60,24540,1,"""1""",24840,24900
4119,501601,500903,120,24540,1,"""1""",24900,25020
4119,500903,502801,60,24540,1,"""1""",25020,25080
4119,502801,101001,180,24540,1,"""1""",25080,25260
4119,101001,118101,60,24540,1,"""1""",25260,25320
4119,118101,106001,60,24540,1,"""1""",25320,25380
4119,106001,118001,120,24540,1,"""1""",25380,25500
4119,118001,103004,180,24540,1,"""1""",25500,25680
4119,103004,112101,180,24540,1,"""1""",25680,25860
4119,112101,117001,180,24540,1,"""1""",25860,26040
4119,117001,119003,120,24540,1,"""1""",26040,26160
4119,119003,208102,180,24540,1,"""1""",26160,26340
4119,208102,201502,120,24540,1,"""1""",26340,26460
4119,201502,203903,60,24540,1,"""1""",26460,26520
4119,203903,207801,60,24540,1,"""1""",26520,26580
4119,207801,205501,120,24540,1,"""1""",26580,26700
4119,205501,205602,60,24540,1,"""1""",26700,26760
4119,205602,201000,60,24540,1,"""1""",26760,26820
4119,201000,200400,60,24540,1,"""1""",26820,26880
4119,200400,204600,120,24540,1,"""1""",26880,27000
4119,502300,502600,0,25140,1,"""1""",25140,25140
4119,502600,502501,60,25140,1,"""1""",25140,25200
4119,502501,501702,120,25140,1,"""1""",25200,25320
4119,501702,501801,120,25140,1,"""1""",25320,25440
4119,501801,501601,60,25140,1,"""1""",25440,25500
4119,501601,500903,120,25140,1,"""1""",25500,25620
4119,500903,502801,60,25140,1,"""1""",25620,25680
4119,502801,101001,180,25140,1,"""1""",25680,25860
4119,101001,118101,60,25140,1,"""1""",25860,25920
4119,118101,106001,60,25140,1,"""1""",25920,25980
4119,106001,118001,120,25140,1,"""1""",25980,26100
4119,118001,103004,180,25140,1,"""1""",26100,26280
4119,103004,112101,180,25140,1,"""1""",26280,26460
4119,112101,117001,180,25140,1,"""1""",26460,26640
4119,117001,119003,120,25140,1,"""1""",26640,26760
4119,119003,208102,180,25140,1,"""1""",26760,26940
4119,208102,201502,120,25140,1,"""1""",26940,27060
4119,201502,203903,60,25140,1,"""1""",27060,27120
4119,203903,207801,60,25140,1,"""1""",27120,27180
4119,207801,205501,120,25140,1,"""1""",27180,27300
4119,205501,205602,60,25140,1,"""1""",27300,27360
4119,205602,201000,60,25140,1,"""1""",27360,27420
4119,201000,200400,60,25140,1,"""1""",27420,27480
4119,200400,204600,120,25140,1,"""1""",27480,27600
4119,502300,502600,0,25740,1,"""1""",25740,25740
4119,502600,502501,60,25740,1,"""1""",25740,25800
4119,502501,501702,120,25740,1,"""1""",25800,25920
4119,501702,501801,120,25740,1,"""1""",25920,26040
4119,501801,501601,60,25740,1,"""1""",26040,26100
4119,501601,500903,120,25740,1,"""1""",26100,26220
4119,500903,502801,60,25740,1,"""1""",26220,26280
4119,502801,101001,180,25740,1,"""1""",26280,26460
4119,101001,118101,60,25740,1,"""1""",26460,26520
4119,118101,106001,60,25740,1,"""1""",26520,26580
4119,106001,118001,120,25740,1,"""1""",26580,26700
4119,118001,103004,180,25740,1,"""1""",26700,26880
4119,103004,112101,180,25740,1,"""1""",26880,27060
4119,112101,117001,180,25740,1,"""1""",27060,27240
4119,117001,119003,120,25740,1,"""1""",27240,27360
4119,119003,208102,180,25740,1,"""1""",27360,27540
4119,208102,201502,120,25740,1,"""1""",27540,27660
4119,201502,203903,60,25740,1,"""1""",27660,27720
4119,203903,207801,60,25740,1,"""1""",27720,27780
4119,207801,205501,120,25740,1,"""1""",27780,27900
4119,205501,205602,60,25740,1,"""1""",27900,27960
4119,205602,201000,60,25740,1,"""1""",27960,28020
4119,201000,200400,60,25740,1,"""1""",28020,28080
4119,200400,204600,120,25740,1,"""1""",28080,28200
4119,502300,502600,0,26340,1,"""1""",26340,26340
4119,502600,502501,60,26340,1,"""1""",26340,26400
4119,502501,501702,120,26340,1,"""1""",26400,26520
4119,501702,501801,120,26340,1,"""1""",26520,26640
4119,501801,501601,60,26340,1,"""1""",26640,26700
4119,501601,500903,120,26340,1,"""1""",26700,26820
4119,500903,502801,60,26340,1,"""1""",26820,26880
4119,502801,101001,180,26340,1,"""1""",26880,27060
4119,101001,118101,60,26340,1,"""1""",27060,27120
4119,118101,106001,60,26340,1,"""1""",27120,27180
4119,106001,118001,120,26340,1,"""1""",27180,27300
4119,118001,103004,180,26340,1,"""1""",27300,27480
4119,103004,112101,180,26340,1,"""1""",27480,27660
4119,112101,117001,180,26340,1,"""1""",27660,27840
4119,117001,119003,120,26340,1,"""1""",27840,27960
4119,119003,208102,180,26340,1,"""1""",27960,28140
4119,208102,201502,120,26340,1,"""1""",28140,28260
4119,201502,203903,60,26340,1,"""1""",28260,28320
4119,203903,207801,60,26340,1,"""1""",28320,28380
4119,207801,205501,120,26340,1,"""1""",28380,28500
4119,205501,205602,60,26340,1,"""1""",28500,28560
4119,205602,201000,60,26340,1,"""1""",28560,28620
4119,201000,200400,60,26340,1,"""1""",28620,28680
4119,200400,204600,120,26340,1,"""1""",28680,28800
4119,502300,502600,0,26940,1,"""1""",26940,26940
4119,502600,502501,60,26940,1,"""1""",26940,27000
4119,502501,501702,120,26940,1,"""1""",27000,27120
4119,501702,501801,120,26940,1,"""1""",27120,27240
4119,501801,501601,60,26940,1,"""1""",27240,27300
4119,501601,500903,120,26940,1,"""1""",27300,27420
4119,500903,502801,60,26940,1,"""1""",27420,27480
4119,502801,101001,180,26940,1,"""1""",27480,27660
4119,101001,118101,60,26940,1,"""1""",27660,27720
4119,118101,106001,60,26940,1,"""1""",27720,27780
4119,106001,118001,120,26940,1,"""1""",27780,27900
4119,118001,103004,180,26940,1,"""1""",27900,28080
4119,103004,112101,180,26940,1,"""1""",28080,28260
4119,112101,117001,180,26940,1,"""1""",28260,28440
4119,117001,119003,120,26940,1,"""1""",28440,28560
4119,119003,208102,180,26940,1,"""1""",28560,28740
4119,208102,201502,120,26940,1,"""1""",28740,28860
4119,201502,203903,60,26940,1,"""1""",28860,28920
4119,203903,207801,60,26940,1,"""1""",28920,28980
4119,207801,205501,120,26940,1,"""1""",28980,29100
4119,205501,205602,60,26940,1,"""1""",29100,29160
4119,205602,201000,60,26940,1,"""1""",29160,29220
4119,201000,200400,60,26940,1,"""1""",29220,29280
4119,200400,204600,120,26940,1,"""1""",29280,29400
4119,502300,502600,0,27540,1,"""1""",27540,27540
4119,502600,502501,60,27540,1,"""1""",27540,27600
4119,502501,501702,120,27540,1,"""1""",27600,27720
4119,501702,501801,120,27540,1,"""1""",27720,27840
4119,501801,501601,60,27540,1,"""1""",27840,27900
4119,501601,500903,120,27540,1,"""1""",27900,28020
4119,500903,502801,60,27540,1,"""1""",28020,28080
4119,502801,101001,180,27540,1,"""1""",28080,28260
4119,101001,118101,60,27540,1,"""1""",28260,28320
4119,118101,106001,60,27540,1,"""1""",28320,28380
4119,106001,118001,120,27540,1,"""1""",28380,28500
4119,118001,103004,180,27540,1,"""1""",28500,28680
4119,103004,112101,180,27540,1,"""1""",28680,28860
4119,112101,117001,180,27540,1,"""1""",28860,29040
4119,117001,119003,120,27540,1,"""1""",29040,29160
4119,119003,208102,180,27540,1,"""1""",29160,29340
4119,208102,201502,120,27540,1,"""1""",29340,29460
4119,201502,203903,60,27540,1,"""1""",29460,29520
4119,203903,207801,60,27540,1,"""1""",29520,29580
4119,207801,205501,120,27540,1,"""1""",29580,29700
4119,205501,205602,60,27540,1,"""1""",29700,29760
4119,205602,201000,60,27540,1,"""1""",29760,29820
4119,201000,200400,60,27540,1,"""1""",29820,29880
4119,200400,204600,120,27540,1,"""1""",29880,30000
4119,502300,502600,0,28140,1,"""1""",28140,28140
4119,502600,502501,60,28140,1,"""1""",28140,28200
4119,502501,501702,120,28140,1,"""1""",28200,28320
4119,501702,501801,120,28140,1,"""1""",28320,28440
4119,501801,501601,60,28140,1,"""1""",28440,28500
4119,501601,500903,120,28140,1,"""1""",28500,28620
4119,500903,502801,60,28140,1,"""1""",28620,28680
4119,502801,101001,180,28140,1,"""1""",28680,28860
4119,101001,118101,60,28140,1,"""1""",28860,28920
4119,118101,106001,60,28140,1,"""1""",28920,28980
4119,106001,118001,120,28140,1,"""1""",28980,29100
4119,118001,103004,180,28140,1,"""1""",29100,29280
4119,103004,112101,180,28140,1,"""1""",29280,29460
4119,112101,117001,180,28140,1,"""1""",29460,29640
4119,117001,119003,120,28140,1,"""1""",29640,29760
4119,119003,208102,180,28140,1,"""1""",29760,29940
4119,208102,201502,120,28140,1,"""1""",29940,30060
4119,201502,203903,60,28140,1,"""1""",30060,30120
4119,203903,207801,60,28140,1,"""1""",30120,30180
4119,207801,205501,120,28140,1,"""1""",30180,30300
4119,205501,205602,60,28140,1,"""1""",30300,30360
4119,205602,201000,60,28140,1,"""1""",30360,30420
4119,201000,200400,60,28140,1,"""1""",30420,30480
4119,200400,204600,120,28140,1,"""1""",30480,30600
4119,502300,502600,0,28740,1,"""1""",28740,28740
4119,502600,502501,60,28740,1,"""1""",28740,28800
4119,502501,501702,120,28740,1,"""1""",28800,28920
4119,501702,501801,120,28740,1,"""1""",28920,29040
4119,501801,501601,60,28740,1,"""1""",29040,29100
4119,501601,500903,120,28740,1,"""1""",29100,29220
4119,500903,502801,60,28740,1,"""1""",29220,29280
4119,502801,101001,180,28740,1,"""1""",29280,29460
4119,101001,118101,60,28740,1,"""1""",29460,29520
4119,118101,106001,60,28740,1,"""1""",29520,29580
4119,106001,118001,120,28740,1,"""1""",29580,29700
4119,118001,103004,180,28740,1,"""1""",29700,29880
4119,103004,112101,180,28740,1,"""1""",29880,30060
4119,112101,117001,180,28740,1,"""1""",30060,30240
4119,117001,119003,120,28740,1,"""1""",30240,30360
4119,119003,208102,180,28740,1,"""1""",30360,30540
4119,208102,201502,120,28740,1,"""1""",30540,30660
4119,201502,203903,60,28740,1,"""1""",30660,30720
4119,203903,207801,60,28740,1,"""1""",30720,30780
4119,207801,205501,120,28740,1,"""1""",30780,30900
4119,205501,205602,60,28740,1,"""1""",30900,30960
4119,205602,201000,60,28740,1,"""1""",30960,31020
4119,201000,200400,60,28740,1,"""1""",31020,31080
4119,200400,204600,120,28740,1,"""1""",31080,31200
4119,502300,502600,0,29340,1,"""1""",29340,29340
4119,502600,502501,60,29340,1,"""1""",29340,29400
4119,502501,501702,120,29340,1,"""1""",29400,29520
4119,501702,501801,120,29340,1,"""1""",29520,29640
4119,501801,501601,60,29340,1,"""1""",29640,29700
4119,501601,500903,120,29340,1,"""1""",29700,29820
4119,500903,502801,60,29340,1,"""1""",29820,29880
4119,502801,101001,180,29340,1,"""1""",29880,30060
4119,101001,118101,60,29340,1,"""1""",30060,30120
4119,118101,106001,60,29340,1,"""1""",30120,30180
4119,106001,118001,120,29340,1,"""1""",30180,30300
4119,118001,103004,180,29340,1,"""1""",30300,30480
4119,103004,112101,180,29340,1,"""1""",30480,30660
4119,112101,117001,180,29340,1,"""1""",30660,30840
4119,117001,119003,120,29340,1,"""1""",30840,30960
4119,119003,208102,180,29340,1,"""1""",30960,31140
4119,208102,201502,120,29340,1,"""1""",31140,31260
4119,201502,203903,60,29340,1,"""1""",31260,31320
4119,203903,207801,60,29340,1,"""1""",31320,31380
4119,207801,205501,120,29340,1,"""1""",31380,31500
4119,205501,205602,60,29340,1,"""1""",31500,31560
4119,205602,201000,60,29340,1,"""1""",31560,31620
4119,201000,200400,60,29340,1,"""1""",31620,31680
4119,200400,204600,120,29340,1,"""1""",31680,31800
4119,502300,502600,0,29940,1,"""1""",29940,29940
4119,502600,502501,60,29940,1,"""1""",29940,30000
4119,502501,501702,120,29940,1,"""1""",30000,30120
4119,501702,501801,120,29940,1,"""1""",30120,30240
4119,501801,501601,60,29940,1,"""1""",30240,30300
4119,501601,500903,120,29940,1,"""1""",30300,30420
4119,500903,502801,60,29940,1,"""1""",30420,30480
4119,502801,101001,180,29940,1,"""1""",30480,30660
4119,101001,118101,60,29940,1,"""1""",30660,30720
4119,118101,106001,60,29940,1,"""1""",30720,30780
4119,106001,118001,120,29940,1,"""1""",30780,30900
4119,118001,103004,180,29940,1,"""1""",30900,31080
4119,103004,112101,180,29940,1,"""1""",31080,31260
4119,112101,117001,180,29940,1,"""1""",31260,31440
4119,117001,119003,120,29940,1,"""1""",31440,31560
4119,119003,208102,180,29940,1,"""1""",31560,31740
4119,208102,201502,120,29940,1,"""1""",31740,31860
4119,201502,203903,60,29940,1,"""1""",31860,31920
4119,203903,207801,60,29940,1,"""1""",31920,31980
4119,207801,205501,120,29940,1,"""1""",31980,32100
4119,205501,205602,60,29940,1,"""1""",32100,32160
4119,205602,201000,60,29940,1,"""1""",32160,32220
4119,201000,200400,60,29940,1,"""1""",32220,32280
4119,200400,204600,120,29940,1,"""1""",32280,32400
4119,502300,502600,0,30540,1,"""1""",30540,30540
4119,502600,502501,60,30540,1,"""1""",30540,30600
4119,502501,501702,120,30540,1,"""1""",30600,30720
4119,501702,501801,120,30540,1,"""1""",30720,30840
4119,501801,501601,60,30540,1,"""1""",30840,30900
4119,501601,500903,120,30540,1,"""1""",30900,31020
4119,500903,502801,60,30540,1,"""1""",31020,31080
4119,502801,101001,180,30540,1,"""1""",31080,31260
4119,101001,118101,60,30540,1,"""1""",31260,31320
4119,118101,106001,60,30540,1,"""1""",31320,31380
4119,106001,118001,120,30540,1,"""1""",31380,31500
4119,118001,103004,180,30540,1,"""1""",31500,31680
4119,103004,112101,180,30540,1,"""1""",31680,31860
4119,112101,117001,180,30540,1,"""1""",31860,32040
4119,117001,119003,120,30540,1,"""1""",32040,32160
4119,119003,208102,180,30540,1,"""1""",32160,32340
4119,208102,201502,120,30540,1,"""1""",32340,32460
4119,201502,203903,60,30540,1,"""1""",32460,32520
4119,203903,207801,60,30540,1,"""1""",32520,32580
4119,207801,205501,120,30540,1,"""1""",32580,32700
4119,205501,205602,60,30540,1,"""1""",32700,32760
4119,205602,201000,60,30540,1,"""1""",32760,32820
4119,201000,200400,60,30540,1,"""1""",32820,32880
4119,200400,204600,120,30540,1,"""1""",32880,33000
4119,502300,502600,0,31140,1,"""1""",31140,31140
4119,502600,502501,60,31140,1,"""1""",31140,31200
4119,502501,501702,120,31140,1,"""1""",31200,31320
4119,501702,501801,120,31140,1,"""1""",31320,31440
4119,501801,501601,60,31140,1,"""1""",31440,31500
4119,501601,500903,120,31140,1,"""1""",31500,31620
4119,500903,502801,60,31140,1,"""1""",31620,31680
4119,502801,101001,180,31140,1,"""1""",31680,31860
4119,101001,118101,60,31140,1,"""1""",31860,31920
4119,118101,106001,60,31140,1,"""1""",31920,31980
4119,106001,118001,120,31140,1,"""1""",31980,32100
4119,118001,103004,180,31140,1,"""1""",32100,32280
4119,103004,112101,180,31140,1,"""1""",32280,32460
4119,112101,117001,180,31140,1,"""1""",32460,32640
4119,117001,119003,120,31140,1,"""1""",32640,32760
4119,119003,208102,180,31140,1,"""1""",32760,32940
4119,208102,201502,120,31140,1,"""1""",32940,33060
4119,201502,203903,60,31140,1,"""1""",33060,33120
4119,203903,207801,60,31140,1,"""1""",33120,33180
4119,207801,205501,120,31140,1,"""1""",33180,33300
4119,205501,205602,60,31140,1,"""1""",33300,33360
4119,205602,201000,60,31140,1,"""1""",33360,33420
4119,201000,200400,60,31140,1,"""1""",33420,33480
4119,200400,204600,120,31140,1,"""1""",33480,33600
4119,502300,502600,0,31740,1,"""1""",31740,31740
4119,502600,502501,60,31740,1,"""1""",31740,31800
4119,502501,501702,120,31740,1,"""1""",31800,31920
4119,501702,501801,120,31740,1,"""1""",31920,32040
4119,501801,501601,60,31740,1,"""1""",32040,32100
4119,501601,500903,120,31740,1,"""1""",32100,32220
4119,500903,502801,60,31740,1,"""1""",32220,32280
4119,502801,101001,180,31740,1,"""1""",32280,32460
4119,101001,118101,60,31740,1,"""1""",32460,32520
4119,118101,106001,60,31740,1,"""1""",32520,32580
4119,106001,118001,120,31740,1,"""1""",32580,32700
4119,118001,103004,180,31740,1,"""1""",32700,32880
4119,103004,112101,180,31740,1,"""1""",32880,33060
4119,112101,117001,180,31740,1,"""1""",33060,33240
4119,117001,119003,120,31740,1,"""1""",33240,33360
4119,119003,208102,180,31740,1,"""1""",33360,33540
4119,208102,201502,120,31740,1,"""1""",33540,33660
4119,201502,203903,60,31740,1,"""1""",33660,33720
4119,203903,207801,60,31740,1,"""1""",33720,33780
4119,207801,205501,120,31740,1,"""1""",33780,33900
4119,205501,205602,60,31740,1,"""1""",33900,33960
4119,205602,201000,60,31740,1,"""1""",33960,34020
4119,201000,200400,60,31740,1,"""1""",34020,34080
4119,200400,204600,120,31740,1,"""1""",34080,34200
4119,502300,502600,0,32340,1,"""1""",32340,32340
4119,502600,502501,60,32340,1,"""1""",32340,32400
4119,502501,501702,120,32340,1,"""1""",32400,32520
4119,501702,501801,120,32340,1,"""1""",32520,32640
4119,501801,501601,60,32340,1,"""1""",32640,32700
4119,501601,500903,120,32340,1,"""1""",32700,32820
4119,500903,502801,60,32340,1,"""1""",32820,32880
4119,502801,101001,180,32340,1,"""1""",32880,33060
4119,101001,118101,60,32340,1,"""1""",33060,33120
4119,118101,106001,60,32340,1,"""1""",33120,33180
4119,106001,118001,120,32340,1,"""1""",33180,33300
4119,118001,103004,180,32340,1,"""1""",33300,33480
4119,103004,112101,180,32340,1,"""1""",33480,33660
4119,112101,117001,180,32340,1,"""1""",33660,33840
4119,117001,119003,120,32340,1,"""1""",33840,33960
4119,119003,208102,180,32340,1,"""1""",33960,34140
4119,208102,201502,120,32340,1,"""1""",34140,34260
4119,201502,203903,60,32340,1,"""1""",34260,34320
4119,203903,207801,60,32340,1,"""1""",34320,34380
4119,207801,205501,120,32340,1,"""1""",34380,34500
4119,205501,205602,60,32340,1,"""1""",34500,34560
4119,205602,201000,60,32340,1,"""1""",34560,34620
4119,201000,200400,60,32340,1,"""1""",34620,34680
4119,200400,204600,120,32340,1,"""1""",34680,34800
4119,502300,502600,0,32940,1,"""1""",32940,32940
4119,502600,502501,60,32940,1,"""1""",32940,33000
4119,502501,501702,120,32940,1,"""1""",33000,33120
4119,501702,501801,120,32940,1,"""1""",33120,33240
4119,501801,501601,60,32940,1,"""1""",33240,33300
4119,501601,500903,120,32940,1,"""1""",33300,33420
4119,500903,502801,60,32940,1,"""1""",33420,33480
4119,502801,101001,180,32940,1,"""1""",33480,33660
4119,101001,118101,60,32940,1,"""1""",33660,33720
4119,118101,106001,60,32940,1,"""1""",33720,33780
4119,106001,118001,120,32940,1,"""1""",33780,33900
4119,118001,103004,180,32940,1,"""1""",33900,34080
4119,103004,112101,180,32940,1,"""1""",34080,34260
4119,112101,117001,180,32940,1,"""1""",34260,34440
4119,117001,119003,120,32940,1,"""1""",34440,34560
4119,119003,208102,180,32940,1,"""1""",34560,34740
4119,208102,201502,120,32940,1,"""1""",34740,34860
4119,201502,203903,60,32940,1,"""1""",34860,34920
4119,203903,207801,60,32940,1,"""1""",34920,34980
4119,207801,205501,120,32940,1,"""1""",34980,35100
4119,205501,205602,60,32940,1,"""1""",35100,35160
4119,205602,201000,60,32940,1,"""1""",35160,35220
4119,201000,200400,60,32940,1,"""1""",35220,35280
4119,200400,204600,120,32940,1,"""1""",35280,35400
4119,502300,502600,0,33540,1,"""1""",33540,33540
4119,502600,502501,60,33540,1,"""1""",33540,33600
4119,502501,501702,120,33540,1,"""1""",33600,33720
4119,501702,501801,120,33540,1,"""1""",33720,33840
4119,501801,501601,60,33540,1,"""1""",33840,33900
4119,501601,500903,120,33540,1,"""1""",33900,34020
4119,500903,502801,60,33540,1,"""1""",34020,34080
4119,502801,101001,180,33540,1,"""1""",34080,34260
4119,101001,118101,60,33540,1,"""1""",34260,34320
4119,118101,106001,60,33540,1,"""1""",34320,34380
4119,106001,118001,120,33540,1,"""1""",34380,34500
4119,118001,103004,180,33540,1,"""1""",34500,34680
4119,103004,112101,180,33540,1,"""1""",34680,34860
4119,112101,117001,180,33540,1,"""1""",34860,35040
4119,117001,119003,120,33540,1,"""1""",35040,35160
4119,119003,208102,180,33540,1,"""1""",35160,35340
4119,208102,201502,120,33540,1,"""1""",35340,35460
4119,201502,203903,60,33540,1,"""1""",35460,35520
4119,203903,207801,60,33540,1,"""1""",35520,35580
4119,207801,205501,120,33540,1,"""1""",35580,35700
4119,205501,205602,60,33540,1,"""1""",35700,35760
4119,205602,201000,60,33540,1,"""1""",35760,35820
4119,201000,200400,60,33540,1,"""1""",35820,35880
4119,200400,204600,120,33540,1,"""1""",35880,36000
4119,502300,502600,0,34140,1,"""1""",34140,34140
4119,502600,502501,60,34140,1,"""1""",34140,34200
4119,502501,501702,120,34140,1,"""1""",34200,34320
4119,501702,501801,120,34140,1,"""1""",34320,34440
4119,501801,501601,60,34140,1,"""1""",34440,34500
4119,501601,500903,120,34140,1,"""1""",34500,34620
4119,500903,502801,60,34140,1,"""1""",34620,34680
4119,502801,101001,180,34140,1,"""1""",34680,34860
4119,101001,118101,60,34140,1,"""1""",34860,34920
4119,118101,106001,60,34140,1,"""1""",34920,34980
4119,106001,118001,120,34140,1,"""1""",34980,35100
4119,118001,103004,180,34140,1,"""1""",35100,35280
4119,103004,112101,180,34140,1,"""1""",35280,35460
4119,112101,117001,180,34140,1,"""1""",35460,35640
4119,117001,119003,120,34140,1,"""1""",35640,35760
4119,119003,208102,180,34140,1,"""1""",35760,35940
4119,208102,201502,120,34140,1,"""1""",35940,36060
4119,201502,203903,60,34140,1,"""1""",36060,36120
4119,203903,207801,60,34140,1,"""1""",36120,36180
4119,207801,205501,120,34140,1,"""1""",36180,36300
4119,205501,205602,60,34140,1,"""1""",36300,36360
4119,205602,201000,60,34140,1,"""1""",36360,36420
4119,201000,200400,60,34140,1,"""1""",36420,36480
4119,200400,204600,120,34140,1,"""1""",36480,36600
4119,502300,502600,0,34740,1,"""1""",34740,34740
4119,502600,502501,60,34740,1,"""1""",34740,34800
4119,502501,501702,120,34740,1,"""1""",34800,34920
4119,501702,501801,120,34740,1,"""1""",34920,35040
4119,501801,501601,60,34740,1,"""1""",35040,35100
4119,501601,500903,120,34740,1,"""1""",35100,35220
4119,500903,502801,60,34740,1,"""1""",35220,35280
4119,502801,101001,180,34740,1,"""1""",35280,35460
4119,101001,118101,60,34740,1,"""1""",35460,35520
4119,118101,106001,60,34740,1,"""1""",35520,35580
4119,106001,118001,120,34740,1,"""1""",35580,35700
4119,118001,103004,180,34740,1,"""1""",35700,35880
4119,103004,112101,180,34740,1,"""1""",35880,36060
4119,112101,117001,180,34740,1,"""1""",36060,36240
4119,117001,119003,120,34740,1,"""1""",36240,36360
4119,119003,208102,180,34740,1,"""1""",36360,36540
4119,208102,201502,120,34740,1,"""1""",36540,36660
4119,201502,203903,60,34740,1,"""1""",36660,36720
4119,203903,207801,60,34740,1,"""1""",36720,36780
4119,207801,205501,120,34740,1,"""1""",36780,36900
4119,205501,205602,60,34740,1,"""1""",36900,36960
4119,205602,201000,60,34740,1,"""1""",36960,37020
4119,201000,200400,60,34740,1,"""1""",37020,37080
4119,200400,204600,120,34740,1,"""1""",37080,37200
4119,502300,502600,0,35340,1,"""1""",35340,35340
4119,502600,502501,60,35340,1,"""1""",35340,35400
4119,502501,501702,120,35340,1,"""1""",35400,35520
4119,501702,501801,120,35340,1,"""1""",35520,35640
4119,501801,501601,60,35340,1,"""1""",35640,35700
4119,501601,500903,120,35340,1,"""1""",35700,35820
4119,500903,502801,60,35340,1,"""1""",35820,35880
4119,502801,101001,180,35340,1,"""1""",35880,36060
4119,101001,118101,60,35340,1,"""1""",36060,36120
4119,118101,106001,60,35340,1,"""1""",36120,36180
4119,106001,118001,120,35340,1,"""1""",36180,36300
4119,118001,103004,180,35340,1,"""1""",36300,36480
4119,103004,112101,180,35340,1,"""1""",36480,36660
4119,112101,117001,180,35340,1,"""1""",36660,36840
4119,117001,119003,120,35340,1,"""1""",36840,36960
4119,119003,208102,180,35340,1,"""1""",36960,37140
4119,208102,201502,120,35340,1,"""1""",37140,37260
4119,201502,203903,60,35340,1,"""1""",37260,37320
4119,203903,207801,60,35340,1,"""1""",37320,37380
4119,207801,205501,120,35340,1,"""1""",37380,37500
4119,205501,205602,60,35340,1,"""1""",37500,37560
4119,205602,201000,60,35340,1,"""1""",37560,37620
4119,201000,200400,60,35340,1,"""1""",37620,37680
4119,200400,204600,120,35340,1,"""1""",37680,37800
4119,502300,502600,0,35940,1,"""1""",35940,35940
4119,502600,502501,60,35940,1,"""1""",35940,36000
4119,502501,501702,120,35940,1,"""1""",36000,36120
4119,501702,501801,120,35940,1,"""1""",36120,36240
4119,501801,501601,60,35940,1,"""1""",36240,36300
4119,501601,500903,120,35940,1,"""1""",36300,36420
4119,500903,502801,60,35940,1,"""1""",36420,36480
4119,502801,101001,180,35940,1,"""1""",36480,36660
4119,101001,118101,60,35940,1,"""1""",36660,36720
4119,118101,106001,60,35940,1,"""1""",36720,36780
4119,106001,118001,120,35940,1,"""1""",36780,36900
4119,118001,103004,180,35940,1,"""1""",36900,37080
4119,103004,112101,180,35940,1,"""1""",37080,37260
4119,112101,117001,180,35940,1,"""1""",37260,37440
4119,117001,119003,120,35940,1,"""1""",37440,37560
4119,119003,208102,180,35940,1,"""1""",37560,37740
4119,208102,201502,120,35940,1,"""1""",37740,37860
4119,201502,203903,60,35940,1,"""1""",37860,37920
4119,203903,207801,60,35940,1,"""1""",37920,37980
4119,207801,205501,120,35940,1,"""1""",37980,38100
4119,205501,205602,60,35940,1,"""1""",38100,38160
4119,205602,201000,60,35940,1,"""1""",38160,38220
4119,201000,200400,60,35940,1,"""1""",38220,38280
4119,200400,204600,120,35940,1,"""1""",38280,38400
4119,502300,502600,0,36540,1,"""1""",36540,36540
4119,502600,502501,60,36540,1,"""1""",36540,36600
4119,502501,501702,120,36540,1,"""1""",36600,36720
4119,501702,501801,120,36540,1,"""1""",36720,36840
4119,501801,501601,60,36540,1,"""1""",36840,36900
4119,501601,500903,120,36540,1,"""1""",36900,37020
4119,500903,502801,60,36540,1,"""1""",37020,37080
4119,502801,101001,180,36540,1,"""1""",37080,37260
4119,101001,118101,60,36540,1,"""1""",37260,37320
4119,118101,106001,60,36540,1,"""1""",37320,37380
4119,106001,118001,120,36540,1,"""1""",37380,37500
4119,118001,103004,180,36540,1,"""1""",37500,37680
4119,103004,112101,180,36540,1,"""1""",37680,37860
4119,112101,117001,180,36540,1,"""1""",37860,38040
4119,117001,119003,120,36540,1,"""1""",38040,38160
4119,119003,208102,180,36540,1,"""1""",38160,38340
4119,208102,201502,120,36540,1,"""1""",38340,38460
4119,201502,203903,60,36540,1,"""1""",38460,38520
4119,203903,207801,60,36540,1,"""1""",38520,38580
4119,207801,205501,120,36540,1,"""1""",38580,38700
4119,205501,205602,60,36540,1,"""1""",38700,38760
4119,205602,201000,60,36540,1,"""1""",38760,38820
4119,201000,200400,60,36540,1,"""1""",38820,38880
4119,200400,204600,120,36540,1,"""1""",38880,39000
4119,502300,502600,0,37140,1,"""1""",37140,37140
4119,502600,502501,60,37140,1,"""1""",37140,37200
4119,502501,501702,120,37140,1,"""1""",37200,37320
4119,501702,501801,120,37140,1,"""1""",37320,37440
4119,501801,501601,60,37140,1,"""1""",37440,37500
4119,501601,500903,120,37140,1,"""1""",37500,37620
4119,500903,502801,60,37140,1,"""1""",37620,37680
4119,502801,101001,180,37140,1,"""1""",37680,37860
4119,101001,118101,60,37140,1,"""1""",37860,37920
4119,118101,106001,60,37140,1,"""1""",37920,37980
4119,106001,118001,120,37140,1,"""1""",37980,38100
4119,118001,103004,180,37140,1,"""1""",38100,38280
4119,103004,112101,180,37140,1,"""1""",38280,38460
4119,112101,117001,180,37140,1,"""1""",38460,38640
4119,117001,119003,120,37140,1,"""1""",38640,38760
4119,119003,208102,180,37140,1,"""1""",38760,38940
4119,208102,201502,120,37140,1,"""1""",38940,39060
4119,201502,203903,60,37140,1,"""1""",39060,39120
4119,203903,207801,60,37140,1,"""1""",39120,39180
4119,207801,205501,120,37140,1,"""1""",39180,39300
4119,205501,205602,60,37140,1,"""1""",39300,39360
4119,205602,201000,60,37140,1,"""1""",39360,39420
4119,201000,200400,60,37140,1,"""1""",39420,39480
4119,200400,204600,120,37140,1,"""1""",39480,39600
4119,502300,502600,0,37740,1,"""1""",37740,37740
4119,502600,502501,60,37740,1,"""1""",37740,37800
4119,502501,501702,120,37740,1,"""1""",37800,37920
4119,501702,501801,120,37740,1,"""1""",37920,38040
4119,501801,501601,60,37740,1,"""1""",38040,38100
4119,501601,500903,120,37740,1,"""1""",38100,38220
4119,500903,502801,60,37740,1,"""1""",38220,38280
4119,502801,101001,180,37740,1,"""1""",38280,38460
4119,101001,118101,60,37740,1,"""1""",38460,38520
4119,118101,106001,60,37740,1,"""1""",38520,38580
4119,106001,118001,120,37740,1,"""1""",38580,38700
4119,118001,103004,180,37740,1,"""1""",38700,38880
4119,103004,112101,180,37740,1,"""1""",38880,39060
4119,112101,117001,180,37740,1,"""1""",39060,39240
4119,117001,119003,120,37740,1,"""1""",39240,39360
4119,119003,208102,180,37740,1,"""1""",39360,39540
4119,208102,201502,120,37740,1,"""1""",39540,39660
4119,201502,203903,60,37740,1,"""1""",39660,39720
4119,203903,207801,60,37740,1,"""1""",39720,39780
4119,207801,205501,120,37740,1,"""1""",39780,39900
4119,205501,205602,60,37740,1,"""1""",39900,39960
4119,205602,201000,60,37740,1,"""1""",39960,40020
4119,201000,200400,60,37740,1,"""1""",40020,40080
4119,200400,204600,120,37740,1,"""1""",40080,40200
4119,502300,502600,0,38340,1,"""1""",38340,38340
4119,502600,502501,60,38340,1,"""1""",38340,38400
4119,502501,501702,120,38340,1,"""1""",38400,38520
4119,501702,501801,120,38340,1,"""1""",38520,38640
4119,501801,501601,60,38340,1,"""1""",38640,38700
4119,501601,500903,120,38340,1,"""1""",38700,38820
4119,500903,502801,60,38340,1,"""1""",38820,38880
4119,502801,101001,180,38340,1,"""1""",38880,39060
4119,101001,118101,60,38340,1,"""1""",39060,39120
4119,118101,106001,60,38340,1,"""1""",39120,39180
4119,106001,118001,120,38340,1,"""1""",39180,39300
4119,118001,103004,180,38340,1,"""1""",39300,39480
4119,103004,112101,180,38340,1,"""1""",39480,39660
4119,112101,117001,180,38340,1,"""1""",39660,39840
4119,117001,119003,120,38340,1,"""1""",39840,39960
4119,119003,208102,180,38340,1,"""1""",39960,40140
4119,208102,201502,120,38340,1,"""1""",40140,40260
4119,201502,203903,60,38340,1,"""1""",40260,40320
4119,203903,207801,60,38340,1,"""1""",40320,40380
4119,207801,205501,120,38340,1,"""1""",40380,40500
4119,205501,205602,60,38340,1,"""1""",40500,40560
4119,205602,201000,60,38340,1,"""1""",40560,40620
4119,201000,200400,60,38340,1,"""1""",40620,40680
4119,200400,204600,120,38340,1,"""1""",40680,40800
4119,502300,502600,0,38940,1,"""1""",38940,38940
4119,502600,502501,60,38940,1,"""1""",38940,39000
4119,502501,501702,120,38940,1,"""1""",39000,39120
4119,501702,501801,120,38940,1,"""1""",39120,39240
4119,501801,501601,60,38940,1,"""1""",39240,39300
4119,501601,500903,120,38940,1,"""1""",39300,39420
4119,500903,502801,60,38940,1,"""1""",39420,39480
4119,502801,101001,180,38940,1,"""1""",39480,39660
4119,101001,118101,60,38940,1,"""1""",39660,39720
4119,118101,106001,60,38940,1,"""1""",39720,39780
4119,106001,118001,120,38940,1,"""1""",39780,39900
4119,118001,103004,180,38940,1,"""1""",39900,40080
4119,103004,112101,180,38940,1,"""1""",40080,40260
4119,112101,117001,180,38940,1,"""1""",40260,40440
4119,117001,119003,120,38940,1,"""1""",40440,40560
4119,119003,208102,180,38940,1,"""1""",40560,40740
4119,208102,201502,120,38940,1,"""1""",40740,40860
4119,201502,203903,60,38940,1,"""1""",40860,40920
4119,203903,207801,60,38940,1,"""1""",40920,40980
4119,207801,205501,120,38940,1,"""1""",40980,41100
4119,205501,205602,60,38940,1,"""1""",41100,41160
4119,205602,201000,60,38940,1,"""1""",41160,41220
4119,201000,200400,60,38940,1,"""1""",41220,41280
4119,200400,204600,120,38940,1,"""1""",41280,41400
4119,502300,502600,0,39540,1,"""1""",39540,39540
4119,502600,502501,60,39540,1,"""1""",39540,39600
4119,502501,501702,120,39540,1,"""1""",39600,39720
4119,501702,501801,120,39540,1,"""1""",39720,39840
4119,501801,501601,60,39540,1,"""1""",39840,39900
4119,501601,500903,120,39540,1,"""1""",39900,40020
4119,500903,502801,60,39540,1,"""1""",40020,40080
4119,502801,101001,180,39540,1,"""1""",40080,40260
4119,101001,118101,60,39540,1,"""1""",40260,40320
4119,118101,106001,60,39540,1,"""1""",40320,40380
4119,106001,118001,120,39540,1,"""1""",40380,40500
4119,118001,103004,180,39540,1,"""1""",40500,40680
4119,103004,112101,180,39540,1,"""1""",40680,40860
4119,112101,117001,180,39540,1,"""1""",40860,41040
4119,117001,119003,120,39540,1,"""1""",41040,41160
4119,119003,208102,180,39540,1,"""1""",41160,41340
4119,208102,201502,120,39540,1,"""1""",41340,41460
4119,201502,203903,60,39540,1,"""1""",41460,41520
4119,203903,207801,60,39540,1,"""1""",41520,41580
4119,207801,205501,120,39540,1,"""1""",41580,41700
4119,205501,205602,60,39540,1,"""1""",41700,41760
4119,205602,201000,60,39540,1,"""1""",41760,41820
4119,201000,200400,60,39540,1,"""1""",41820,41880
4119,200400,204600,120,39540,1,"""1""",41880,42000
4119,502300,502600,0,40140,1,"""1""",40140,40140
4119,502600,502501,60,40140,1,"""1""",40140,40200
4119,502501,501702,120,40140,1,"""1""",40200,40320
4119,501702,501801,120,40140,1,"""1""",40320,40440
4119,501801,501601,60,40140,1,"""1""",40440,40500
4119,501601,500903,120,40140,1,"""1""",40500,40620
4119,500903,502801,60,40140,1,"""1""",40620,40680
4119,502801,101001,180,40140,1,"""1""",40680,40860
4119,101001,118101,60,40140,1,"""1""",40860,40920
4119,118101,106001,60,40140,1,"""1""",40920,40980
4119,106001,118001,120,40140,1,"""1""",40980,41100
4119,118001,103004,180,40140,1,"""1""",41100,41280
4119,103004,112101,180,40140,1,"""1""",41280,41460
4119,112101,117001,180,40140,1,"""1""",41460,41640
4119,117001,119003,120,40140,1,"""1""",41640,41760
4119,119003,208102,180,40140,1,"""1""",41760,41940
4119,208102,201502,120,40140,1,"""1""",41940,42060
4119,201502,203903,60,40140,1,"""1""",42060,42120
4119,203903,207801,60,40140,1,"""1""",42120,42180
4119,207801,205501,120,40140,1,"""1""",42180,42300
4119,205501,205602,60,40140,1,"""1""",42300,42360
4119,205602,201000,60,40140,1,"""1""",42360,42420
4119,201000,200400,60,40140,1,"""1""",42420,42480
4119,200400,204600,120,40140,1,"""1""",42480,42600
4119,502300,502600,0,40740,1,"""1""",40740,40740
4119,502600,502501,60,40740,1,"""1""",40740,40800
4119,502501,501702,120,40740,1,"""1""",40800,40920
4119,501702,501801,120,40740,1,"""1""",40920,41040
4119,501801,501601,60,40740,1,"""1""",41040,41100
4119,501601,500903,120,40740,1,"""1""",41100,41220
4119,500903,502801,60,40740,1,"""1""",41220,41280
4119,502801,101001,180,40740,1,"""1""",41280,41460
4119,101001,118101,60,40740,1,"""1""",41460,41520
4119,118101,106001,60,40740,1,"""1""",41520,41580
4119,106001,118001,120,40740,1,"""1""",41580,41700
4119,118001,103004,180,40740,1,"""1""",41700,41880
4119,103004,112101,180,40740,1,"""1""",41880,42060
4119,112101,117001,180,40740,1,"""1""",42060,42240
4119,117001,119003,120,40740,1,"""1""",42240,42360
4119,119003,208102,180,40740,1,"""1""",42360,42540
4119,208102,201502,120,40740,1,"""1""",42540,42660
4119,201502,203903,60,40740,1,"""1""",42660,42720
4119,203903,207801,60,40740,1,"""1""",42720,42780
4119,207801,205501,120,40740,1,"""1""",42780,42900
4119,205501,205602,60,40740,1,"""1""",42900,42960
4119,205602,201000,60,40740,1,"""1""",42960,43020
4119,201000,200400,60,40740,1,"""1""",43020,43080
4119,200400,204600,120,40740,1,"""1""",43080,43200
4119,502300,502600,0,41340,1,"""1""",41340,41340
4119,502600,502501,60,41340,1,"""1""",41340,41400
4119,502501,501702,120,41340,1,"""1""",41400,41520
4119,501702,501801,120,41340,1,"""1""",41520,41640
4119,501801,501601,60,41340,1,"""1""",41640,41700
4119,501601,500903,120,41340,1,"""1""",41700,41820
4119,500903,502801,60,41340,1,"""1""",41820,41880
4119,502801,101001,180,41340,1,"""1""",41880,42060
4119,101001,118101,60,41340,1,"""1""",42060,42120
4119,118101,106001,60,41340,1,"""1""",42120,42180
4119,106001,118001,120,41340,1,"""1""",42180,42300
4119,118001,103004,180,41340,1,"""1""",42300,42480
4119,103004,112101,180,41340,1,"""1""",42480,42660
4119,112101,117001,180,41340,1,"""1""",42660,42840
4119,117001,119003,120,41340,1,"""1""",42840,42960
4119,119003,208102,180,41340,1,"""1""",42960,43140
4119,208102,201502,120,41340,1,"""1""",43140,43260
4119,201502,203903,60,41340,1,"""1""",43260,43320
4119,203903,207801,60,41340,1,"""1""",43320,43380
4119,207801,205501,120,41340,1,"""1""",43380,43500
4119,205501,205602,60,41340,1,"""1""",43500,43560
4119,205602,201000,60,41340,1,"""1""",43560,43620
4119,201000,200400,60,41340,1,"""1""",43620,43680
4119,200400,204600,120,41340,1,"""1""",43680,43800
4119,502300,502600,0,41940,1,"""1""",41940,41940
4119,502600,502501,60,41940,1,"""1""",41940,42000
4119,502501,501702,120,41940,1,"""1""",42000,42120
4119,501702,501801,120,41940,1,"""1""",42120,42240
4119,501801,501601,60,41940,1,"""1""",42240,42300
4119,501601,500903,120,41940,1,"""1""",42300,42420
4119,500903,502801,60,41940,1,"""1""",42420,42480
4119,502801,101001,180,41940,1,"""1""",42480,42660
4119,101001,118101,60,41940,1,"""1""",42660,42720
4119,118101,106001,60,41940,1,"""1""",42720,42780
4119,106001,118001,120,41940,1,"""1""",42780,42900
4119,118001,103004,180,41940,1,"""1""",42900,43080
4119,103004,112101,180,41940,1,"""1""",43080,43260
4119,112101,117001,180,41940,1,"""1""",43260,43440
4119,117001,119003,120,41940,1,"""1""",43440,43560
4119,119003,208102,180,41940,1,"""1""",43560,43740
4119,208102,201502,120,41940,1,"""1""",43740,43860
4119,201502,203903,60,41940,1,"""1""",43860,43920
4119,203903,207801,60,41940,1,"""1""",43920,43980
4119,207801,205501,120,41940,1,"""1""",43980,44100
4119,205501,205602,60,41940,1,"""1""",44100,44160
4119,205602,201000,60,41940,1,"""1""",44160,44220
4119,201000,200400,60,41940,1,"""1""",44220,44280
4119,200400,204600,120,41940,1,"""1""",44280,44400
4119,502300,502600,0,42540,1,"""1""",42540,42540
4119,502600,502501,60,42540,1,"""1""",42540,42600
4119,502501,501702,120,42540,1,"""1""",42600,42720
4119,501702,501801,120,42540,1,"""1""",42720,42840
4119,501801,501601,60,42540,1,"""1""",42840,42900
4119,501601,500903,120,42540,1,"""1""",42900,43020
4119,500903,502801,60,42540,1,"""1""",43020,43080
4119,502801,101001,180,42540,1,"""1""",43080,43260
4119,101001,118101,60,42540,1,"""1""",43260,43320
4119,118101,106001,60,42540,1,"""1""",43320,43380
4119,106001,118001,120,42540,1,"""1""",43380,43500
4119,118001,103004,180,42540,1,"""1""",43500,43680
4119,103004,112101,180,42540,1,"""1""",43680,43860
4119,112101,117001,180,42540,1,"""1""",43860,44040
4119,117001,119003,120,42540,1,"""1""",44040,44160
4119,119003,208102,180,42540,1,"""1""",44160,44340
4119,208102,201502,120,42540,1,"""1""",44340,44460
4119,201502,203903,60,42540,1,"""1""",44460,44520
4119,203903,207801,60,42540,1,"""1""",44520,44580
4119,207801,205501,120,42540,1,"""1""",44580,44700
4119,205501,205602,60,42540,1,"""1""",44700,44760
4119,205602,201000,60,42540,1,"""1""",44760,44820
4119,201000,200400,60,42540,1,"""1""",44820,44880
4119,200400,204600,120,42540,1,"""1""",44880,45000
4119,502300,502600,0,43140,1,"""1""",43140,43140
4119,502600,502501,60,43140,1,"""1""",43140,43200
4119,502501,501702,120,43140,1,"""1""",43200,43320
4119,501702,501801,120,43140,1,"""1""",43320,43440
4119,501801,501601,60,43140,1,"""1""",43440,43500
4119,501601,500903,120,43140,1,"""1""",43500,43620
4119,500903,502801,60,43140,1,"""1""",43620,43680
4119,502801,101001,180,43140,1,"""1""",43680,43860
4119,101001,118101,60,43140,1,"""1""",43860,43920
4119,118101,106001,60,43140,1,"""1""",43920,43980
4119,106001,118001,120,43140,1,"""1""",43980,44100
4119,118001,103004,180,43140,1,"""1""",44100,44280
4119,103004,112101,180,43140,1,"""1""",44280,44460
4119,112101,117001,180,43140,1,"""1""",44460,44640
4119,117001,119003,120,43140,1,"""1""",44640,44760
4119,119003,208102,180,43140,1,"""1""",44760,44940
4119,208102,201502,120,43140,1,"""1""",44940,45060
4119,201502,203903,60,43140,1,"""1""",45060,45120
4119,203903,207801,60,43140,1,"""1""",45120,45180
4119,207801,205501,120,43140,1,"""1""",45180,45300
4119,205501,205602,60,43140,1,"""1""",45300,45360
4119,205602,201000,60,43140,1,"""1""",45360,45420
4119,201000,200400,60,43140,1,"""1""",45420,45480
4119,200400,204600,120,43140,1,"""1""",45480,45600
4119,502300,502600,0,43740,1,"""1""",43740,43740
4119,502600,502501,60,43740,1,"""1""",43740,43800
4119,502501,501702,120,43740,1,"""1""",43800,43920
4119,501702,501801,120,43740,1,"""1""",43920,44040
4119,501801,501601,60,43740,1,"""1""",44040,44100
4119,501601,500903,120,43740,1,"""1""",44100,44220
4119,500903,502801,60,43740,1,"""1""",44220,44280
4119,502801,101001,180,43740,1,"""1""",44280,44460
4119,101001,118101,60,43740,1,"""1""",44460,44520
4119,118101,106001,60,43740,1,"""1""",44520,44580
4119,106001,118001,120,43740,1,"""1""",44580,44700
4119,118001,103004,180,43740,1,"""1""",44700,44880
4119,103004,112101,180,43740,1,"""1""",44880,45060
4119,112101,117001,180,43740,1,"""1""",45060,45240
4119,117001,119003,120,43740,1,"""1""",45240,45360
4119,119003,208102,180,43740,1,"""1""",45360,45540
4119,208102,201502,120,43740,1,"""1""",45540,45660
4119,201502,203903,60,43740,1,"""1""",45660,45720
4119,203903,207801,60,43740,1,"""1""",45720,45780
4119,207801,205501,120,43740,1,"""1""",45780,45900
4119,205501,205602,60,43740,1,"""1""",45900,45960
4119,205602,201000,60,43740,1,"""1""",45960,46020
4119,201000,200400,60,43740,1,"""1""",46020,46080
4119,200400,204600,120,43740,1,"""1""",46080,46200
4119,502300,502600,0,44340,1,"""1""",44340,44340
4119,502600,502501,60,44340,1,"""1""",44340,44400
4119,502501,501702,120,44340,1,"""1""",44400,44520
4119,501702,501801,120,44340,1,"""1""",44520,44640
4119,501801,501601,60,44340,1,"""1""",44640,44700
4119,501601,500903,120,44340,1,"""1""",44700,44820
4119,500903,502801,60,44340,1,"""1""",44820,44880
4119,502801,101001,180,44340,1,"""1""",44880,45060
4119,101001,118101,60,44340,1,"""1""",45060,45120
4119,118101,106001,60,44340,1,"""1""",45120,45180
4119,106001,118001,120,44340,1,"""1""",45180,45300
4119,118001,103004,180,44340,1,"""1""",45300,45480
4119,103004,112101,180,44340,1,"""1""",45480,45660
4119,112101,117001,180,44340,1,"""1""",45660,45840
4119,117001,119003,120,44340,1,"""1""",45840,45960
4119,119003,208102,180,44340,1,"""1""",45960,46140
4119,208102,201502,120,44340,1,"""1""",46140,46260
4119,201502,203903,60,44340,1,"""1""",46260,46320
4119,203903,207801,60,44340,1,"""1""",46320,46380
4119,207801,205501,120,44340,1,"""1""",46380,46500
4119,205501,205602,60,44340,1,"""1""",46500,46560
4119,205602,201000,60,44340,1,"""1""",46560,46620
4119,201000,200400,60,44340,1,"""1""",46620,46680
4119,200400,204600,120,44340,1,"""1""",46680,46800
4119,502300,502600,0,44940,1,"""1""",44940,44940
4119,502600,502501,60,44940,1,"""1""",44940,45000
4119,502501,501702,120,44940,1,"""1""",45000,45120
4119,501702,501801,120,44940,1,"""1""",45120,45240
4119,501801,501601,60,44940,1,"""1""",45240,45300
4119,501601,500903,120,44940,1,"""1""",45300,45420
4119,500903,502801,60,44940,1,"""1""",45420,45480
4119,502801,101001,180,44940,1,"""1""",45480,45660
4119,101001,118101,60,44940,1,"""1""",45660,45720
4119,118101,106001,60,44940,1,"""1""",45720,45780
4119,106001,118001,120,44940,1,"""1""",45780,45900
4119,118001,103004,180,44940,1,"""1""",45900,46080
4119,103004,112101,180,44940,1,"""1""",46080,46260
4119,112101,117001,180,44940,1,"""1""",46260,46440
4119,117001,119003,120,44940,1,"""1""",46440,46560
4119,119003,208102,180,44940,1,"""1""",46560,46740
4119,208102,201502,120,44940,1,"""1""",46740,46860
4119,201502,203903,60,44940,1,"""1""",46860,46920
4119,203903,207801,60,44940,1,"""1""",46920,46980
4119,207801,205501,120,44940,1,"""1""",46980,47100
4119,205501,205602,60,44940,1,"""1""",47100,47160
4119,205602,201000,60,44940,1,"""1""",47160,47220
4119,201000,200400,60,44940,1,"""1""",47220,47280
4119,200400,204600,120,44940,1,"""1""",47280,47400
4119,502300,502600,0,45540,1,"""1""",45540,45540
4119,502600,502501,60,45540,1,"""1""",45540,45600
4119,502501,501702,120,45540,1,"""1""",45600,45720
4119,501702,501801,120,45540,1,"""1""",45720,45840
4119,501801,501601,60,45540,1,"""1""",45840,45900
4119,501601,500903,120,45540,1,"""1""",45900,46020
4119,500903,502801,60,45540,1,"""1""",46020,46080
4119,502801,101001,180,45540,1,"""1""",46080,46260
4119,101001,118101,60,45540,1,"""1""",46260,46320
4119,118101,106001,60,45540,1,"""1""",46320,46380
4119,106001,118001,120,45540,1,"""1""",46380,46500
4119,118001,103004,180,45540,1,"""1""",46500,46680
4119,103004,112101,180,45540,1,"""1""",46680,46860
4119,112101,117001,180,45540,1,"""1""",46860,47040
4119,117001,119003,120,45540,1,"""1""",47040,47160
4119,119003,208102,180,45540,1,"""1""",47160,47340
4119,208102,201502,120,45540,1,"""1""",47340,47460
4119,201502,203903,60,45540,1,"""1""",47460,47520
4119,203903,207801,60,45540,1,"""1""",47520,47580
4119,207801,205501,120,45540,1,"""1""",47580,47700
4119,205501,205602,60,45540,1,"""1""",47700,47760
4119,205602,201000,60,45540,1,"""1""",47760,47820
4119,201000,200400,60,45540,1,"""1""",47820,47880
4119,200400,204600,120,45540,1,"""1""",47880,48000
4119,502300,502600,0,46140,1,"""1""",46140,46140
4119,502600,502501,60,46140,1,"""1""",46140,46200
4119,502501,501702,120,46140,1,"""1""",46200,46320
4119,501702,501801,120,46140,1,"""1""",46320,46440
4119,501801,501601,60,46140,1,"""1""",46440,46500
4119,501601,500903,120,46140,1,"""1""",46500,46620
4119,500903,502801,60,46140,1,"""1""",46620,46680
4119,502801,101001,180,46140,1,"""1""",46680,46860
4119,101001,118101,60,46140,1,"""1""",46860,46920
4119,118101,106001,60,46140,1,"""1""",46920,46980
4119,106001,118001,120,46140,1,"""1""",46980,47100
4119,118001,103004,180,46140,1,"""1""",47100,47280
4119,103004,112101,180,46140,1,"""1""",47280,47460
4119,112101,117001,180,46140,1,"""1""",47460,47640
4119,117001,119003,120,46140,1,"""1""",47640,47760
4119,119003,208102,180,46140,1,"""1""",47760,47940
4119,208102,201502,120,46140,1,"""1""",47940,48060
4119,201502,203903,60,46140,1,"""1""",48060,48120
4119,203903,207801,60,46140,1,"""1""",48120,48180
4119,207801,205501,120,46140,1,"""1""",48180,48300
4119,205501,205602,60,46140,1,"""1""",48300,48360
4119,205602,201000,60,46140,1,"""1""",48360,48420
4119,201000,200400,60,46140,1,"""1""",48420,48480
4119,200400,204600,120,46140,1,"""1""",48480,48600
4119,502300,502600,0,46740,1,"""1""",46740,46740
4119,502600,502501,60,46740,1,"""1""",46740,46800
4119,502501,501702,120,46740,1,"""1""",46800,46920
4119,501702,501801,120,46740,1,"""1""",46920,47040
4119,501801,501601,60,46740,1,"""1""",47040,47100
4119,501601,500903,120,46740,1,"""1""",47100,47220
4119,500903,502801,60,46740,1,"""1""",47220,47280
4119,502801,101001,180,46740,1,"""1""",47280,47460
4119,101001,118101,60,46740,1,"""1""",47460,47520
4119,118101,106001,60,46740,1,"""1""",47520,47580
4119,106001,118001,120,46740,1,"""1""",47580,47700
4119,118001,103004,180,46740,1,"""1""",47700,47880
4119,103004,112101,180,46740,1,"""1""",47880,48060
4119,112101,117001,180,46740,1,"""1""",48060,48240
4119,117001,119003,120,46740,1,"""1""",48240,48360
4119,119003,208102,180,46740,1,"""1""",48360,48540
4119,208102,201502,120,46740,1,"""1""",48540,48660
4119,201502,203903,60,46740,1,"""1""",48660,48720
4119,203903,207801,60,46740,1,"""1""",48720,48780
4119,207801,205501,120,46740,1,"""1""",48780,48900
4119,205501,205602,60,46740,1,"""1""",48900,48960
4119,205602,201000,60,46740,1,"""1""",48960,49020
4119,201000,200400,60,46740,1,"""1""",49020,49080
4119,200400,204600,120,46740,1,"""1""",49080,49200
4119,502300,502600,0,47340,1,"""1""",47340,47340
4119,502600,502501,60,47340,1,"""1""",47340,47400
4119,502501,501702,120,47340,1,"""1""",47400,47520
4119,501702,501801,120,47340,1,"""1""",47520,47640
4119,501801,501601,60,47340,1,"""1""",47640,47700
4119,501601,500903,120,47340,1,"""1""",47700,47820
4119,500903,502801,60,47340,1,"""1""",47820,47880
4119,502801,101001,180,47340,1,"""1""",47880,48060
4119,101001,118101,60,47340,1,"""1""",48060,48120
4119,118101,106001,60,47340,1,"""1""",48120,48180
4119,106001,118001,120,47340,1,"""1""",48180,48300
4119,118001,103004,180,47340,1,"""1""",48300,48480
4119,103004,112101,180,47340,1,"""1""",48480,48660
4119,112101,117001,180,47340,1,"""1""",48660,48840
4119,117001,119003,120,47340,1,"""1""",48840,48960
4119,119003,208102,180,47340,1,"""1""",48960,49140
4119,208102,201502,120,47340,1,"""1""",49140,49260
4119,201502,203903,60,47340,1,"""1""",49260,49320
4119,203903,207801,60,47340,1,"""1""",49320,49380
4119,207801,205501,120,47340,1,"""1""",49380,49500
4119,205501,205602,60,47340,1,"""1""",49500,49560
4119,205602,201000,60,47340,1,"""1""",49560,49620
4119,201000,200400,60,47340,1,"""1""",49620,49680
4119,200400,204600,120,47340,1,"""1""",49680,49800
4119,502300,502600,0,47940,1,"""1""",47940,47940
4119,502600,502501,60,47940,1,"""1""",47940,48000
4119,502501,501702,120,47940,1,"""1""",48000,48120
4119,501702,501801,120,47940,1,"""1""",48120,48240
4119,501801,501601,60,47940,1,"""1""",48240,48300
4119,501601,500903,120,47940,1,"""1""",48300,48420
4119,500903,502801,60,47940,1,"""1""",48420,48480
4119,502801,101001,180,47940,1,"""1""",48480,48660
4119,101001,118101,60,47940,1,"""1""",48660,48720
4119,118101,106001,60,47940,1,"""1""",48720,48780
4119,106001,118001,120,47940,1,"""1""",48780,48900
4119,118001,103004,180,47940,1,"""1""",48900,49080
4119,103004,112101,180,47940,1,"""1""",49080,49260
4119,112101,117001,180,47940,1,"""1""",49260,49440
4119,117001,119003,120,47940,1,"""1""",49440,49560
4119,119003,208102,180,47940,1,"""1""",49560,49740
4119,208102,201502,120,47940,1,"""1""",49740,49860
4119,201502,203903,60,47940,1,"""1""",49860,49920
4119,203903,207801,60,47940,1,"""1""",49920,49980
4119,207801,205501,120,47940,1,"""1""",49980,50100
4119,205501,205602,60,47940,1,"""1""",50100,50160
4119,205602,201000,60,47940,1,"""1""",50160,50220
4119,201000,200400,60,47940,1,"""1""",50220,50280
4119,200400,204600,120,47940,1,"""1""",50280,50400
4119,502300,502600,0,48540,1,"""1""",48540,48540
4119,502600,502501,60,48540,1,"""1""",48540,48600
4119,502501,501702,120,48540,1,"""1""",48600,48720
4119,501702,501801,120,48540,1,"""1""",48720,48840
4119,501801,501601,60,48540,1,"""1""",48840,48900
4119,501601,500903,120,48540,1,"""1""",48900,49020
4119,500903,502801,60,48540,1,"""1""",49020,49080
4119,502801,101001,180,48540,1,"""1""",49080,49260
4119,101001,118101,60,48540,1,"""1""",49260,49320
4119,118101,106001,60,48540,1,"""1""",49320,49380
4119,106001,118001,120,48540,1,"""1""",49380,49500
4119,118001,103004,180,48540,1,"""1""",49500,49680
4119,103004,112101,180,48540,1,"""1""",49680,49860
4119,112101,117001,180,48540,1,"""1""",49860,50040
4119,117001,119003,120,48540,1,"""1""",50040,50160
4119,119003,208102,180,48540,1,"""1""",50160,50340
4119,208102,201502,120,48540,1,"""1""",50340,50460
4119,201502,203903,60,48540,1,"""1""",50460,50520
4119,203903,207801,60,48540,1,"""1""",50520,50580
4119,207801,205501,120,48540,1,"""1""",50580,50700
4119,205501,205602,60,48540,1,"""1""",50700,50760
4119,205602,201000,60,48540,1,"""1""",50760,50820
4119,201000,200400,60,48540,1,"""1""",50820,50880
4119,200400,204600,120,48540,1,"""1""",50880,51000
4119,502300,502600,0,49140,1,"""1""",49140,49140
4119,502600,502501,60,49140,1,"""1""",49140,49200
4119,502501,501702,120,49140,1,"""1""",49200,49320
4119,501702,501801,120,49140,1,"""1""",49320,49440
4119,501801,501601,60,49140,1,"""1""",49440,49500
4119,501601,500903,120,49140,1,"""1""",49500,49620
4119,500903,502801,60,49140,1,"""1""",49620,49680
4119,502801,101001,180,49140,1,"""1""",49680,49860
4119,101001,118101,60,49140,1,"""1""",49860,49920
4119,118101,106001,60,49140,1,"""1""",49920,49980
4119,106001,118001,120,49140,1,"""1""",49980,50100
4119,118001,103004,180,49140,1,"""1""",50100,50280
4119,103004,112101,180,49140,1,"""1""",50280,50460
4119,112101,117001,180,49140,1,"""1""",50460,50640
4119,117001,119003,120,49140,1,"""1""",50640,50760
4119,119003,208102,180,49140,1,"""1""",50760,50940
4119,208102,201502,120,49140,1,"""1""",50940,51060
4119,201502,203903,60,49140,1,"""1""",51060,51120
4119,203903,207801,60,49140,1,"""1""",51120,51180
4119,207801,205501,120,49140,1,"""1""",51180,51300
4119,205501,205602,60,49140,1,"""1""",51300,51360
4119,205602,201000,60,49140,1,"""1""",51360,51420
4119,201000,200400,60,49140,1,"""1""",51420,51480
4119,200400,204600,120,49140,1,"""1""",51480,51600
4119,502300,502600,0,49740,1,"""1""",49740,49740
4119,502600,502501,60,49740,1,"""1""",49740,49800
4119,502501,501702,120,49740,1,"""1""",49800,49920
4119,501702,501801,120,49740,1,"""1""",49920,50040
4119,501801,501601,60,49740,1,"""1""",50040,50100
4119,501601,500903,120,49740,1,"""1""",50100,50220
4119,500903,502801,60,49740,1,"""1""",50220,50280
4119,502801,101001,180,49740,1,"""1""",50280,50460
4119,101001,118101,60,49740,1,"""1""",50460,50520
4119,118101,106001,60,49740,1,"""1""",50520,50580
4119,106001,118001,120,49740,1,"""1""",50580,50700
4119,118001,103004,180,49740,1,"""1""",50700,50880
4119,103004,112101,180,49740,1,"""1""",50880,51060
4119,112101,117001,180,49740,1,"""1""",51060,51240
4119,117001,119003,120,49740,1,"""1""",51240,51360
4119,119003,208102,180,49740,1,"""1""",51360,51540
4119,208102,201502,120,49740,1,"""1""",51540,51660
4119,201502,203903,60,49740,1,"""1""",51660,51720
4119,203903,207801,60,49740,1,"""1""",51720,51780
4119,207801,205501,120,49740,1,"""1""",51780,51900
4119,205501,205602,60,49740,1,"""1""",51900,51960
4119,205602,201000,60,49740,1,"""1""",51960,52020
4119,201000,200400,60,49740,1,"""1""",52020,52080
4119,200400,204600,120,49740,1,"""1""",52080,52200
4119,502300,502600,0,50340,1,"""1""",50340,50340
4119,502600,502501,60,50340,1,"""1""",50340,50400
4119,502501,501702,120,50340,1,"""1""",50400,50520
4119,501702,501801,120,50340,1,"""1""",50520,50640
4119,501801,501601,60,50340,1,"""1""",50640,50700
4119,501601,500903,120,50340,1,"""1""",50700,50820
4119,500903,502801,60,50340,1,"""1""",50820,50880
4119,502801,101001,180,50340,1,"""1""",50880,51060
4119,101001,118101,60,50340,1,"""1""",51060,51120
4119,118101,106001,60,50340,1,"""1""",51120,51180
4119,106001,118001,120,50340,1,"""1""",51180,51300
4119,118001,103004,180,50340,1,"""1""",51300,51480
4119,103004,112101,180,50340,1,"""1""",51480,51660
4119,112101,117001,180,50340,1,"""1""",51660,51840
4119,117001,119003,120,50340,1,"""1""",51840,51960
4119,119003,208102,180,50340,1,"""1""",51960,52140
4119,208102,201502,120,50340,1,"""1""",52140,52260
4119,201502,203903,60,50340,1,"""1""",52260,52320
4119,203903,207801,60,50340,1,"""1""",52320,52380
4119,207801,205501,120,50340,1,"""1""",52380,52500
4119,205501,205602,60,50340,1,"""1""",52500,52560
4119,205602,201000,60,50340,1,"""1""",52560,52620
4119,201000,200400,60,50340,1,"""1""",52620,52680
4119,200400,204600,120,50340,1,"""1""",52680,52800
4119,502300,502600,0,50940,1,"""1""",50940,50940
4119,502600,502501,60,50940,1,"""1""",50940,51000
4119,502501,501702,120,50940,1,"""1""",51000,51120
4119,501702,501801,120,50940,1,"""1""",51120,51240
4119,501801,501601,60,50940,1,"""1""",51240,51300
4119,501601,500903,120,50940,1,"""1""",51300,51420
4119,500903,502801,60,50940,1,"""1""",51420,51480
4119,502801,101001,180,50940,1,"""1""",51480,51660
4119,101001,118101,60,50940,1,"""1""",51660,51720
4119,118101,106001,60,50940,1,"""1""",51720,51780
4119,106001,118001,120,50940,1,"""1""",51780,51900
4119,118001,103004,180,50940,1,"""1""",51900,52080
4119,103004,112101,180,50940,1,"""1""",52080,52260
4119,112101,117001,180,50940,1,"""1""",52260,52440
4119,117001,119003,120,50940,1,"""1""",52440,52560
4119,119003,208102,180,50940,1,"""1""",52560,52740
4119,208102,201502,120,50940,1,"""1""",52740,52860
4119,201502,203903,60,50940,1,"""1""",52860,52920
4119,203903,207801,60,50940,1,"""1""",52920,52980
4119,207801,205501,120,50940,1,"""1""",52980,53100
4119,205501,205602,60,50940,1,"""1""",53100,53160
4119,205602,201000,60,50940,1,"""1""",53160,53220
4119,201000,200400,60,50940,1,"""1""",53220,53280
4119,200400,204600,120,50940,1,"""1""",53280,53400
4119,502300,502600,0,51540,1,"""1""",51540,51540
4119,502600,502501,60,51540,1,"""1""",51540,51600
4119,502501,501702,120,51540,1,"""1""",51600,51720
4119,501702,501801,120,51540,1,"""1""",51720,51840
4119,501801,501601,60,51540,1,"""1""",51840,51900
4119,501601,500903,120,51540,1,"""1""",51900,52020
4119,500903,502801,60,51540,1,"""1""",52020,52080
4119,502801,101001,180,51540,1,"""1""",52080,52260
4119,101001,118101,60,51540,1,"""1""",52260,52320
4119,118101,106001,60,51540,1,"""1""",52320,52380
4119,106001,118001,120,51540,1,"""1""",52380,52500
4119,118001,103004,180,51540,1,"""1""",52500,52680
4119,103004,112101,180,51540,1,"""1""",52680,52860
4119,112101,117001,180,51540,1,"""1""",52860,53040
4119,117001,119003,120,51540,1,"""1""",53040,53160
4119,119003,208102,180,51540,1,"""1""",53160,53340
4119,208102,201502,120,51540,1,"""1""",53340,53460
4119,201502,203903,60,51540,1,"""1""",53460,53520
4119,203903,207801,60,51540,1,"""1""",53520,53580
4119,207801,205501,120,51540,1,"""1""",53580,53700
4119,205501,205602,60,51540,1,"""1""",53700,53760
4119,205602,201000,60,51540,1,"""1""",53760,53820
4119,201000,200400,60,51540,1,"""1""",53820,53880
4119,200400,204600,120,51540,1,"""1""",53880,54000
4119,502300,502600,0,52140,1,"""1""",52140,52140
4119,502600,502501,60,52140,1,"""1""",52140,52200
4119,502501,501702,120,52140,1,"""1""",52200,52320
4119,501702,501801,120,52140,1,"""1""",52320,52440
4119,501801,501601,60,52140,1,"""1""",52440,52500
4119,501601,500903,120,52140,1,"""1""",52500,52620
4119,500903,502801,60,52140,1,"""1""",52620,52680
4119,502801,101001,180,52140,1,"""1""",52680,52860
4119,101001,118101,60,52140,1,"""1""",52860,52920
4119,118101,106001,60,52140,1,"""1""",52920,52980
4119,106001,118001,120,52140,1,"""1""",52980,53100
4119,118001,103004,180,52140,1,"""1""",53100,53280
4119,103004,112101,180,52140,1,"""1""",53280,53460
4119,112101,117001,180,52140,1,"""1""",53460,53640
4119,117001,119003,120,52140,1,"""1""",53640,53760
4119,119003,208102,180,52140,1,"""1""",53760,53940
4119,208102,201502,120,52140,1,"""1""",53940,54060
4119,201502,203903,60,52140,1,"""1""",54060,54120
4119,203903,207801,60,52140,1,"""1""",54120,54180
4119,207801,205501,120,52140,1,"""1""",54180,54300
4119,205501,205602,60,52140,1,"""1""",54300,54360
4119,205602,201000,60,52140,1,"""1""",54360,54420
4119,201000,200400,60,52140,1,"""1""",54420,54480
4119,200400,204600,120,52140,1,"""1""",54480,54600
4119,502300,502600,0,52740,1,"""1""",52740,52740
4119,502600,502501,60,52740,1,"""1""",52740,52800
4119,502501,501702,120,52740,1,"""1""",52800,52920
4119,501702,501801,120,52740,1,"""1""",52920,53040
4119,501801,501601,60,52740,1,"""1""",53040,53100
4119,501601,500903,120,52740,1,"""1""",53100,53220
4119,500903,502801,60,52740,1,"""1""",53220,53280
4119,502801,101001,180,52740,1,"""1""",53280,53460
4119,101001,118101,60,52740,1,"""1""",53460,53520
4119,118101,106001,60,52740,1,"""1""",53520,53580
4119,106001,118001,120,52740,1,"""1""",53580,53700
4119,118001,103004,180,52740,1,"""1""",53700,53880
4119,103004,112101,180,52740,1,"""1""",53880,54060
4119,112101,117001,180,52740,1,"""1""",54060,54240
4119,117001,119003,120,52740,1,"""1""",54240,54360
4119,119003,208102,180,52740,1,"""1""",54360,54540
4119,208102,201502,120,52740,1,"""1""",54540,54660
4119,201502,203903,60,52740,1,"""1""",54660,54720
4119,203903,207801,60,52740,1,"""1""",54720,54780
4119,207801,205501,120,52740,1,"""1""",54780,54900
4119,205501,205602,60,52740,1,"""1""",54900,54960
4119,205602,201000,60,52740,1,"""1""",54960,55020
4119,201000,200400,60,52740,1,"""1""",55020,55080
4119,200400,204600,120,52740,1,"""1""",55080,55200
4119,502300,502600,0,53340,1,"""1""",53340,53340
4119,502600,502501,60,53340,1,"""1""",53340,53400
4119,502501,501702,120,53340,1,"""1""",53400,53520
4119,501702,501801,120,53340,1,"""1""",53520,53640
4119,501801,501601,60,53340,1,"""1""",53640,53700
4119,501601,500903,120,53340,1,"""1""",53700,53820
4119,500903,502801,60,53340,1,"""1""",53820,53880
4119,502801,101001,180,53340,1,"""1""",53880,54060
4119,101001,118101,60,53340,1,"""1""",54060,54120
4119,118101,106001,60,53340,1,"""1""",54120,54180
4119,106001,118001,120,53340,1,"""1""",54180,54300
4119,118001,103004,180,53340,1,"""1""",54300,54480
4119,103004,112101,180,53340,1,"""1""",54480,54660
4119,112101,117001,180,53340,1,"""1""",54660,54840
4119,117001,119003,120,53340,1,"""1""",54840,54960
4119,119003,208102,180,53340,1,"""1""",54960,55140
4119,208102,201502,120,53340,1,"""1""",55140,55260
4119,201502,203903,60,53340,1,"""1""",55260,55320
4119,203903,207801,60,53340,1,"""1""",55320,55380
4119,207801,205501,120,53340,1,"""1""",55380,55500
4119,205501,205602,60,53340,1,"""1""",55500,55560
4119,205602,201000,60,53340,1,"""1""",55560,55620
4119,201000,200400,60,53340,1,"""1""",55620,55680
4119,200400,204600,120,53340,1,"""1""",55680,55800
4119,502300,502600,0,53940,1,"""1""",53940,53940
4119,502600,502501,60,53940,1,"""1""",53940,54000
4119,502501,501702,120,53940,1,"""1""",54000,54120
4119,501702,501801,120,53940,1,"""1""",54120,54240
4119,501801,501601,60,53940,1,"""1""",54240,54300
4119,501601,500903,120,53940,1,"""1""",54300,54420
4119,500903,502801,60,53940,1,"""1""",54420,54480
4119,502801,101001,180,53940,1,"""1""",54480,54660
4119,101001,118101,60,53940,1,"""1""",54660,54720
4119,118101,106001,60,53940,1,"""1""",54720,54780
4119,106001,118001,120,53940,1,"""1""",54780,54900
4119,118001,103004,180,53940,1,"""1""",54900,55080
4119,103004,112101,180,53940,1,"""1""",55080,55260
4119,112101,117001,180,53940,1,"""1""",55260,55440
4119,117001,119003,120,53940,1,"""1""",55440,55560
4119,119003,208102,180,53940,1,"""1""",55560,55740
4119,208102,201502,120,53940,1,"""1""",55740,55860
4119,201502,203903,60,53940,1,"""1""",55860,55920
4119,203903,207801,60,53940,1,"""1""",55920,55980
4119,207801,205501,120,53940,1,"""1""",55980,56100
4119,205501,205602,60,53940,1,"""1""",56100,56160
4119,205602,201000,60,53940,1,"""1""",56160,56220
4119,201000,200400,60,53940,1,"""1""",56220,56280
4119,200400,204600,120,53940,1,"""1""",56280,56400
4119,502300,502600,0,54540,1,"""1""",54540,54540
4119,502600,502501,60,54540,1,"""1""",54540,54600
4119,502501,501702,120,54540,1,"""1""",54600,54720
4119,501702,501801,120,54540,1,"""1""",54720,54840
4119,501801,501601,60,54540,1,"""1""",54840,54900
4119,501601,500903,120,54540,1,"""1""",54900,55020
4119,500903,502801,60,54540,1,"""1""",55020,55080
4119,502801,101001,180,54540,1,"""1""",55080,55260
4119,101001,118101,60,54540,1,"""1""",55260,55320
4119,118101,106001,60,54540,1,"""1""",55320,55380
4119,106001,118001,120,54540,1,"""1""",55380,55500
4119,118001,103004,180,54540,1,"""1""",55500,55680
4119,103004,112101,180,54540,1,"""1""",55680,55860
4119,112101,117001,180,54540,1,"""1""",55860,56040
4119,117001,119003,120,54540,1,"""1""",56040,56160
4119,119003,208102,180,54540,1,"""1""",56160,56340
4119,208102,201502,120,54540,1,"""1""",56340,56460
4119,201502,203903,60,54540,1,"""1""",56460,56520
4119,203903,207801,60,54540,1,"""1""",56520,56580
4119,207801,205501,120,54540,1,"""1""",56580,56700
4119,205501,205602,60,54540,1,"""1""",56700,56760
4119,205602,201000,60,54540,1,"""1""",56760,56820
4119,201000,200400,60,54540,1,"""1""",56820,56880
4119,200400,204600,120,54540,1,"""1""",56880,57000
4119,502300,502600,0,55140,1,"""1""",55140,55140
4119,502600,502501,60,55140,1,"""1""",55140,55200
4119,502501,501702,120,55140,1,"""1""",55200,55320
4119,501702,501801,120,55140,1,"""1""",55320,55440
4119,501801,501601,60,55140,1,"""1""",55440,55500
4119,501601,500903,120,55140,1,"""1""",55500,55620
4119,500903,502801,60,55140,1,"""1""",55620,55680
4119,502801,101001,180,55140,1,"""1""",55680,55860
4119,101001,118101,60,55140,1,"""1""",55860,55920
4119,118101,106001,60,55140,1,"""1""",55920,55980
4119,106001,118001,120,55140,1,"""1""",55980,56100
4119,118001,103004,180,55140,1,"""1""",56100,56280
4119,103004,112101,180,55140,1,"""1""",56280,56460
4119,112101,117001,180,55140,1,"""1""",56460,56640
4119,117001,119003,120,55140,1,"""1""",56640,56760
4119,119003,208102,180,55140,1,"""1""",56760,56940
4119,208102,201502,120,55140,1,"""1""",56940,57060
4119,201502,203903,60,55140,1,"""1""",57060,57120
4119,203903,207801,60,55140,1,"""1""",57120,57180
4119,207801,205501,120,55140,1,"""1""",57180,57300
4119,205501,205602,60,55140,1,"""1""",57300,57360
4119,205602,201000,60,55140,1,"""1""",57360,57420
4119,201000,200400,60,55140,1,"""1""",57420,57480
4119,200400,204600,120,55140,1,"""1""",57480,57600
4119,502300,502600,0,55740,1,"""1""",55740,55740
4119,502600,502501,60,55740,1,"""1""",55740,55800
4119,502501,501702,120,55740,1,"""1""",55800,55920
4119,501702,501801,120,55740,1,"""1""",55920,56040
4119,501801,501601,60,55740,1,"""1""",56040,56100
4119,501601,500903,120,55740,1,"""1""",56100,56220
4119,500903,502801,60,55740,1,"""1""",56220,56280
4119,502801,101001,180,55740,1,"""1""",56280,56460
4119,101001,118101,60,55740,1,"""1""",56460,56520
4119,118101,106001,60,55740,1,"""1""",56520,56580
4119,106001,118001,120,55740,1,"""1""",56580,56700
4119,118001,103004,180,55740,1,"""1""",56700,56880
4119,103004,112101,180,55740,1,"""1""",56880,57060
4119,112101,117001,180,55740,1,"""1""",57060,57240
4119,117001,119003,120,55740,1,"""1""",57240,57360
4119,119003,208102,180,55740,1,"""1""",57360,57540
4119,208102,201502,120,55740,1,"""1""",57540,57660
4119,201502,203903,60,55740,1,"""1""",57660,57720
4119,203903,207801,60,55740,1,"""1""",57720,57780
4119,207801,205501,120,55740,1,"""1""",57780,57900
4119,205501,205602,60,55740,1,"""1""",57900,57960
4119,205602,201000,60,55740,1,"""1""",57960,58020
4119,201000,200400,60,55740,1,"""1""",58020,58080
4119,200400,204600,120,55740,1,"""1""",58080,58200
4119,502300,502600,0,56340,1,"""1""",56340,56340
4119,502600,502501,60,56340,1,"""1""",56340,56400
4119,502501,501702,120,56340,1,"""1""",56400,56520
4119,501702,501801,120,56340,1,"""1""",56520,56640
4119,501801,501601,60,56340,1,"""1""",56640,56700
4119,501601,500903,120,56340,1,"""1""",56700,56820
4119,500903,502801,60,56340,1,"""1""",56820,56880
4119,502801,101001,180,56340,1,"""1""",56880,57060
4119,101001,118101,60,56340,1,"""1""",57060,57120
4119,118101,106001,60,56340,1,"""1""",57120,57180
4119,106001,118001,120,56340,1,"""1""",57180,57300
4119,118001,103004,180,56340,1,"""1""",57300,57480
4119,103004,112101,180,56340,1,"""1""",57480,57660
4119,112101,117001,180,56340,1,"""1""",57660,57840
4119,117001,119003,120,56340,1,"""1""",57840,57960
4119,119003,208102,180,56340,1,"""1""",57960,58140
4119,208102,201502,120,56340,1,"""1""",58140,58260
4119,201502,203903,60,56340,1,"""1""",58260,58320
4119,203903,207801,60,56340,1,"""1""",58320,58380
4119,207801,205501,120,56340,1,"""1""",58380,58500
4119,205501,205602,60,56340,1,"""1""",58500,58560
4119,205602,201000,60,56340,1,"""1""",58560,58620
4119,201000,200400,60,56340,1,"""1""",58620,58680
4119,200400,204600,120,56340,1,"""1""",58680,58800
4119,502300,502600,0,56940,1,"""1""",56940,56940
4119,502600,502501,60,56940,1,"""1""",56940,57000
4119,502501,501702,120,56940,1,"""1""",57000,57120
4119,501702,501801,120,56940,1,"""1""",57120,57240
4119,501801,501601,60,56940,1,"""1""",57240,57300
4119,501601,500903,120,56940,1,"""1""",57300,57420
4119,500903,502801,60,56940,1,"""1""",57420,57480
4119,502801,101001,180,56940,1,"""1""",57480,57660
4119,101001,118101,60,56940,1,"""1""",57660,57720
4119,118101,106001,60,56940,1,"""1""",57720,57780
4119,106001,118001,120,56940,1,"""1""",57780,57900
4119,118001,103004,180,56940,1,"""1""",57900,58080
4119,103004,112101,180,56940,1,"""1""",58080,58260
4119,112101,117001,180,56940,1,"""1""",58260,58440
4119,117001,119003,120,56940,1,"""1""",58440,58560
4119,119003,208102,180,56940,1,"""1""",58560,58740
4119,208102,201502,120,56940,1,"""1""",58740,58860
4119,201502,203903,60,56940,1,"""1""",58860,58920
4119,203903,207801,60,56940,1,"""1""",58920,58980
4119,207801,205501,120,56940,1,"""1""",58980,59100
4119,205501,205602,60,56940,1,"""1""",59100,59160
4119,205602,201000,60,56940,1,"""1""",59160,59220
4119,201000,200400,60,56940,1,"""1""",59220,59280
4119,200400,204600,120,56940,1,"""1""",59280,59400
4119,502300,502600,0,57540,1,"""1""",57540,57540
4119,502600,502501,60,57540,1,"""1""",57540,57600
4119,502501,501702,120,57540,1,"""1""",57600,57720
4119,501702,501801,120,57540,1,"""1""",57720,57840
4119,501801,501601,60,57540,1,"""1""",57840,57900
4119,501601,500903,120,57540,1,"""1""",57900,58020
4119,500903,502801,60,57540,1,"""1""",58020,58080
4119,502801,101001,180,57540,1,"""1""",58080,58260
4119,101001,118101,60,57540,1,"""1""",58260,58320
4119,118101,106001,60,57540,1,"""1""",58320,58380
4119,106001,118001,120,57540,1,"""1""",58380,58500
4119,118001,103004,180,57540,1,"""1""",58500,58680
4119,103004,112101,180,57540,1,"""1""",58680,58860
4119,112101,117001,180,57540,1,"""1""",58860,59040
4119,117001,119003,120,57540,1,"""1""",59040,59160
4119,119003,208102,180,57540,1,"""1""",59160,59340
4119,208102,201502,120,57540,1,"""1""",59340,59460
4119,201502,203903,60,57540,1,"""1""",59460,59520
4119,203903,207801,60,57540,1,"""1""",59520,59580
4119,207801,205501,120,57540,1,"""1""",59580,59700
4119,205501,205602,60,57540,1,"""1""",59700,59760
4119,205602,201000,60,57540,1,"""1""",59760,59820
4119,201000,200400,60,57540,1,"""1""",59820,59880
4119,200400,204600,120,57540,1,"""1""",59880,60000
4119,502300,502600,0,58140,1,"""1""",58140,58140
4119,502600,502501,60,58140,1,"""1""",58140,58200
4119,502501,501702,120,58140,1,"""1""",58200,58320
4119,501702,501801,120,58140,1,"""1""",58320,58440
4119,501801,501601,60,58140,1,"""1""",58440,58500
4119,501601,500903,120,58140,1,"""1""",58500,58620
4119,500903,502801,60,58140,1,"""1""",58620,58680
4119,502801,101001,180,58140,1,"""1""",58680,58860
4119,101001,118101,60,58140,1,"""1""",58860,58920
4119,118101,106001,60,58140,1,"""1""",58920,58980
4119,106001,118001,120,58140,1,"""1""",58980,59100
4119,118001,103004,180,58140,1,"""1""",59100,59280
4119,103004,112101,180,58140,1,"""1""",59280,59460
4119,112101,117001,180,58140,1,"""1""",59460,59640
4119,117001,119003,120,58140,1,"""1""",59640,59760
4119,119003,208102,180,58140,1,"""1""",59760,59940
4119,208102,201502,120,58140,1,"""1""",59940,60060
4119,201502,203903,60,58140,1,"""1""",60060,60120
4119,203903,207801,60,58140,1,"""1""",60120,60180
4119,207801,205501,120,58140,1,"""1""",60180,60300
4119,205501,205602,60,58140,1,"""1""",60300,60360
4119,205602,201000,60,58140,1,"""1""",60360,60420
4119,201000,200400,60,58140,1,"""1""",60420,60480
4119,200400,204600,120,58140,1,"""1""",60480,60600
4119,502300,502600,0,58740,1,"""1""",58740,58740
4119,502600,502501,60,58740,1,"""1""",58740,58800
4119,502501,501702,120,58740,1,"""1""",58800,58920
4119,501702,501801,120,58740,1,"""1""",58920,59040
4119,501801,501601,60,58740,1,"""1""",59040,59100
4119,501601,500903,120,58740,1,"""1""",59100,59220
4119,500903,502801,60,58740,1,"""1""",59220,59280
4119,502801,101001,180,58740,1,"""1""",59280,59460
4119,101001,118101,60,58740,1,"""1""",59460,59520
4119,118101,106001,60,58740,1,"""1""",59520,59580
4119,106001,118001,120,58740,1,"""1""",59580,59700
4119,118001,103004,180,58740,1,"""1""",59700,59880
4119,103004,112101,180,58740,1,"""1""",59880,60060
4119,112101,117001,180,58740,1,"""1""",60060,60240
4119,117001,119003,120,58740,1,"""1""",60240,60360
4119,119003,208102,180,58740,1,"""1""",60360,60540
4119,208102,201502,120,58740,1,"""1""",60540,60660
4119,201502,203903,60,58740,1,"""1""",60660,60720
4119,203903,207801,60,58740,1,"""1""",60720,60780
4119,207801,205501,120,58740,1,"""1""",60780,60900
4119,205501,205602,60,58740,1,"""1""",60900,60960
4119,205602,201000,60,58740,1,"""1""",60960,61020
4119,201000,200400,60,58740,1,"""1""",61020,61080
4119,200400,204600,120,58740,1,"""1""",61080,61200
4119,502300,502600,0,59340,1,"""1""",59340,59340
4119,502600,502501,60,59340,1,"""1""",59340,59400
4119,502501,501702,120,59340,1,"""1""",59400,59520
4119,501702,501801,120,59340,1,"""1""",59520,59640
4119,501801,501601,60,59340,1,"""1""",59640,59700
4119,501601,500903,120,59340,1,"""1""",59700,59820
4119,500903,502801,60,59340,1,"""1""",59820,59880
4119,502801,101001,180,59340,1,"""1""",59880,60060
4119,101001,118101,60,59340,1,"""1""",60060,60120
4119,118101,106001,60,59340,1,"""1""",60120,60180
4119,106001,118001,120,59340,1,"""1""",60180,60300
4119,118001,103004,180,59340,1,"""1""",60300,60480
4119,103004,112101,180,59340,1,"""1""",60480,60660
4119,112101,117001,180,59340,1,"""1""",60660,60840
4119,117001,119003,120,59340,1,"""1""",60840,60960
4119,119003,208102,180,59340,1,"""1""",60960,61140
4119,208102,201502,120,59340,1,"""1""",61140,61260
4119,201502,203903,60,59340,1,"""1""",61260,61320
4119,203903,207801,60,59340,1,"""1""",61320,61380
4119,207801,205501,120,59340,1,"""1""",61380,61500
4119,205501,205602,60,59340,1,"""1""",61500,61560
4119,205602,201000,60,59340,1,"""1""",61560,61620
4119,201000,200400,60,59340,1,"""1""",61620,61680
4119,200400,204600,120,59340,1,"""1""",61680,61800
4119,502300,502600,0,59940,1,"""1""",59940,59940
4119,502600,502501,60,59940,1,"""1""",59940,60000
4119,502501,501702,120,59940,1,"""1""",60000,60120
4119,501702,501801,120,59940,1,"""1""",60120,60240
4119,501801,501601,60,59940,1,"""1""",60240,60300
4119,501601,500903,120,59940,1,"""1""",60300,60420
4119,500903,502801,60,59940,1,"""1""",60420,60480
4119,502801,101001,180,59940,1,"""1""",60480,60660
4119,101001,118101,60,59940,1,"""1""",60660,60720
4119,118101,106001,60,59940,1,"""1""",60720,60780
4119,106001,118001,120,59940,1,"""1""",60780,60900
4119,118001,103004,180,59940,1,"""1""",60900,61080
4119,103004,112101,180,59940,1,"""1""",61080,61260
4119,112101,117001,180,59940,1,"""1""",61260,61440
4119,117001,119003,120,59940,1,"""1""",61440,61560
4119,119003,208102,180,59940,1,"""1""",61560,61740
4119,208102,201502,120,59940,1,"""1""",61740,61860
4119,201502,203903,60,59940,1,"""1""",61860,61920
4119,203903,207801,60,59940,1,"""1""",61920,61980
4119,207801,205501,120,59940,1,"""1""",61980,62100
4119,205501,205602,60,59940,1,"""1""",62100,62160
4119,205602,201000,60,59940,1,"""1""",62160,62220
4119,201000,200400,60,59940,1,"""1""",62220,62280
4119,200400,204600,120,59940,1,"""1""",62280,62400
4119,502300,502600,0,60540,1,"""1""",60540,60540
4119,502600,502501,60,60540,1,"""1""",60540,60600
4119,502501,501702,120,60540,1,"""1""",60600,60720
4119,501702,501801,120,60540,1,"""1""",60720,60840
4119,501801,501601,60,60540,1,"""1""",60840,60900
4119,501601,500903,120,60540,1,"""1""",60900,61020
4119,500903,502801,60,60540,1,"""1""",61020,61080
4119,502801,101001,180,60540,1,"""1""",61080,61260
4119,101001,118101,60,60540,1,"""1""",61260,61320
4119,118101,106001,60,60540,1,"""1""",61320,61380
4119,106001,118001,120,60540,1,"""1""",61380,61500
4119,118001,103004,180,60540,1,"""1""",61500,61680
4119,103004,112101,180,60540,1,"""1""",61680,61860
4119,112101,117001,180,60540,1,"""1""",61860,62040
4119,117001,119003,120,60540,1,"""1""",62040,62160
4119,119003,208102,180,60540,1,"""1""",62160,62340
4119,208102,201502,120,60540,1,"""1""",62340,62460
4119,201502,203903,60,60540,1,"""1""",62460,62520
4119,203903,207801,60,60540,1,"""1""",62520,62580
4119,207801,205501,120,60540,1,"""1""",62580,62700
4119,205501,205602,60,60540,1,"""1""",62700,62760
4119,205602,201000,60,60540,1,"""1""",62760,62820
4119,201000,200400,60,60540,1,"""1""",62820,62880
4119,200400,204600,120,60540,1,"""1""",62880,63000
4119,502300,502600,0,61140,1,"""1""",61140,61140
4119,502600,502501,60,61140,1,"""1""",61140,61200
4119,502501,501702,120,61140,1,"""1""",61200,61320
4119,501702,501801,120,61140,1,"""1""",61320,61440
4119,501801,501601,60,61140,1,"""1""",61440,61500
4119,501601,500903,120,61140,1,"""1""",61500,61620
4119,500903,502801,60,61140,1,"""1""",61620,61680
4119,502801,101001,180,61140,1,"""1""",61680,61860
4119,101001,118101,60,61140,1,"""1""",61860,61920
4119,118101,106001,60,61140,1,"""1""",61920,61980
4119,106001,118001,120,61140,1,"""1""",61980,62100
4119,118001,103004,180,61140,1,"""1""",62100,62280
4119,103004,112101,180,61140,1,"""1""",62280,62460
4119,112101,117001,180,61140,1,"""1""",62460,62640
4119,117001,119003,120,61140,1,"""1""",62640,62760
4119,119003,208102,180,61140,1,"""1""",62760,62940
4119,208102,201502,120,61140,1,"""1""",62940,63060
4119,201502,203903,60,61140,1,"""1""",63060,63120
4119,203903,207801,60,61140,1,"""1""",63120,63180
4119,207801,205501,120,61140,1,"""1""",63180,63300
4119,205501,205602,60,61140,1,"""1""",63300,63360
4119,205602,201000,60,61140,1,"""1""",63360,63420
4119,201000,200400,60,61140,1,"""1""",63420,63480
4119,200400,204600,120,61140,1,"""1""",63480,63600
4119,502300,502600,0,61740,1,"""1""",61740,61740
4119,502600,502501,60,61740,1,"""1""",61740,61800
4119,502501,501702,120,61740,1,"""1""",61800,61920
4119,501702,501801,120,61740,1,"""1""",61920,62040
4119,501801,501601,60,61740,1,"""1""",62040,62100
4119,501601,500903,120,61740,1,"""1""",62100,62220
4119,500903,502801,60,61740,1,"""1""",62220,62280
4119,502801,101001,180,61740,1,"""1""",62280,62460
4119,101001,118101,60,61740,1,"""1""",62460,62520
4119,118101,106001,60,61740,1,"""1""",62520,62580
4119,106001,118001,120,61740,1,"""1""",62580,62700
4119,118001,103004,180,61740,1,"""1""",62700,62880
4119,103004,112101,180,61740,1,"""1""",62880,63060
4119,112101,117001,180,61740,1,"""1""",63060,63240
4119,117001,119003,120,61740,1,"""1""",63240,63360
4119,119003,208102,180,61740,1,"""1""",63360,63540
4119,208102,201502,120,61740,1,"""1""",63540,63660
4119,201502,203903,60,61740,1,"""1""",63660,63720
4119,203903,207801,60,61740,1,"""1""",63720,63780
4119,207801,205501,120,61740,1,"""1""",63780,63900
4119,205501,205602,60,61740,1,"""1""",63900,63960
4119,205602,201000,60,61740,1,"""1""",63960,64020
4119,201000,200400,60,61740,1,"""1""",64020,64080
4119,200400,204600,120,61740,1,"""1""",64080,64200
4119,502300,502600,0,62340,1,"""1""",62340,62340
4119,502600,502501,60,62340,1,"""1""",62340,62400
4119,502501,501702,120,62340,1,"""1""",62400,62520
4119,501702,501801,120,62340,1,"""1""",62520,62640
4119,501801,501601,60,62340,1,"""1""",62640,62700
4119,501601,500903,120,62340,1,"""1""",62700,62820
4119,500903,502801,60,62340,1,"""1""",62820,62880
4119,502801,101001,180,62340,1,"""1""",62880,63060
4119,101001,118101,60,62340,1,"""1""",63060,63120
4119,118101,106001,60,62340,1,"""1""",63120,63180
4119,106001,118001,120,62340,1,"""1""",63180,63300
4119,118001,103004,180,62340,1,"""1""",63300,63480
4119,103004,112101,180,62340,1,"""1""",63480,63660
4119,112101,117001,180,62340,1,"""1""",63660,63840
4119,117001,119003,120,62340,1,"""1""",63840,63960
4119,119003,208102,180,62340,1,"""1""",63960,64140
4119,208102,201502,120,62340,1,"""1""",64140,64260
4119,201502,203903,60,62340,1,"""1""",64260,64320
4119,203903,207801,60,62340,1,"""1""",64320,64380
4119,207801,205501,120,62340,1,"""1""",64380,64500
4119,205501,205602,60,62340,1,"""1""",64500,64560
4119,205602,201000,60,62340,1,"""1""",64560,64620
4119,201000,200400,60,62340,1,"""1""",64620,64680
4119,200400,204600,120,62340,1,"""1""",64680,64800
4119,502300,502600,0,62940,1,"""1""",62940,62940
4119,502600,502501,60,62940,1,"""1""",62940,63000
4119,502501,501702,120,62940,1,"""1""",63000,63120
4119,501702,501801,120,62940,1,"""1""",63120,63240
4119,501801,501601,60,62940,1,"""1""",63240,63300
4119,501601,500903,120,62940,1,"""1""",63300,63420
4119,500903,502801,60,62940,1,"""1""",63420,63480
4119,502801,101001,180,62940,1,"""1""",63480,63660
4119,101001,118101,60,62940,1,"""1""",63660,63720
4119,118101,106001,60,62940,1,"""1""",63720,63780
4119,106001,118001,120,62940,1,"""1""",63780,63900
4119,118001,103004,180,62940,1,"""1""",63900,64080
4119,103004,112101,180,62940,1,"""1""",64080,64260
4119,112101,117001,180,62940,1,"""1""",64260,64440
4119,117001,119003,120,62940,1,"""1""",64440,64560
4119,119003,208102,180,62940,1,"""1""",64560,64740
4119,208102,201502,120,62940,1,"""1""",64740,64860
4119,201502,203903,60,62940,1,"""1""",64860,64920
4119,203903,207801,60,62940,1,"""1""",64920,64980
4119,207801,205501,120,62940,1,"""1""",64980,65100
4119,205501,205602,60,62940,1,"""1""",65100,65160
4119,205602,201000,60,62940,1,"""1""",65160,65220
4119,201000,200400,60,62940,1,"""1""",65220,65280
4119,200400,204600,120,62940,1,"""1""",65280,65400
4119,502300,502600,0,63540,1,"""1""",63540,63540
4119,502600,502501,60,63540,1,"""1""",63540,63600
4119,502501,501702,120,63540,1,"""1""",63600,63720
4119,501702,501801,120,63540,1,"""1""",63720,63840
4119,501801,501601,60,63540,1,"""1""",63840,63900
4119,501601,500903,120,63540,1,"""1""",63900,64020
4119,500903,502801,60,63540,1,"""1""",64020,64080
4119,502801,101001,180,63540,1,"""1""",64080,64260
4119,101001,118101,60,63540,1,"""1""",64260,64320
4119,118101,106001,60,63540,1,"""1""",64320,64380
4119,106001,118001,120,63540,1,"""1""",64380,64500
4119,118001,103004,180,63540,1,"""1""",64500,64680
4119,103004,112101,180,63540,1,"""1""",64680,64860
4119,112101,117001,180,63540,1,"""1""",64860,65040
4119,117001,119003,120,63540,1,"""1""",65040,65160
4119,119003,208102,180,63540,1,"""1""",65160,65340
4119,208102,201502,120,63540,1,"""1""",65340,65460
4119,201502,203903,60,63540,1,"""1""",65460,65520
4119,203903,207801,60,63540,1,"""1""",65520,65580
4119,207801,205501,120,63540,1,"""1""",65580,65700
4119,205501,205602,60,63540,1,"""1""",65700,65760
4119,205602,201000,60,63540,1,"""1""",65760,65820
4119,201000,200400,60,63540,1,"""1""",65820,65880
4119,200400,204600,120,63540,1,"""1""",65880,66000
4119,502300,502600,0,64140,1,"""1""",64140,64140
4119,502600,502501,60,64140,1,"""1""",64140,64200
4119,502501,501702,120,64140,1,"""1""",64200,64320
4119,501702,501801,120,64140,1,"""1""",64320,64440
4119,501801,501601,60,64140,1,"""1""",64440,64500
4119,501601,500903,120,64140,1,"""1""",64500,64620
4119,500903,502801,60,64140,1,"""1""",64620,64680
4119,502801,101001,180,64140,1,"""1""",64680,64860
4119,101001,118101,60,64140,1,"""1""",64860,64920
4119,118101,106001,60,64140,1,"""1""",64920,64980
4119,106001,118001,120,64140,1,"""1""",64980,65100
4119,118001,103004,180,64140,1,"""1""",65100,65280
4119,103004,112101,180,64140,1,"""1""",65280,65460
4119,112101,117001,180,64140,1,"""1""",65460,65640
4119,117001,119003,120,64140,1,"""1""",65640,65760
4119,119003,208102,180,64140,1,"""1""",65760,65940
4119,208102,201502,120,64140,1,"""1""",65940,66060
4119,201502,203903,60,64140,1,"""1""",66060,66120
4119,203903,207801,60,64140,1,"""1""",66120,66180
4119,207801,205501,120,64140,1,"""1""",66180,66300
4119,205501,205602,60,64140,1,"""1""",66300,66360
4119,205602,201000,60,64140,1,"""1""",66360,66420
4119,201000,200400,60,64140,1,"""1""",66420,66480
4119,200400,204600,120,64140,1,"""1""",66480,66600
4119,502300,502600,0,64740,1,"""1""",64740,64740
4119,502600,502501,60,64740,1,"""1""",64740,64800
4119,502501,501702,120,64740,1,"""1""",64800,64920
4119,501702,501801,120,64740,1,"""1""",64920,65040
4119,501801,501601,60,64740,1,"""1""",65040,65100
4119,501601,500903,120,64740,1,"""1""",65100,65220
4119,500903,502801,60,64740,1,"""1""",65220,65280
4119,502801,101001,180,64740,1,"""1""",65280,65460
4119,101001,118101,60,64740,1,"""1""",65460,65520
4119,118101,106001,60,64740,1,"""1""",65520,65580
4119,106001,118001,120,64740,1,"""1""",65580,65700
4119,118001,103004,180,64740,1,"""1""",65700,65880
4119,103004,112101,180,64740,1,"""1""",65880,66060
4119,112101,117001,180,64740,1,"""1""",66060,66240
4119,117001,119003,120,64740,1,"""1""",66240,66360
4119,119003,208102,180,64740,1,"""1""",66360,66540
4119,208102,201502,120,64740,1,"""1""",66540,66660
4119,201502,203903,60,64740,1,"""1""",66660,66720
4119,203903,207801,60,64740,1,"""1""",66720,66780
4119,207801,205501,120,64740,1,"""1""",66780,66900
4119,205501,205602,60,64740,1,"""1""",66900,66960
4119,205602,201000,60,64740,1,"""1""",66960,67020
4119,201000,200400,60,64740,1,"""1""",67020,67080
4119,200400,204600,120,64740,1,"""1""",67080,67200
4119,502300,502600,0,65340,1,"""1""",65340,65340
4119,502600,502501,60,65340,1,"""1""",65340,65400
4119,502501,501702,120,65340,1,"""1""",65400,65520
4119,501702,501801,120,65340,1,"""1""",65520,65640
4119,501801,501601,60,65340,1,"""1""",65640,65700
4119,501601,500903,120,65340,1,"""1""",65700,65820
4119,500903,502801,60,65340,1,"""1""",65820,65880
4119,502801,101001,180,65340,1,"""1""",65880,66060
4119,101001,118101,60,65340,1,"""1""",66060,66120
4119,118101,106001,60,65340,1,"""1""",66120,66180
4119,106001,118001,120,65340,1,"""1""",66180,66300
4119,118001,103004,180,65340,1,"""1""",66300,66480
4119,103004,112101,180,65340,1,"""1""",66480,66660
4119,112101,117001,180,65340,1,"""1""",66660,66840
4119,117001,119003,120,65340,1,"""1""",66840,66960
4119,119003,208102,180,65340,1,"""1""",66960,67140
4119,208102,201502,120,65340,1,"""1""",67140,67260
4119,201502,203903,60,65340,1,"""1""",67260,67320
4119,203903,207801,60,65340,1,"""1""",67320,67380
4119,207801,205501,120,65340,1,"""1""",67380,67500
4119,205501,205602,60,65340,1,"""1""",67500,67560
4119,205602,201000,60,65340,1,"""1""",67560,67620
4119,201000,200400,60,65340,1,"""1""",67620,67680
4119,200400,204600,120,65340,1,"""1""",67680,67800
4119,502300,502600,0,65940,1,"""1""",65940,65940
4119,502600,502501,60,65940,1,"""1""",65940,66000
4119,502501,501702,120,65940,1,"""1""",66000,66120
4119,501702,501801,120,65940,1,"""1""",66120,66240
4119,501801,501601,60,65940,1,"""1""",66240,66300
4119,501601,500903,120,65940,1,"""1""",66300,66420
4119,500903,502801,60,65940,1,"""1""",66420,66480
4119,502801,101001,180,65940,1,"""1""",66480,66660
4119,101001,118101,60,65940,1,"""1""",66660,66720
4119,118101,106001,60,65940,1,"""1""",66720,66780
4119,106001,118001,120,65940,1,"""1""",66780,66900
4119,118001,103004,180,65940,1,"""1""",66900,67080
4119,103004,112101,180,65940,1,"""1""",67080,67260
4119,112101,117001,180,65940,1,"""1""",67260,67440
4119,117001,119003,120,65940,1,"""1""",67440,67560
4119,119003,208102,180,65940,1,"""1""",67560,67740
4119,208102,201502,120,65940,1,"""1""",67740,67860
4119,201502,203903,60,65940,1,"""1""",67860,67920
4119,203903,207801,60,65940,1,"""1""",67920,67980
4119,207801,205501,120,65940,1,"""1""",67980,68100
4119,205501,205602,60,65940,1,"""1""",68100,68160
4119,205602,201000,60,65940,1,"""1""",68160,68220
4119,201000,200400,60,65940,1,"""1""",68220,68280
4119,200400,204600,120,65940,1,"""1""",68280,68400
4119,502300,502600,0,66540,1,"""1""",66540,66540
4119,502600,502501,60,66540,1,"""1""",66540,66600
4119,502501,501702,120,66540,1,"""1""",66600,66720
4119,501702,501801,120,66540,1,"""1""",66720,66840
4119,501801,501601,60,66540,1,"""1""",66840,66900
4119,501601,500903,120,66540,1,"""1""",66900,67020
4119,500903,502801,60,66540,1,"""1""",67020,67080
4119,502801,101001,180,66540,1,"""1""",67080,67260
4119,101001,118101,60,66540,1,"""1""",67260,67320
4119,118101,106001,60,66540,1,"""1""",67320,67380
4119,106001,118001,120,66540,1,"""1""",67380,67500
4119,118001,103004,180,66540,1,"""1""",67500,67680
4119,103004,112101,180,66540,1,"""1""",67680,67860
4119,112101,117001,180,66540,1,"""1""",67860,68040
4119,117001,119003,120,66540,1,"""1""",68040,68160
4119,119003,208102,180,66540,1,"""1""",68160,68340
4119,208102,201502,120,66540,1,"""1""",68340,68460
4119,201502,203903,60,66540,1,"""1""",68460,68520
4119,203903,207801,60,66540,1,"""1""",68520,68580
4119,207801,205501,120,66540,1,"""1""",68580,68700
4119,205501,205602,60,66540,1,"""1""",68700,68760
4119,205602,201000,60,66540,1,"""1""",68760,68820
4119,201000,200400,60,66540,1,"""1""",68820,68880
4119,200400,204600,120,66540,1,"""1""",68880,69000
4119,502300,502600,0,67140,1,"""1""",67140,67140
4119,502600,502501,60,67140,1,"""1""",67140,67200
4119,502501,501702,120,67140,1,"""1""",67200,67320
4119,501702,501801,120,67140,1,"""1""",67320,67440
4119,501801,501601,60,67140,1,"""1""",67440,67500
4119,501601,500903,120,67140,1,"""1""",67500,67620
4119,500903,502801,60,67140,1,"""1""",67620,67680
4119,502801,101001,180,67140,1,"""1""",67680,67860
4119,101001,118101,60,67140,1,"""1""",67860,67920
4119,118101,106001,60,67140,1,"""1""",67920,67980
4119,106001,118001,120,67140,1,"""1""",67980,68100
4119,118001,103004,180,67140,1,"""1""",68100,68280
4119,103004,112101,180,67140,1,"""1""",68280,68460
4119,112101,117001,180,67140,1,"""1""",68460,68640
4119,117001,119003,120,67140,1,"""1""",68640,68760
4119,119003,208102,180,67140,1,"""1""",68760,68940
4119,208102,201502,120,67140,1,"""1""",68940,69060
4119,201502,203903,60,67140,1,"""1""",69060,69120
4119,203903,207801,60,67140,1,"""1""",69120,69180
4119,207801,205501,120,67140,1,"""1""",69180,69300
4119,205501,205602,60,67140,1,"""1""",69300,69360
4119,205602,201000,60,67140,1,"""1""",69360,69420
4119,201000,200400,60,67140,1,"""1""",69420,69480
4119,200400,204600,120,67140,1,"""1""",69480,69600
4119,502300,502600,0,67740,1,"""1""",67740,67740
4119,502600,502501,60,67740,1,"""1""",67740,67800
4119,502501,501702,120,67740,1,"""1""",67800,67920
4119,501702,501801,120,67740,1,"""1""",67920,68040
4119,501801,501601,60,67740,1,"""1""",68040,68100
4119,501601,500903,120,67740,1,"""1""",68100,68220
4119,500903,502801,60,67740,1,"""1""",68220,68280
4119,502801,101001,180,67740,1,"""1""",68280,68460
4119,101001,118101,60,67740,1,"""1""",68460,68520
4119,118101,106001,60,67740,1,"""1""",68520,68580
4119,106001,118001,120,67740,1,"""1""",68580,68700
4119,118001,103004,180,67740,1,"""1""",68700,68880
4119,103004,112101,180,67740,1,"""1""",68880,69060
4119,112101,117001,180,67740,1,"""1""",69060,69240
4119,117001,119003,120,67740,1,"""1""",69240,69360
4119,119003,208102,180,67740,1,"""1""",69360,69540
4119,208102,201502,120,67740,1,"""1""",69540,69660
4119,201502,203903,60,67740,1,"""1""",69660,69720
4119,203903,207801,60,67740,1,"""1""",69720,69780
4119,207801,205501,120,67740,1,"""1""",69780,69900
4119,205501,205602,60,67740,1,"""1""",69900,69960
4119,205602,201000,60,67740,1,"""1""",69960,70020
4119,201000,200400,60,67740,1,"""1""",70020,70080
4119,200400,204600,120,67740,1,"""1""",70080,70200
4119,502300,502600,0,68340,1,"""1""",68340,68340
4119,502600,502501,60,68340,1,"""1""",68340,68400
4119,502501,501702,120,68340,1,"""1""",68400,68520
4119,501702,501801,120,68340,1,"""1""",68520,68640
4119,501801,501601,60,68340,1,"""1""",68640,68700
4119,501601,500903,120,68340,1,"""1""",68700,68820
4119,500903,502801,60,68340,1,"""1""",68820,68880
4119,502801,101001,180,68340,1,"""1""",68880,69060
4119,101001,118101,60,68340,1,"""1""",69060,69120
4119,118101,106001,60,68340,1,"""1""",69120,69180
4119,106001,118001,120,68340,1,"""1""",69180,69300
4119,118001,103004,180,68340,1,"""1""",69300,69480
4119,103004,112101,180,68340,1,"""1""",69480,69660
4119,112101,117001,180,68340,1,"""1""",69660,69840
4119,117001,119003,120,68340,1,"""1""",69840,69960
4119,119003,208102,180,68340,1,"""1""",69960,70140
4119,208102,201502,120,68340,1,"""1""",70140,70260
4119,201502,203903,60,68340,1,"""1""",70260,70320
4119,203903,207801,60,68340,1,"""1""",70320,70380
4119,207801,205501,120,68340,1,"""1""",70380,70500
4119,205501,205602,60,68340,1,"""1""",70500,70560
4119,205602,201000,60,68340,1,"""1""",70560,70620
4119,201000,200400,60,68340,1,"""1""",70620,70680
4119,200400,204600,120,68340,1,"""1""",70680,70800
4119,502300,502600,0,68940,1,"""1""",68940,68940
4119,502600,502501,60,68940,1,"""1""",68940,69000
4119,502501,501702,120,68940,1,"""1""",69000,69120
4119,501702,501801,120,68940,1,"""1""",69120,69240
4119,501801,501601,60,68940,1,"""1""",69240,69300
4119,501601,500903,120,68940,1,"""1""",69300,69420
4119,500903,502801,60,68940,1,"""1""",69420,69480
4119,502801,101001,180,68940,1,"""1""",69480,69660
4119,101001,118101,60,68940,1,"""1""",69660,69720
4119,118101,106001,60,68940,1,"""1""",69720,69780
4119,106001,118001,120,68940,1,"""1""",69780,69900
4119,118001,103004,180,68940,1,"""1""",69900,70080
4119,103004,112101,180,68940,1,"""1""",70080,70260
4119,112101,117001,180,68940,1,"""1""",70260,70440
4119,117001,119003,120,68940,1,"""1""",70440,70560
4119,119003,208102,180,68940,1,"""1""",70560,70740
4119,208102,201502,120,68940,1,"""1""",70740,70860
4119,201502,203903,60,68940,1,"""1""",70860,70920
4119,203903,207801,60,68940,1,"""1""",70920,70980
4119,207801,205501,120,68940,1,"""1""",70980,71100
4119,205501,205602,60,68940,1,"""1""",71100,71160
4119,205602,201000,60,68940,1,"""1""",71160,71220
4119,201000,200400,60,68940,1,"""1""",71220,71280
4119,200400,204600,120,68940,1,"""1""",71280,71400
4119,502300,502600,0,69720,1,"""1""",69720,69720
4119,502600,502501,60,69720,1,"""1""",69720,69780
4119,502501,501702,120,69720,1,"""1""",69780,69900
4119,501702,501801,120,69720,1,"""1""",69900,70020
4119,501801,501601,60,69720,1,"""1""",70020,70080
4119,501601,500903,120,69720,1,"""1""",70080,70200
4119,500903,502801,60,69720,1,"""1""",70200,70260
4119,502801,101001,180,69720,1,"""1""",70260,70440
4119,101001,118101,60,69720,1,"""1""",70440,70500
4119,118101,106001,60,69720,1,"""1""",70500,70560
4119,106001,118001,120,69720,1,"""1""",70560,70680
4119,118001,103004,180,69720,1,"""1""",70680,70860
4119,103004,112101,180,69720,1,"""1""",70860,71040
4119,112101,117001,180,69720,1,"""1""",71040,71220
4119,117001,119003,120,69720,1,"""1""",71220,71340
4119,119003,208102,180,69720,1,"""1""",71340,71520
4119,208102,201502,120,69720,1,"""1""",71520,71640
4119,201502,203903,60,69720,1,"""1""",71640,71700
4119,203903,207801,60,69720,1,"""1""",71700,71760
4119,207801,205501,120,69720,1,"""1""",71760,71880
4119,205501,205602,60,69720,1,"""1""",71880,71940
4119,205602,201000,60,69720,1,"""1""",71940,72000
4119,201000,200400,60,69720,1,"""1""",72000,72060
4119,200400,204600,120,69720,1,"""1""",72060,72180
4121,502300,502600,0,20460,1,"""1""",20460,20460
4121,502600,502501,60,20460,1,"""1""",20460,20520
4121,502501,501702,120,20460,1,"""1""",20520,20640
4121,501702,501801,120,20460,1,"""1""",20640,20760
4121,501801,501601,60,20460,1,"""1""",20760,20820
4121,501601,500903,60,20460,1,"""1""",20820,20880
4121,500903,502801,60,20460,1,"""1""",20880,20940
4121,502801,101001,180,20460,1,"""1""",20940,21120
4121,101001,118101,60,20460,1,"""1""",21120,21180
4121,118101,106001,60,20460,1,"""1""",21180,21240
4121,106001,118001,120,20460,1,"""1""",21240,21360
4121,118001,103004,180,20460,1,"""1""",21360,21540
4121,103004,112101,180,20460,1,"""1""",21540,21720
4121,112101,117001,180,20460,1,"""1""",21720,21900
4121,117001,119003,120,20460,1,"""1""",21900,22020
4121,119003,208102,120,20460,1,"""1""",22020,22140
4121,208102,201502,120,20460,1,"""1""",22140,22260
4121,201502,203903,60,20460,1,"""1""",22260,22320
4121,203903,207801,60,20460,1,"""1""",22320,22380
4121,207801,205501,60,20460,1,"""1""",22380,22440
4121,205501,205602,60,20460,1,"""1""",22440,22500
4121,205602,201000,60,20460,1,"""1""",22500,22560
4121,201000,200400,60,20460,1,"""1""",22560,22620
4121,200400,204600,60,20460,1,"""1""",22620,22680
4121,502300,502600,0,21600,1,"""1""",21600,21600
4121,502600,502501,60,21600,1,"""1""",21600,21660
4121,502501,501702,120,21600,1,"""1""",21660,21780
4121,501702,501801,120,21600,1,"""1""",21780,21900
4121,501801,501601,60,21600,1,"""1""",21900,21960
4121,501601,500903,60,21600,1,"""1""",21960,22020
4121,500903,502801,60,21600,1,"""1""",22020,22080
4121,502801,101001,180,21600,1,"""1""",22080,22260
4121,101001,118101,60,21600,1,"""1""",22260,22320
4121,118101,106001,60,21600,1,"""1""",22320,22380
4121,106001,118001,120,21600,1,"""1""",22380,22500
4121,118001,103004,180,21600,1,"""1""",22500,22680
4121,103004,112101,180,21600,1,"""1""",22680,22860
4121,112101,117001,180,21600,1,"""1""",22860,23040
4121,117001,119003,120,21600,1,"""1""",23040,23160
4121,119003,208102,120,21600,1,"""1""",23160,23280
4121,208102,201502,120,21600,1,"""1""",23280,23400
4121,201502,203903,60,21600,1,"""1""",23400,23460
4121,203903,207801,60,21600,1,"""1""",23460,23520
4121,207801,205501,60,21600,1,"""1""",23520,23580
4121,205501,205602,60,21600,1,"""1""",23580,23640
4121,205602,201000,60,21600,1,"""1""",23640,23700
4121,201000,200400,60,21600,1,"""1""",23700,23760
4121,200400,204600,60,21600,1,"""1""",23760,23820
4121,502300,502600,0,22200,1,"""1""",22200,22200
4121,502600,502501,60,22200,1,"""1""",22200,22260
4121,502501,501702,120,22200,1,"""1""",22260,22380
4121,501702,501801,120,22200,1,"""1""",22380,22500
4121,501801,501601,60,22200,1,"""1""",22500,22560
4121,501601,500903,60,22200,1,"""1""",22560,22620
4121,500903,502801,60,22200,1,"""1""",22620,22680
4121,502801,101001,180,22200,1,"""1""",22680,22860
4121,101001,118101,60,22200,1,"""1""",22860,22920
4121,118101,106001,60,22200,1,"""1""",22920,22980
4121,106001,118001,120,22200,1,"""1""",22980,23100
4121,118001,103004,180,22200,1,"""1""",23100,23280
4121,103004,112101,180,22200,1,"""1""",23280,23460
4121,112101,117001,180,22200,1,"""1""",23460,23640
4121,117001,119003,120,22200,1,"""1""",23640,23760
4121,119003,208102,120,22200,1,"""1""",23760,23880
4121,208102,201502,120,22200,1,"""1""",23880,24000
4121,201502,203903,60,22200,1,"""1""",24000,24060
4121,203903,207801,60,22200,1,"""1""",24060,24120
4121,207801,205501,60,22200,1,"""1""",24120,24180
4121,205501,205602,60,22200,1,"""1""",24180,24240
4121,205602,201000,60,22200,1,"""1""",24240,24300
4121,201000,200400,60,22200,1,"""1""",24300,24360
4121,200400,204600,60,22200,1,"""1""",24360,24420
4121,502300,502600,0,22800,1,"""1""",22800,22800
4121,502600,502501,60,22800,1,"""1""",22800,22860
4121,502501,501702,120,22800,1,"""1""",22860,22980
4121,501702,501801,120,22800,1,"""1""",22980,23100
4121,501801,501601,60,22800,1,"""1""",23100,23160
4121,501601,500903,60,22800,1,"""1""",23160,23220
4121,500903,502801,60,22800,1,"""1""",23220,23280
4121,502801,101001,180,22800,1,"""1""",23280,23460
4121,101001,118101,60,22800,1,"""1""",23460,23520
4121,118101,106001,60,22800,1,"""1""",23520,23580
4121,106001,118001,120,22800,1,"""1""",23580,23700
4121,118001,103004,180,22800,1,"""1""",23700,23880
4121,103004,112101,180,22800,1,"""1""",23880,24060
4121,112101,117001,180,22800,1,"""1""",24060,24240
4121,117001,119003,120,22800,1,"""1""",24240,24360
4121,119003,208102,120,22800,1,"""1""",24360,24480
4121,208102,201502,120,22800,1,"""1""",24480,24600
4121,201502,203903,60,22800,1,"""1""",24600,24660
4121,203903,207801,60,22800,1,"""1""",24660,24720
4121,207801,205501,60,22800,1,"""1""",24720,24780
4121,205501,205602,60,22800,1,"""1""",24780,24840
4121,205602,201000,60,22800,1,"""1""",24840,24900
4121,201000,200400,60,22800,1,"""1""",24900,24960
4121,200400,204600,60,22800,1,"""1""",24960,25020
4121,502300,502600,0,23400,1,"""1""",23400,23400
4121,502600,502501,60,23400,1,"""1""",23400,23460
4121,502501,501702,120,23400,1,"""1""",23460,23580
4121,501702,501801,120,23400,1,"""1""",23580,23700
4121,501801,501601,60,23400,1,"""1""",23700,23760
4121,501601,500903,60,23400,1,"""1""",23760,23820
4121,500903,502801,60,23400,1,"""1""",23820,23880
4121,502801,101001,180,23400,1,"""1""",23880,24060
4121,101001,118101,60,23400,1,"""1""",24060,24120
4121,118101,106001,60,23400,1,"""1""",24120,24180
4121,106001,118001,120,23400,1,"""1""",24180,24300
4121,118001,103004,180,23400,1,"""1""",24300,24480
4121,103004,112101,180,23400,1,"""1""",24480,24660
4121,112101,117001,180,23400,1,"""1""",24660,24840
4121,117001,119003,120,23400,1,"""1""",24840,24960
4121,119003,208102,120,23400,1,"""1""",24960,25080
4121,208102,201502,120,23400,1,"""1""",25080,25200
4121,201502,203903,60,23400,1,"""1""",25200,25260
4121,203903,207801,60,23400,1,"""1""",25260,25320
4121,207801,205501,60,23400,1,"""1""",25320,25380
4121,205501,205602,60,23400,1,"""1""",25380,25440
4121,205602,201000,60,23400,1,"""1""",25440,25500
4121,201000,200400,60,23400,1,"""1""",25500,25560
4121,200400,204600,60,23400,1,"""1""",25560,25620
4122,502300,502600,0,18900,1,"""1""",18900,18900
4122,502600,502501,60,18900,1,"""1""",18900,18960
4122,502501,501702,120,18900,1,"""1""",18960,19080
4122,501702,501801,60,18900,1,"""1""",19080,19140
4122,501801,501601,60,18900,1,"""1""",19140,19200
4122,501601,500903,60,18900,1,"""1""",19200,19260
4122,500903,502801,60,18900,1,"""1""",19260,19320
4122,502801,101001,120,18900,1,"""1""",19320,19440
4122,101001,118101,60,18900,1,"""1""",19440,19500
4122,118101,106001,60,18900,1,"""1""",19500,19560
4122,106001,118001,60,18900,1,"""1""",19560,19620
4122,118001,103004,180,18900,1,"""1""",19620,19800
4122,103004,112101,120,18900,1,"""1""",19800,19920
4122,112101,117001,120,18900,1,"""1""",19920,20040
4122,117001,119003,120,18900,1,"""1""",20040,20160
4122,119003,208102,120,18900,1,"""1""",20160,20280
4122,208102,201502,120,18900,1,"""1""",20280,20400
4122,201502,203903,60,18900,1,"""1""",20400,20460
4122,203903,207801,60,18900,1,"""1""",20460,20520
4122,207801,205501,60,18900,1,"""1""",20520,20580
4122,205501,205602,60,18900,1,"""1""",20580,20640
4122,205602,201000,60,18900,1,"""1""",20640,20700
4122,201000,200400,60,18900,1,"""1""",20700,20760
4122,200400,204600,120,18900,1,"""1""",20760,20880
4122,502300,502600,0,20100,1,"""1""",20100,20100
4122,502600,502501,60,20100,1,"""1""",20100,20160
4122,502501,501702,120,20100,1,"""1""",20160,20280
4122,501702,501801,60,20100,1,"""1""",20280,20340
4122,501801,501601,60,20100,1,"""1""",20340,20400
4122,501601,500903,60,20100,1,"""1""",20400,20460
4122,500903,502801,60,20100,1,"""1""",20460,20520
4122,502801,101001,120,20100,1,"""1""",20520,20640
4122,101001,118101,60,20100,1,"""1""",20640,20700
4122,118101,106001,60,20100,1,"""1""",20700,20760
4122,106001,118001,60,20100,1,"""1""",20760,20820
4122,118001,103004,180,20100,1,"""1""",20820,21000
4122,103004,112101,120,20100,1,"""1""",21000,21120
4122,112101,117001,120,20100,1,"""1""",21120,21240
4122,117001,119003,120,20100,1,"""1""",21240,21360
4122,119003,208102,120,20100,1,"""1""",21360,21480
4122,208102,201502,120,20100,1,"""1""",21480,21600
4122,201502,203903,60,20100,1,"""1""",21600,21660
4122,203903,207801,60,20100,1,"""1""",21660,21720
4122,207801,205501,60,20100,1,"""1""",21720,21780
4122,205501,205602,60,20100,1,"""1""",21780,21840
4122,205602,201000,60,20100,1,"""1""",21840,21900
4122,201000,200400,60,20100,1,"""1""",21900,21960
4122,200400,204600,120,20100,1,"""1""",21960,22080
4123,204600,200600,0,24420,1,"""2""",24420,24420
4123,200600,204200,60,24420,1,"""2""",24420,24480
4123,204200,204500,60,24420,1,"""2""",24480,24540
4123,204500,200500,120,24420,1,"""2""",24540,24660
4123,200500,205603,60,24420,1,"""2""",24660,24720
4123,205603,205503,60,24420,1,"""2""",24720,24780
4123,205503,207802,60,24420,1,"""2""",24780,24840
4123,207802,203900,180,24420,1,"""2""",24840,25020
4123,203900,201503,60,24420,1,"""2""",25020,25080
4123,201503,208103,120,24420,1,"""2""",25080,25200
4123,208103,119004,120,24420,1,"""2""",25200,25320
4123,119004,117002,60,24420,1,"""2""",25320,25380
4123,117002,112105,180,24420,1,"""2""",25380,25560
4123,112105,103003,180,24420,1,"""2""",25560,25740
4123,103003,118002,180,24420,1,"""2""",25740,25920
4123,118002,106002,60,24420,1,"""2""",25920,25980
4123,106002,118102,60,24420,1,"""2""",25980,26040
4123,118102,101004,120,24420,1,"""2""",26040,26160
4123,101004,502802,120,24420,1,"""2""",26160,26280
4123,502802,500904,120,24420,1,"""2""",26280,26400
4123,500904,501602,60,24420,1,"""2""",26400,26460
4123,501602,501802,60,24420,1,"""2""",26460,26520
4123,501802,502000,60,24420,1,"""2""",26520,26580
4123,502000,501704,120,24420,1,"""2""",26580,26700
4123,501704,502502,60,24420,1,"""2""",26700,26760
4123,502502,501500,60,24420,1,"""2""",26760,26820
4123,501500,500500,60,24420,1,"""2""",26820,26880
4123,500500,500300,60,24420,1,"""2""",26880,26940
4123,500300,500200,60,24420,1,"""2""",26940,27000
4123,500200,502300,180,24420,1,"""2""",27000,27180
4123,204600,200600,0,25020,1,"""2""",25020,25020
4123,200600,204200,60,25020,1,"""2""",25020,25080
4123,204200,204500,60,25020,1,"""2""",25080,25140
4123,204500,200500,120,25020,1,"""2""",25140,25260
4123,200500,205603,60,25020,1,"""2""",25260,25320
4123,205603,205503,60,25020,1,"""2""",25320,25380
4123,205503,207802,60,25020,1,"""2""",25380,25440
4123,207802,203900,180,25020,1,"""2""",25440,25620
4123,203900,201503,60,25020,1,"""2""",25620,25680
4123,201503,208103,120,25020,1,"""2""",25680,25800
4123,208103,119004,120,25020,1,"""2""",25800,25920
4123,119004,117002,60,25020,1,"""2""",25920,25980
4123,117002,112105,180,25020,1,"""2""",25980,26160
4123,112105,103003,180,25020,1,"""2""",26160,26340
4123,103003,118002,180,25020,1,"""2""",26340,26520
4123,118002,106002,60,25020,1,"""2""",26520,26580
4123,106002,118102,60,25020,1,"""2""",26580,26640
4123,118102,101004,120,25020,1,"""2""",26640,26760
4123,101004,502802,120,25020,1,"""2""",26760,26880
4123,502802,500904,120,25020,1,"""2""",26880,27000
4123,500904,501602,60,25020,1,"""2""",27000,27060
4123,501602,501802,60,25020,1,"""2""",27060,27120
4123,501802,502000,60,25020,1,"""2""",27120,27180
4123,502000,501704,120,25020,1,"""2""",27180,27300
4123,501704,502502,60,25020,1,"""2""",27300,27360
4123,502502,501500,60,25020,1,"""2""",27360,27420
4123,501500,500500,60,25020,1,"""2""",27420,27480
4123,500500,500300,60,25020,1,"""2""",27480,27540
4123,500300,500200,60,25020,1,"""2""",27540,27600
4123,500200,502300,180,25020,1,"""2""",27600,27780
4123,204600,200600,0,25620,1,"""2""",25620,25620
4123,200600,204200,60,25620,1,"""2""",25620,25680
4123,204200,204500,60,25620,1,"""2""",25680,25740
4123,204500,200500,120,25620,1,"""2""",25740,25860
4123,200500,205603,60,25620,1,"""2""",25860,25920
4123,205603,205503,60,25620,1,"""2""",25920,25980
4123,205503,207802,60,25620,1,"""2""",25980,26040
4123,207802,203900,180,25620,1,"""2""",26040,26220
4123,203900,201503,60,25620,1,"""2""",26220,26280
4123,201503,208103,120,25620,1,"""2""",26280,26400
4123,208103,119004,120,25620,1,"""2""",26400,26520
4123,119004,117002,60,25620,1,"""2""",26520,26580
4123,117002,112105,180,25620,1,"""2""",26580,26760
4123,112105,103003,180,25620,1,"""2""",26760,26940
4123,103003,118002,180,25620,1,"""2""",26940,27120
4123,118002,106002,60,25620,1,"""2""",27120,27180
4123,106002,118102,60,25620,1,"""2""",27180,27240
4123,118102,101004,120,25620,1,"""2""",27240,27360
4123,101004,502802,120,25620,1,"""2""",27360,27480
4123,502802,500904,120,25620,1,"""2""",27480,27600
4123,500904,501602,60,25620,1,"""2""",27600,27660
4123,501602,501802,60,25620,1,"""2""",27660,27720
4123,501802,502000,60,25620,1,"""2""",27720,27780
4123,502000,501704,120,25620,1,"""2""",27780,27900
4123,501704,502502,60,25620,1,"""2""",27900,27960
4123,502502,501500,60,25620,1,"""2""",27960,28020
4123,501500,500500,60,25620,1,"""2""",28020,28080
4123,500500,500300,60,25620,1,"""2""",28080,28140
4123,500300,500200,60,25620,1,"""2""",28140,28200
4123,500200,502300,180,25620,1,"""2""",28200,28380
4123,204600,200600,0,26220,1,"""2""",26220,26220
4123,200600,204200,60,26220,1,"""2""",26220,26280
4123,204200,204500,60,26220,1,"""2""",26280,26340
4123,204500,200500,120,26220,1,"""2""",26340,26460
4123,200500,205603,60,26220,1,"""2""",26460,26520
4123,205603,205503,60,26220,1,"""2""",26520,26580
4123,205503,207802,60,26220,1,"""2""",26580,26640
4123,207802,203900,180,26220,1,"""2""",26640,26820
4123,203900,201503,60,26220,1,"""2""",26820,26880
4123,201503,208103,120,26220,1,"""2""",26880,27000
4123,208103,119004,120,26220,1,"""2""",27000,27120
4123,119004,117002,60,26220,1,"""2""",27120,27180
4123,117002,112105,180,26220,1,"""2""",27180,27360
4123,112105,103003,180,26220,1,"""2""",27360,27540
4123,103003,118002,180,26220,1,"""2""",27540,27720
4123,118002,106002,60,26220,1,"""2""",27720,27780
4123,106002,118102,60,26220,1,"""2""",27780,27840
4123,118102,101004,120,26220,1,"""2""",27840,27960
4123,101004,502802,120,26220,1,"""2""",27960,28080
4123,502802,500904,120,26220,1,"""2""",28080,28200
4123,500904,501602,60,26220,1,"""2""",28200,28260
4123,501602,501802,60,26220,1,"""2""",28260,28320
4123,501802,502000,60,26220,1,"""2""",28320,28380
4123,502000,501704,120,26220,1,"""2""",28380,28500
4123,501704,502502,60,26220,1,"""2""",28500,28560
4123,502502,501500,60,26220,1,"""2""",28560,28620
4123,501500,500500,60,26220,1,"""2""",28620,28680
4123,500500,500300,60,26220,1,"""2""",28680,28740
4123,500300,500200,60,26220,1,"""2""",28740,28800
4123,500200,502300,180,26220,1,"""2""",28800,28980
4123,204600,200600,0,26820,1,"""2""",26820,26820
4123,200600,204200,60,26820,1,"""2""",26820,26880
4123,204200,204500,60,26820,1,"""2""",26880,26940
4123,204500,200500,120,26820,1,"""2""",26940,27060
4123,200500,205603,60,26820,1,"""2""",27060,27120
4123,205603,205503,60,26820,1,"""2""",27120,27180
4123,205503,207802,60,26820,1,"""2""",27180,27240
4123,207802,203900,180,26820,1,"""2""",27240,27420
4123,203900,201503,60,26820,1,"""2""",27420,27480
4123,201503,208103,120,26820,1,"""2""",27480,27600
4123,208103,119004,120,26820,1,"""2""",27600,27720
4123,119004,117002,60,26820,1,"""2""",27720,27780
4123,117002,112105,180,26820,1,"""2""",27780,27960
4123,112105,103003,180,26820,1,"""2""",27960,28140
4123,103003,118002,180,26820,1,"""2""",28140,28320
4123,118002,106002,60,26820,1,"""2""",28320,28380
4123,106002,118102,60,26820,1,"""2""",28380,28440
4123,118102,101004,120,26820,1,"""2""",28440,28560
4123,101004,502802,120,26820,1,"""2""",28560,28680
4123,502802,500904,120,26820,1,"""2""",28680,28800
4123,500904,501602,60,26820,1,"""2""",28800,28860
4123,501602,501802,60,26820,1,"""2""",28860,28920
4123,501802,502000,60,26820,1,"""2""",28920,28980
4123,502000,501704,120,26820,1,"""2""",28980,29100
4123,501704,502502,60,26820,1,"""2""",29100,29160
4123,502502,501500,60,26820,1,"""2""",29160,29220
4123,501500,500500,60,26820,1,"""2""",29220,29280
4123,500500,500300,60,26820,1,"""2""",29280,29340
4123,500300,500200,60,26820,1,"""2""",29340,29400
4123,500200,502300,180,26820,1,"""2""",29400,29580
4123,204600,200600,0,27420,1,"""2""",27420,27420
4123,200600,204200,60,27420,1,"""2""",27420,27480
4123,204200,204500,60,27420,1,"""2""",27480,27540
4123,204500,200500,120,27420,1,"""2""",27540,27660
4123,200500,205603,60,27420,1,"""2""",27660,27720
4123,205603,205503,60,27420,1,"""2""",27720,27780
4123,205503,207802,60,27420,1,"""2""",27780,27840
4123,207802,203900,180,27420,1,"""2""",27840,28020
4123,203900,201503,60,27420,1,"""2""",28020,28080
4123,201503,208103,120,27420,1,"""2""",28080,28200
4123,208103,119004,120,27420,1,"""2""",28200,28320
4123,119004,117002,60,27420,1,"""2""",28320,28380
4123,117002,112105,180,27420,1,"""2""",28380,28560
4123,112105,103003,180,27420,1,"""2""",28560,28740
4123,103003,118002,180,27420,1,"""2""",28740,28920
4123,118002,106002,60,27420,1,"""2""",28920,28980
4123,106002,118102,60,27420,1,"""2""",28980,29040
4123,118102,101004,120,27420,1,"""2""",29040,29160
4123,101004,502802,120,27420,1,"""2""",29160,29280
4123,502802,500904,120,27420,1,"""2""",29280,29400
4123,500904,501602,60,27420,1,"""2""",29400,29460
4123,501602,501802,60,27420,1,"""2""",29460,29520
4123,501802,502000,60,27420,1,"""2""",29520,29580
4123,502000,501704,120,27420,1,"""2""",29580,29700
4123,501704,502502,60,27420,1,"""2""",29700,29760
4123,502502,501500,60,27420,1,"""2""",29760,29820
4123,501500,500500,60,27420,1,"""2""",29820,29880
4123,500500,500300,60,27420,1,"""2""",29880,29940
4123,500300,500200,60,27420,1,"""2""",29940,30000
4123,500200,502300,180,27420,1,"""2""",30000,30180
4123,204600,200600,0,28020,1,"""2""",28020,28020
4123,200600,204200,60,28020,1,"""2""",28020,28080
4123,204200,204500,60,28020,1,"""2""",28080,28140
4123,204500,200500,120,28020,1,"""2""",28140,28260
4123,200500,205603,60,28020,1,"""2""",28260,28320
4123,205603,205503,60,28020,1,"""2""",28320,28380
4123,205503,207802,60,28020,1,"""2""",28380,28440
4123,207802,203900,180,28020,1,"""2""",28440,28620
4123,203900,201503,60,28020,1,"""2""",28620,28680
4123,201503,208103,120,28020,1,"""2""",28680,28800
4123,208103,119004,120,28020,1,"""2""",28800,28920
4123,119004,117002,60,28020,1,"""2""",28920,28980
4123,117002,112105,180,28020,1,"""2""",28980,29160
4123,112105,103003,180,28020,1,"""2""",29160,29340
4123,103003,118002,180,28020,1,"""2""",29340,29520
4123,118002,106002,60,28020,1,"""2""",29520,29580
4123,106002,118102,60,28020,1,"""2""",29580,29640
4123,118102,101004,120,28020,1,"""2""",29640,29760
4123,101004,502802,120,28020,1,"""2""",29760,29880
4123,502802,500904,120,28020,1,"""2""",29880,30000
4123,500904,501602,60,28020,1,"""2""",30000,30060
4123,501602,501802,60,28020,1,"""2""",30060,30120
4123,501802,502000,60,28020,1,"""2""",30120,30180
4123,502000,501704,120,28020,1,"""2""",30180,30300
4123,501704,502502,60,28020,1,"""2""",30300,30360
4123,502502,501500,60,28020,1,"""2""",30360,30420
4123,501500,500500,60,28020,1,"""2""",30420,30480
4123,500500,500300,60,28020,1,"""2""",30480,30540
4123,500300,500200,60,28020,1,"""2""",30540,30600
4123,500200,502300,180,28020,1,"""2""",30600,30780
4123,204600,200600,0,28620,1,"""2""",28620,28620
4123,200600,204200,60,28620,1,"""2""",28620,28680
4123,204200,204500,60,28620,1,"""2""",28680,28740
4123,204500,200500,120,28620,1,"""2""",28740,28860
4123,200500,205603,60,28620,1,"""2""",28860,28920
4123,205603,205503,60,28620,1,"""2""",28920,28980
4123,205503,207802,60,28620,1,"""2""",28980,29040
4123,207802,203900,180,28620,1,"""2""",29040,29220
4123,203900,201503,60,28620,1,"""2""",29220,29280
4123,201503,208103,120,28620,1,"""2""",29280,29400
4123,208103,119004,120,28620,1,"""2""",29400,29520
4123,119004,117002,60,28620,1,"""2""",29520,29580
4123,117002,112105,180,28620,1,"""2""",29580,29760
4123,112105,103003,180,28620,1,"""2""",29760,29940
4123,103003,118002,180,28620,1,"""2""",29940,30120
4123,118002,106002,60,28620,1,"""2""",30120,30180
4123,106002,118102,60,28620,1,"""2""",30180,30240
4123,118102,101004,120,28620,1,"""2""",30240,30360
4123,101004,502802,120,28620,1,"""2""",30360,30480
4123,502802,500904,120,28620,1,"""2""",30480,30600
4123,500904,501602,60,28620,1,"""2""",30600,30660
4123,501602,501802,60,28620,1,"""2""",30660,30720
4123,501802,502000,60,28620,1,"""2""",30720,30780
4123,502000,501704,120,28620,1,"""2""",30780,30900
4123,501704,502502,60,28620,1,"""2""",30900,30960
4123,502502,501500,60,28620,1,"""2""",30960,31020
4123,501500,500500,60,28620,1,"""2""",31020,31080
4123,500500,500300,60,28620,1,"""2""",31080,31140
4123,500300,500200,60,28620,1,"""2""",31140,31200
4123,500200,502300,180,28620,1,"""2""",31200,31380
4123,204600,200600,0,29220,1,"""2""",29220,29220
4123,200600,204200,60,29220,1,"""2""",29220,29280
4123,204200,204500,60,29220,1,"""2""",29280,29340
4123,204500,200500,120,29220,1,"""2""",29340,29460
4123,200500,205603,60,29220,1,"""2""",29460,29520
4123,205603,205503,60,29220,1,"""2""",29520,29580
4123,205503,207802,60,29220,1,"""2""",29580,29640
4123,207802,203900,180,29220,1,"""2""",29640,29820
4123,203900,201503,60,29220,1,"""2""",29820,29880
4123,201503,208103,120,29220,1,"""2""",29880,30000
4123,208103,119004,120,29220,1,"""2""",30000,30120
4123,119004,117002,60,29220,1,"""2""",30120,30180
4123,117002,112105,180,29220,1,"""2""",30180,30360
4123,112105,103003,180,29220,1,"""2""",30360,30540
4123,103003,118002,180,29220,1,"""2""",30540,30720
4123,118002,106002,60,29220,1,"""2""",30720,30780
4123,106002,118102,60,29220,1,"""2""",30780,30840
4123,118102,101004,120,29220,1,"""2""",30840,30960
4123,101004,502802,120,29220,1,"""2""",30960,31080
4123,502802,500904,120,29220,1,"""2""",31080,31200
4123,500904,501602,60,29220,1,"""2""",31200,31260
4123,501602,501802,60,29220,1,"""2""",31260,31320
4123,501802,502000,60,29220,1,"""2""",31320,31380
4123,502000,501704,120,29220,1,"""2""",31380,31500
4123,501704,502502,60,29220,1,"""2""",31500,31560
4123,502502,501500,60,29220,1,"""2""",31560,31620
4123,501500,500500,60,29220,1,"""2""",31620,31680
4123,500500,500300,60,29220,1,"""2""",31680,31740
4123,500300,500200,60,29220,1,"""2""",31740,31800
4123,500200,502300,180,29220,1,"""2""",31800,31980
4123,204600,200600,0,29820,1,"""2""",29820,29820
4123,200600,204200,60,29820,1,"""2""",29820,29880
4123,204200,204500,60,29820,1,"""2""",29880,29940
4123,204500,200500,120,29820,1,"""2""",29940,30060
4123,200500,205603,60,29820,1,"""2""",30060,30120
4123,205603,205503,60,29820,1,"""2""",30120,30180
4123,205503,207802,60,29820,1,"""2""",30180,30240
4123,207802,203900,180,29820,1,"""2""",30240,30420
4123,203900,201503,60,29820,1,"""2""",30420,30480
4123,201503,208103,120,29820,1,"""2""",30480,30600
4123,208103,119004,120,29820,1,"""2""",30600,30720
4123,119004,117002,60,29820,1,"""2""",30720,30780
4123,117002,112105,180,29820,1,"""2""",30780,30960
4123,112105,103003,180,29820,1,"""2""",30960,31140
4123,103003,118002,180,29820,1,"""2""",31140,31320
4123,118002,106002,60,29820,1,"""2""",31320,31380
4123,106002,118102,60,29820,1,"""2""",31380,31440
4123,118102,101004,120,29820,1,"""2""",31440,31560
4123,101004,502802,120,29820,1,"""2""",31560,31680
4123,502802,500904,120,29820,1,"""2""",31680,31800
4123,500904,501602,60,29820,1,"""2""",31800,31860
4123,501602,501802,60,29820,1,"""2""",31860,31920
4123,501802,502000,60,29820,1,"""2""",31920,31980
4123,502000,501704,120,29820,1,"""2""",31980,32100
4123,501704,502502,60,29820,1,"""2""",32100,32160
4123,502502,501500,60,29820,1,"""2""",32160,32220
4123,501500,500500,60,29820,1,"""2""",32220,32280
4123,500500,500300,60,29820,1,"""2""",32280,32340
4123,500300,500200,60,29820,1,"""2""",32340,32400
4123,500200,502300,180,29820,1,"""2""",32400,32580
4123,204600,200600,0,30420,1,"""2""",30420,30420
4123,200600,204200,60,30420,1,"""2""",30420,30480
4123,204200,204500,60,30420,1,"""2""",30480,30540
4123,204500,200500,120,30420,1,"""2""",30540,30660
4123,200500,205603,60,30420,1,"""2""",30660,30720
4123,205603,205503,60,30420,1,"""2""",30720,30780
4123,205503,207802,60,30420,1,"""2""",30780,30840
4123,207802,203900,180,30420,1,"""2""",30840,31020
4123,203900,201503,60,30420,1,"""2""",31020,31080
4123,201503,208103,120,30420,1,"""2""",31080,31200
4123,208103,119004,120,30420,1,"""2""",31200,31320
4123,119004,117002,60,30420,1,"""2""",31320,31380
4123,117002,112105,180,30420,1,"""2""",31380,31560
4123,112105,103003,180,30420,1,"""2""",31560,31740
4123,103003,118002,180,30420,1,"""2""",31740,31920
4123,118002,106002,60,30420,1,"""2""",31920,31980
4123,106002,118102,60,30420,1,"""2""",31980,32040
4123,118102,101004,120,30420,1,"""2""",32040,32160
4123,101004,502802,120,30420,1,"""2""",32160,32280
4123,502802,500904,120,30420,1,"""2""",32280,32400
4123,500904,501602,60,30420,1,"""2""",32400,32460
4123,501602,501802,60,30420,1,"""2""",32460,32520
4123,501802,502000,60,30420,1,"""2""",32520,32580
4123,502000,501704,120,30420,1,"""2""",32580,32700
4123,501704,502502,60,30420,1,"""2""",32700,32760
4123,502502,501500,60,30420,1,"""2""",32760,32820
4123,501500,500500,60,30420,1,"""2""",32820,32880
4123,500500,500300,60,30420,1,"""2""",32880,32940
4123,500300,500200,60,30420,1,"""2""",32940,33000
4123,500200,502300,180,30420,1,"""2""",33000,33180
4123,204600,200600,0,31020,1,"""2""",31020,31020
4123,200600,204200,60,31020,1,"""2""",31020,31080
4123,204200,204500,60,31020,1,"""2""",31080,31140
4123,204500,200500,120,31020,1,"""2""",31140,31260
4123,200500,205603,60,31020,1,"""2""",31260,31320
4123,205603,205503,60,31020,1,"""2""",31320,31380
4123,205503,207802,60,31020,1,"""2""",31380,31440
4123,207802,203900,180,31020,1,"""2""",31440,31620
4123,203900,201503,60,31020,1,"""2""",31620,31680
4123,201503,208103,120,31020,1,"""2""",31680,31800
4123,208103,119004,120,31020,1,"""2""",31800,31920
4123,119004,117002,60,31020,1,"""2""",31920,31980
4123,117002,112105,180,31020,1,"""2""",31980,32160
4123,112105,103003,180,31020,1,"""2""",32160,32340
4123,103003,118002,180,31020,1,"""2""",32340,32520
4123,118002,106002,60,31020,1,"""2""",32520,32580
4123,106002,118102,60,31020,1,"""2""",32580,32640
4123,118102,101004,120,31020,1,"""2""",32640,32760
4123,101004,502802,120,31020,1,"""2""",32760,32880
4123,502802,500904,120,31020,1,"""2""",32880,33000
4123,500904,501602,60,31020,1,"""2""",33000,33060
4123,501602,501802,60,31020,1,"""2""",33060,33120
4123,501802,502000,60,31020,1,"""2""",33120,33180
4123,502000,501704,120,31020,1,"""2""",33180,33300
4123,501704,502502,60,31020,1,"""2""",33300,33360
4123,502502,501500,60,31020,1,"""2""",33360,33420
4123,501500,500500,60,31020,1,"""2""",33420,33480
4123,500500,500300,60,31020,1,"""2""",33480,33540
4123,500300,500200,60,31020,1,"""2""",33540,33600
4123,500200,502300,180,31020,1,"""2""",33600,33780
4123,204600,200600,0,31620,1,"""2""",31620,31620
4123,200600,204200,60,31620,1,"""2""",31620,31680
4123,204200,204500,60,31620,1,"""2""",31680,31740
4123,204500,200500,120,31620,1,"""2""",31740,31860
4123,200500,205603,60,31620,1,"""2""",31860,31920
4123,205603,205503,60,31620,1,"""2""",31920,31980
4123,205503,207802,60,31620,1,"""2""",31980,32040
4123,207802,203900,180,31620,1,"""2""",32040,32220
4123,203900,201503,60,31620,1,"""2""",32220,32280
4123,201503,208103,120,31620,1,"""2""",32280,32400
4123,208103,119004,120,31620,1,"""2""",32400,32520
4123,119004,117002,60,31620,1,"""2""",32520,32580
4123,117002,112105,180,31620,1,"""2""",32580,32760
4123,112105,103003,180,31620,1,"""2""",32760,32940
4123,103003,118002,180,31620,1,"""2""",32940,33120
4123,118002,106002,60,31620,1,"""2""",33120,33180
4123,106002,118102,60,31620,1,"""2""",33180,33240
4123,118102,101004,120,31620,1,"""2""",33240,33360
4123,101004,502802,120,31620,1,"""2""",33360,33480
4123,502802,500904,120,31620,1,"""2""",33480,33600
4123,500904,501602,60,31620,1,"""2""",33600,33660
4123,501602,501802,60,31620,1,"""2""",33660,33720
4123,501802,502000,60,31620,1,"""2""",33720,33780
4123,502000,501704,120,31620,1,"""2""",33780,33900
4123,501704,502502,60,31620,1,"""2""",33900,33960
4123,502502,501500,60,31620,1,"""2""",33960,34020
4123,501500,500500,60,31620,1,"""2""",34020,34080
4123,500500,500300,60,31620,1,"""2""",34080,34140
4123,500300,500200,60,31620,1,"""2""",34140,34200
4123,500200,502300,180,31620,1,"""2""",34200,34380
4123,204600,200600,0,32220,1,"""2""",32220,32220
4123,200600,204200,60,32220,1,"""2""",32220,32280
4123,204200,204500,60,32220,1,"""2""",32280,32340
4123,204500,200500,120,32220,1,"""2""",32340,32460
4123,200500,205603,60,32220,1,"""2""",32460,32520
4123,205603,205503,60,32220,1,"""2""",32520,32580
4123,205503,207802,60,32220,1,"""2""",32580,32640
4123,207802,203900,180,32220,1,"""2""",32640,32820
4123,203900,201503,60,32220,1,"""2""",32820,32880
4123,201503,208103,120,32220,1,"""2""",32880,33000
4123,208103,119004,120,32220,1,"""2""",33000,33120
4123,119004,117002,60,32220,1,"""2""",33120,33180
4123,117002,112105,180,32220,1,"""2""",33180,33360
4123,112105,103003,180,32220,1,"""2""",33360,33540
4123,103003,118002,180,32220,1,"""2""",33540,33720
4123,118002,106002,60,32220,1,"""2""",33720,33780
4123,106002,118102,60,32220,1,"""2""",33780,33840
4123,118102,101004,120,32220,1,"""2""",33840,33960
4123,101004,502802,120,32220,1,"""2""",33960,34080
4123,502802,500904,120,32220,1,"""2""",34080,34200
4123,500904,501602,60,32220,1,"""2""",34200,34260
4123,501602,501802,60,32220,1,"""2""",34260,34320
4123,501802,502000,60,32220,1,"""2""",34320,34380
4123,502000,501704,120,32220,1,"""2""",34380,34500
4123,501704,502502,60,32220,1,"""2""",34500,34560
4123,502502,501500,60,32220,1,"""2""",34560,34620
4123,501500,500500,60,32220,1,"""2""",34620,34680
4123,500500,500300,60,32220,1,"""2""",34680,34740
4123,500300,500200,60,32220,1,"""2""",34740,34800
4123,500200,502300,180,32220,1,"""2""",34800,34980
4123,204600,200600,0,32820,1,"""2""",32820,32820
4123,200600,204200,60,32820,1,"""2""",32820,32880
4123,204200,204500,60,32820,1,"""2""",32880,32940
4123,204500,200500,120,32820,1,"""2""",32940,33060
4123,200500,205603,60,32820,1,"""2""",33060,33120
4123,205603,205503,60,32820,1,"""2""",33120,33180
4123,205503,207802,60,32820,1,"""2""",33180,33240
4123,207802,203900,180,32820,1,"""2""",33240,33420
4123,203900,201503,60,32820,1,"""2""",33420,33480
4123,201503,208103,120,32820,1,"""2""",33480,33600
4123,208103,119004,120,32820,1,"""2""",33600,33720
4123,119004,117002,60,32820,1,"""2""",33720,33780
4123,117002,112105,180,32820,1,"""2""",33780,33960
4123,112105,103003,180,32820,1,"""2""",33960,34140
4123,103003,118002,180,32820,1,"""2""",34140,34320
4123,118002,106002,60,32820,1,"""2""",34320,34380
4123,106002,118102,60,32820,1,"""2""",34380,34440
4123,118102,101004,120,32820,1,"""2""",34440,34560
4123,101004,502802,120,32820,1,"""2""",34560,34680
4123,502802,500904,120,32820,1,"""2""",34680,34800
4123,500904,501602,60,32820,1,"""2""",34800,34860
4123,501602,501802,60,32820,1,"""2""",34860,34920
4123,501802,502000,60,32820,1,"""2""",34920,34980
4123,502000,501704,120,32820,1,"""2""",34980,35100
4123,501704,502502,60,32820,1,"""2""",35100,35160
4123,502502,501500,60,32820,1,"""2""",35160,35220
4123,501500,500500,60,32820,1,"""2""",35220,35280
4123,500500,500300,60,32820,1,"""2""",35280,35340
4123,500300,500200,60,32820,1,"""2""",35340,35400
4123,500200,502300,180,32820,1,"""2""",35400,35580
4123,204600,200600,0,33420,1,"""2""",33420,33420
4123,200600,204200,60,33420,1,"""2""",33420,33480
4123,204200,204500,60,33420,1,"""2""",33480,33540
4123,204500,200500,120,33420,1,"""2""",33540,33660
4123,200500,205603,60,33420,1,"""2""",33660,33720
4123,205603,205503,60,33420,1,"""2""",33720,33780
4123,205503,207802,60,33420,1,"""2""",33780,33840
4123,207802,203900,180,33420,1,"""2""",33840,34020
4123,203900,201503,60,33420,1,"""2""",34020,34080
4123,201503,208103,120,33420,1,"""2""",34080,34200
4123,208103,119004,120,33420,1,"""2""",34200,34320
4123,119004,117002,60,33420,1,"""2""",34320,34380
4123,117002,112105,180,33420,1,"""2""",34380,34560
4123,112105,103003,180,33420,1,"""2""",34560,34740
4123,103003,118002,180,33420,1,"""2""",34740,34920
4123,118002,106002,60,33420,1,"""2""",34920,34980
4123,106002,118102,60,33420,1,"""2""",34980,35040
4123,118102,101004,120,33420,1,"""2""",35040,35160
4123,101004,502802,120,33420,1,"""2""",35160,35280
4123,502802,500904,120,33420,1,"""2""",35280,35400
4123,500904,501602,60,33420,1,"""2""",35400,35460
4123,501602,501802,60,33420,1,"""2""",35460,35520
4123,501802,502000,60,33420,1,"""2""",35520,35580
4123,502000,501704,120,33420,1,"""2""",35580,35700
4123,501704,502502,60,33420,1,"""2""",35700,35760
4123,502502,501500,60,33420,1,"""2""",35760,35820
4123,501500,500500,60,33420,1,"""2""",35820,35880
4123,500500,500300,60,33420,1,"""2""",35880,35940
4123,500300,500200,60,33420,1,"""2""",35940,36000
4123,500200,502300,180,33420,1,"""2""",36000,36180
4123,204600,200600,0,34020,1,"""2""",34020,34020
4123,200600,204200,60,34020,1,"""2""",34020,34080
4123,204200,204500,60,34020,1,"""2""",34080,34140
4123,204500,200500,120,34020,1,"""2""",34140,34260
4123,200500,205603,60,34020,1,"""2""",34260,34320
4123,205603,205503,60,34020,1,"""2""",34320,34380
4123,205503,207802,60,34020,1,"""2""",34380,34440
4123,207802,203900,180,34020,1,"""2""",34440,34620
4123,203900,201503,60,34020,1,"""2""",34620,34680
4123,201503,208103,120,34020,1,"""2""",34680,34800
4123,208103,119004,120,34020,1,"""2""",34800,34920
4123,119004,117002,60,34020,1,"""2""",34920,34980
4123,117002,112105,180,34020,1,"""2""",34980,35160
4123,112105,103003,180,34020,1,"""2""",35160,35340
4123,103003,118002,180,34020,1,"""2""",35340,35520
4123,118002,106002,60,34020,1,"""2""",35520,35580
4123,106002,118102,60,34020,1,"""2""",35580,35640
4123,118102,101004,120,34020,1,"""2""",35640,35760
4123,101004,502802,120,34020,1,"""2""",35760,35880
4123,502802,500904,120,34020,1,"""2""",35880,36000
4123,500904,501602,60,34020,1,"""2""",36000,36060
4123,501602,501802,60,34020,1,"""2""",36060,36120
4123,501802,502000,60,34020,1,"""2""",36120,36180
4123,502000,501704,120,34020,1,"""2""",36180,36300
4123,501704,502502,60,34020,1,"""2""",36300,36360
4123,502502,501500,60,34020,1,"""2""",36360,36420
4123,501500,500500,60,34020,1,"""2""",36420,36480
4123,500500,500300,60,34020,1,"""2""",36480,36540
4123,500300,500200,60,34020,1,"""2""",36540,36600
4123,500200,502300,180,34020,1,"""2""",36600,36780
4123,204600,200600,0,34620,1,"""2""",34620,34620
4123,200600,204200,60,34620,1,"""2""",34620,34680
4123,204200,204500,60,34620,1,"""2""",34680,34740
4123,204500,200500,120,34620,1,"""2""",34740,34860
4123,200500,205603,60,34620,1,"""2""",34860,34920
4123,205603,205503,60,34620,1,"""2""",34920,34980
4123,205503,207802,60,34620,1,"""2""",34980,35040
4123,207802,203900,180,34620,1,"""2""",35040,35220
4123,203900,201503,60,34620,1,"""2""",35220,35280
4123,201503,208103,120,34620,1,"""2""",35280,35400
4123,208103,119004,120,34620,1,"""2""",35400,35520
4123,119004,117002,60,34620,1,"""2""",35520,35580
4123,117002,112105,180,34620,1,"""2""",35580,35760
4123,112105,103003,180,34620,1,"""2""",35760,35940
4123,103003,118002,180,34620,1,"""2""",35940,36120
4123,118002,106002,60,34620,1,"""2""",36120,36180
4123,106002,118102,60,34620,1,"""2""",36180,36240
4123,118102,101004,120,34620,1,"""2""",36240,36360
4123,101004,502802,120,34620,1,"""2""",36360,36480
4123,502802,500904,120,34620,1,"""2""",36480,36600
4123,500904,501602,60,34620,1,"""2""",36600,36660
4123,501602,501802,60,34620,1,"""2""",36660,36720
4123,501802,502000,60,34620,1,"""2""",36720,36780
4123,502000,501704,120,34620,1,"""2""",36780,36900
4123,501704,502502,60,34620,1,"""2""",36900,36960
4123,502502,501500,60,34620,1,"""2""",36960,37020
4123,501500,500500,60,34620,1,"""2""",37020,37080
4123,500500,500300,60,34620,1,"""2""",37080,37140
4123,500300,500200,60,34620,1,"""2""",37140,37200
4123,500200,502300,180,34620,1,"""2""",37200,37380
4123,204600,200600,0,35220,1,"""2""",35220,35220
4123,200600,204200,60,35220,1,"""2""",35220,35280
4123,204200,204500,60,35220,1,"""2""",35280,35340
4123,204500,200500,120,35220,1,"""2""",35340,35460
4123,200500,205603,60,35220,1,"""2""",35460,35520
4123,205603,205503,60,35220,1,"""2""",35520,35580
4123,205503,207802,60,35220,1,"""2""",35580,35640
4123,207802,203900,180,35220,1,"""2""",35640,35820
4123,203900,201503,60,35220,1,"""2""",35820,35880
4123,201503,208103,120,35220,1,"""2""",35880,36000
4123,208103,119004,120,35220,1,"""2""",36000,36120
4123,119004,117002,60,35220,1,"""2""",36120,36180
4123,117002,112105,180,35220,1,"""2""",36180,36360
4123,112105,103003,180,35220,1,"""2""",36360,36540
4123,103003,118002,180,35220,1,"""2""",36540,36720
4123,118002,106002,60,35220,1,"""2""",36720,36780
4123,106002,118102,60,35220,1,"""2""",36780,36840
4123,118102,101004,120,35220,1,"""2""",36840,36960
4123,101004,502802,120,35220,1,"""2""",36960,37080
4123,502802,500904,120,35220,1,"""2""",37080,37200
4123,500904,501602,60,35220,1,"""2""",37200,37260
4123,501602,501802,60,35220,1,"""2""",37260,37320
4123,501802,502000,60,35220,1,"""2""",37320,37380
4123,502000,501704,120,35220,1,"""2""",37380,37500
4123,501704,502502,60,35220,1,"""2""",37500,37560
4123,502502,501500,60,35220,1,"""2""",37560,37620
4123,501500,500500,60,35220,1,"""2""",37620,37680
4123,500500,500300,60,35220,1,"""2""",37680,37740
4123,500300,500200,60,35220,1,"""2""",37740,37800
4123,500200,502300,180,35220,1,"""2""",37800,37980
4123,204600,200600,0,35820,1,"""2""",35820,35820
4123,200600,204200,60,35820,1,"""2""",35820,35880
4123,204200,204500,60,35820,1,"""2""",35880,35940
4123,204500,200500,120,35820,1,"""2""",35940,36060
4123,200500,205603,60,35820,1,"""2""",36060,36120
4123,205603,205503,60,35820,1,"""2""",36120,36180
4123,205503,207802,60,35820,1,"""2""",36180,36240
4123,207802,203900,180,35820,1,"""2""",36240,36420
4123,203900,201503,60,35820,1,"""2""",36420,36480
4123,201503,208103,120,35820,1,"""2""",36480,36600
4123,208103,119004,120,35820,1,"""2""",36600,36720
4123,119004,117002,60,35820,1,"""2""",36720,36780
4123,117002,112105,180,35820,1,"""2""",36780,36960
4123,112105,103003,180,35820,1,"""2""",36960,37140
4123,103003,118002,180,35820,1,"""2""",37140,37320
4123,118002,106002,60,35820,1,"""2""",37320,37380
4123,106002,118102,60,35820,1,"""2""",37380,37440
4123,118102,101004,120,35820,1,"""2""",37440,37560
4123,101004,502802,120,35820,1,"""2""",37560,37680
4123,502802,500904,120,35820,1,"""2""",37680,37800
4123,500904,501602,60,35820,1,"""2""",37800,37860
4123,501602,501802,60,35820,1,"""2""",37860,37920
4123,501802,502000,60,35820,1,"""2""",37920,37980
4123,502000,501704,120,35820,1,"""2""",37980,38100
4123,501704,502502,60,35820,1,"""2""",38100,38160
4123,502502,501500,60,35820,1,"""2""",38160,38220
4123,501500,500500,60,35820,1,"""2""",38220,38280
4123,500500,500300,60,35820,1,"""2""",38280,38340
4123,500300,500200,60,35820,1,"""2""",38340,38400
4123,500200,502300,180,35820,1,"""2""",38400,38580
4123,204600,200600,0,36420,1,"""2""",36420,36420
4123,200600,204200,60,36420,1,"""2""",36420,36480
4123,204200,204500,60,36420,1,"""2""",36480,36540
4123,204500,200500,120,36420,1,"""2""",36540,36660
4123,200500,205603,60,36420,1,"""2""",36660,36720
4123,205603,205503,60,36420,1,"""2""",36720,36780
4123,205503,207802,60,36420,1,"""2""",36780,36840
4123,207802,203900,180,36420,1,"""2""",36840,37020
4123,203900,201503,60,36420,1,"""2""",37020,37080
4123,201503,208103,120,36420,1,"""2""",37080,37200
4123,208103,119004,120,36420,1,"""2""",37200,37320
4123,119004,117002,60,36420,1,"""2""",37320,37380
4123,117002,112105,180,36420,1,"""2""",37380,37560
4123,112105,103003,180,36420,1,"""2""",37560,37740
4123,103003,118002,180,36420,1,"""2""",37740,37920
4123,118002,106002,60,36420,1,"""2""",37920,37980
4123,106002,118102,60,36420,1,"""2""",37980,38040
4123,118102,101004,120,36420,1,"""2""",38040,38160
4123,101004,502802,120,36420,1,"""2""",38160,38280
4123,502802,500904,120,36420,1,"""2""",38280,38400
4123,500904,501602,60,36420,1,"""2""",38400,38460
4123,501602,501802,60,36420,1,"""2""",38460,38520
4123,501802,502000,60,36420,1,"""2""",38520,38580
4123,502000,501704,120,36420,1,"""2""",38580,38700
4123,501704,502502,60,36420,1,"""2""",38700,38760
4123,502502,501500,60,36420,1,"""2""",38760,38820
4123,501500,500500,60,36420,1,"""2""",38820,38880
4123,500500,500300,60,36420,1,"""2""",38880,38940
4123,500300,500200,60,36420,1,"""2""",38940,39000
4123,500200,502300,180,36420,1,"""2""",39000,39180
4123,204600,200600,0,37020,1,"""2""",37020,37020
4123,200600,204200,60,37020,1,"""2""",37020,37080
4123,204200,204500,60,37020,1,"""2""",37080,37140
4123,204500,200500,120,37020,1,"""2""",37140,37260
4123,200500,205603,60,37020,1,"""2""",37260,37320
4123,205603,205503,60,37020,1,"""2""",37320,37380
4123,205503,207802,60,37020,1,"""2""",37380,37440
4123,207802,203900,180,37020,1,"""2""",37440,37620
4123,203900,201503,60,37020,1,"""2""",37620,37680
4123,201503,208103,120,37020,1,"""2""",37680,37800
4123,208103,119004,120,37020,1,"""2""",37800,37920
4123,119004,117002,60,37020,1,"""2""",37920,37980
4123,117002,112105,180,37020,1,"""2""",37980,38160
4123,112105,103003,180,37020,1,"""2""",38160,38340
4123,103003,118002,180,37020,1,"""2""",38340,38520
4123,118002,106002,60,37020,1,"""2""",38520,38580
4123,106002,118102,60,37020,1,"""2""",38580,38640
4123,118102,101004,120,37020,1,"""2""",38640,38760
4123,101004,502802,120,37020,1,"""2""",38760,38880
4123,502802,500904,120,37020,1,"""2""",38880,39000
4123,500904,501602,60,37020,1,"""2""",39000,39060
4123,501602,501802,60,37020,1,"""2""",39060,39120
4123,501802,502000,60,37020,1,"""2""",39120,39180
4123,502000,501704,120,37020,1,"""2""",39180,39300
4123,501704,502502,60,37020,1,"""2""",39300,39360
4123,502502,501500,60,37020,1,"""2""",39360,39420
4123,501500,500500,60,37020,1,"""2""",39420,39480
4123,500500,500300,60,37020,1,"""2""",39480,39540
4123,500300,500200,60,37020,1,"""2""",39540,39600
4123,500200,502300,180,37020,1,"""2""",39600,39780
4123,204600,200600,0,37620,1,"""2""",37620,37620
4123,200600,204200,60,37620,1,"""2""",37620,37680
4123,204200,204500,60,37620,1,"""2""",37680,37740
4123,204500,200500,120,37620,1,"""2""",37740,37860
4123,200500,205603,60,37620,1,"""2""",37860,37920
4123,205603,205503,60,37620,1,"""2""",37920,37980
4123,205503,207802,60,37620,1,"""2""",37980,38040
4123,207802,203900,180,37620,1,"""2""",38040,38220
4123,203900,201503,60,37620,1,"""2""",38220,38280
4123,201503,208103,120,37620,1,"""2""",38280,38400
4123,208103,119004,120,37620,1,"""2""",38400,38520
4123,119004,117002,60,37620,1,"""2""",38520,38580
4123,117002,112105,180,37620,1,"""2""",38580,38760
4123,112105,103003,180,37620,1,"""2""",38760,38940
4123,103003,118002,180,37620,1,"""2""",38940,39120
4123,118002,106002,60,37620,1,"""2""",39120,39180
4123,106002,118102,60,37620,1,"""2""",39180,39240
4123,118102,101004,120,37620,1,"""2""",39240,39360
4123,101004,502802,120,37620,1,"""2""",39360,39480
4123,502802,500904,120,37620,1,"""2""",39480,39600
4123,500904,501602,60,37620,1,"""2""",39600,39660
4123,501602,501802,60,37620,1,"""2""",39660,39720
4123,501802,502000,60,37620,1,"""2""",39720,39780
4123,502000,501704,120,37620,1,"""2""",39780,39900
4123,501704,502502,60,37620,1,"""2""",39900,39960
4123,502502,501500,60,37620,1,"""2""",39960,40020
4123,501500,500500,60,37620,1,"""2""",40020,40080
4123,500500,500300,60,37620,1,"""2""",40080,40140
4123,500300,500200,60,37620,1,"""2""",40140,40200
4123,500200,502300,180,37620,1,"""2""",40200,40380
4123,204600,200600,0,38220,1,"""2""",38220,38220
4123,200600,204200,60,38220,1,"""2""",38220,38280
4123,204200,204500,60,38220,1,"""2""",38280,38340
4123,204500,200500,120,38220,1,"""2""",38340,38460
4123,200500,205603,60,38220,1,"""2""",38460,38520
4123,205603,205503,60,38220,1,"""2""",38520,38580
4123,205503,207802,60,38220,1,"""2""",38580,38640
4123,207802,203900,180,38220,1,"""2""",38640,38820
4123,203900,201503,60,38220,1,"""2""",38820,38880
4123,201503,208103,120,38220,1,"""2""",38880,39000
4123,208103,119004,120,38220,1,"""2""",39000,39120
4123,119004,117002,60,38220,1,"""2""",39120,39180
4123,117002,112105,180,38220,1,"""2""",39180,39360
4123,112105,103003,180,38220,1,"""2""",39360,39540
4123,103003,118002,180,38220,1,"""2""",39540,39720
4123,118002,106002,60,38220,1,"""2""",39720,39780
4123,106002,118102,60,38220,1,"""2""",39780,39840
4123,118102,101004,120,38220,1,"""2""",39840,39960
4123,101004,502802,120,38220,1,"""2""",39960,40080
4123,502802,500904,120,38220,1,"""2""",40080,40200
4123,500904,501602,60,38220,1,"""2""",40200,40260
4123,501602,501802,60,38220,1,"""2""",40260,40320
4123,501802,502000,60,38220,1,"""2""",40320,40380
4123,502000,501704,120,38220,1,"""2""",40380,40500
4123,501704,502502,60,38220,1,"""2""",40500,40560
4123,502502,501500,60,38220,1,"""2""",40560,40620
4123,501500,500500,60,38220,1,"""2""",40620,40680
4123,500500,500300,60,38220,1,"""2""",40680,40740
4123,500300,500200,60,38220,1,"""2""",40740,40800
4123,500200,502300,180,38220,1,"""2""",40800,40980
4123,204600,200600,0,38820,1,"""2""",38820,38820
4123,200600,204200,60,38820,1,"""2""",38820,38880
4123,204200,204500,60,38820,1,"""2""",38880,38940
4123,204500,200500,120,38820,1,"""2""",38940,39060
4123,200500,205603,60,38820,1,"""2""",39060,39120
4123,205603,205503,60,38820,1,"""2""",39120,39180
4123,205503,207802,60,38820,1,"""2""",39180,39240
4123,207802,203900,180,38820,1,"""2""",39240,39420
4123,203900,201503,60,38820,1,"""2""",39420,39480
4123,201503,208103,120,38820,1,"""2""",39480,39600
4123,208103,119004,120,38820,1,"""2""",39600,39720
4123,119004,117002,60,38820,1,"""2""",39720,39780
4123,117002,112105,180,38820,1,"""2""",39780,39960
4123,112105,103003,180,38820,1,"""2""",39960,40140
4123,103003,118002,180,38820,1,"""2""",40140,40320
4123,118002,106002,60,38820,1,"""2""",40320,40380
4123,106002,118102,60,38820,1,"""2""",40380,40440
4123,118102,101004,120,38820,1,"""2""",40440,40560
4123,101004,502802,120,38820,1,"""2""",40560,40680
4123,502802,500904,120,38820,1,"""2""",40680,40800
4123,500904,501602,60,38820,1,"""2""",40800,40860
4123,501602,501802,60,38820,1,"""2""",40860,40920
4123,501802,502000,60,38820,1,"""2""",40920,40980
4123,502000,501704,120,38820,1,"""2""",40980,41100
4123,501704,502502,60,38820,1,"""2""",41100,41160
4123,502502,501500,60,38820,1,"""2""",41160,41220
4123,501500,500500,60,38820,1,"""2""",41220,41280
4123,500500,500300,60,38820,1,"""2""",41280,41340
4123,500300,500200,60,38820,1,"""2""",41340,41400
4123,500200,502300,180,38820,1,"""2""",41400,41580
4123,204600,200600,0,39420,1,"""2""",39420,39420
4123,200600,204200,60,39420,1,"""2""",39420,39480
4123,204200,204500,60,39420,1,"""2""",39480,39540
4123,204500,200500,120,39420,1,"""2""",39540,39660
4123,200500,205603,60,39420,1,"""2""",39660,39720
4123,205603,205503,60,39420,1,"""2""",39720,39780
4123,205503,207802,60,39420,1,"""2""",39780,39840
4123,207802,203900,180,39420,1,"""2""",39840,40020
4123,203900,201503,60,39420,1,"""2""",40020,40080
4123,201503,208103,120,39420,1,"""2""",40080,40200
4123,208103,119004,120,39420,1,"""2""",40200,40320
4123,119004,117002,60,39420,1,"""2""",40320,40380
4123,117002,112105,180,39420,1,"""2""",40380,40560
4123,112105,103003,180,39420,1,"""2""",40560,40740
4123,103003,118002,180,39420,1,"""2""",40740,40920
4123,118002,106002,60,39420,1,"""2""",40920,40980
4123,106002,118102,60,39420,1,"""2""",40980,41040
4123,118102,101004,120,39420,1,"""2""",41040,41160
4123,101004,502802,120,39420,1,"""2""",41160,41280
4123,502802,500904,120,39420,1,"""2""",41280,41400
4123,500904,501602,60,39420,1,"""2""",41400,41460
4123,501602,501802,60,39420,1,"""2""",41460,41520
4123,501802,502000,60,39420,1,"""2""",41520,41580
4123,502000,501704,120,39420,1,"""2""",41580,41700
4123,501704,502502,60,39420,1,"""2""",41700,41760
4123,502502,501500,60,39420,1,"""2""",41760,41820
4123,501500,500500,60,39420,1,"""2""",41820,41880
4123,500500,500300,60,39420,1,"""2""",41880,41940
4123,500300,500200,60,39420,1,"""2""",41940,42000
4123,500200,502300,180,39420,1,"""2""",42000,42180
4123,204600,200600,0,40020,1,"""2""",40020,40020
4123,200600,204200,60,40020,1,"""2""",40020,40080
4123,204200,204500,60,40020,1,"""2""",40080,40140
4123,204500,200500,120,40020,1,"""2""",40140,40260
4123,200500,205603,60,40020,1,"""2""",40260,40320
4123,205603,205503,60,40020,1,"""2""",40320,40380
4123,205503,207802,60,40020,1,"""2""",40380,40440
4123,207802,203900,180,40020,1,"""2""",40440,40620
4123,203900,201503,60,40020,1,"""2""",40620,40680
4123,201503,208103,120,40020,1,"""2""",40680,40800
4123,208103,119004,120,40020,1,"""2""",40800,40920
4123,119004,117002,60,40020,1,"""2""",40920,40980
4123,117002,112105,180,40020,1,"""2""",40980,41160
4123,112105,103003,180,40020,1,"""2""",41160,41340
4123,103003,118002,180,40020,1,"""2""",41340,41520
4123,118002,106002,60,40020,1,"""2""",41520,41580
4123,106002,118102,60,40020,1,"""2""",41580,41640
4123,118102,101004,120,40020,1,"""2""",41640,41760
4123,101004,502802,120,40020,1,"""2""",41760,41880
4123,502802,500904,120,40020,1,"""2""",41880,42000
4123,500904,501602,60,40020,1,"""2""",42000,42060
4123,501602,501802,60,40020,1,"""2""",42060,42120
4123,501802,502000,60,40020,1,"""2""",42120,42180
4123,502000,501704,120,40020,1,"""2""",42180,42300
4123,501704,502502,60,40020,1,"""2""",42300,42360
4123,502502,501500,60,40020,1,"""2""",42360,42420
4123,501500,500500,60,40020,1,"""2""",42420,42480
4123,500500,500300,60,40020,1,"""2""",42480,42540
4123,500300,500200,60,40020,1,"""2""",42540,42600
4123,500200,502300,180,40020,1,"""2""",42600,42780
4123,204600,200600,0,40620,1,"""2""",40620,40620
4123,200600,204200,60,40620,1,"""2""",40620,40680
4123,204200,204500,60,40620,1,"""2""",40680,40740
4123,204500,200500,120,40620,1,"""2""",40740,40860
4123,200500,205603,60,40620,1,"""2""",40860,40920
4123,205603,205503,60,40620,1,"""2""",40920,40980
4123,205503,207802,60,40620,1,"""2""",40980,41040
4123,207802,203900,180,40620,1,"""2""",41040,41220
4123,203900,201503,60,40620,1,"""2""",41220,41280
4123,201503,208103,120,40620,1,"""2""",41280,41400
4123,208103,119004,120,40620,1,"""2""",41400,41520
4123,119004,117002,60,40620,1,"""2""",41520,41580
4123,117002,112105,180,40620,1,"""2""",41580,41760
4123,112105,103003,180,40620,1,"""2""",41760,41940
4123,103003,118002,180,40620,1,"""2""",41940,42120
4123,118002,106002,60,40620,1,"""2""",42120,42180
4123,106002,118102,60,40620,1,"""2""",42180,42240
4123,118102,101004,120,40620,1,"""2""",42240,42360
4123,101004,502802,120,40620,1,"""2""",42360,42480
4123,502802,500904,120,40620,1,"""2""",42480,42600
4123,500904,501602,60,40620,1,"""2""",42600,42660
4123,501602,501802,60,40620,1,"""2""",42660,42720
4123,501802,502000,60,40620,1,"""2""",42720,42780
4123,502000,501704,120,40620,1,"""2""",42780,42900
4123,501704,502502,60,40620,1,"""2""",42900,42960
4123,502502,501500,60,40620,1,"""2""",42960,43020
4123,501500,500500,60,40620,1,"""2""",43020,43080
4123,500500,500300,60,40620,1,"""2""",43080,43140
4123,500300,500200,60,40620,1,"""2""",43140,43200
4123,500200,502300,180,40620,1,"""2""",43200,43380
4123,204600,200600,0,41220,1,"""2""",41220,41220
4123,200600,204200,60,41220,1,"""2""",41220,41280
4123,204200,204500,60,41220,1,"""2""",41280,41340
4123,204500,200500,120,41220,1,"""2""",41340,41460
4123,200500,205603,60,41220,1,"""2""",41460,41520
4123,205603,205503,60,41220,1,"""2""",41520,41580
4123,205503,207802,60,41220,1,"""2""",41580,41640
4123,207802,203900,180,41220,1,"""2""",41640,41820
4123,203900,201503,60,41220,1,"""2""",41820,41880
4123,201503,208103,120,41220,1,"""2""",41880,42000
4123,208103,119004,120,41220,1,"""2""",42000,42120
4123,119004,117002,60,41220,1,"""2""",42120,42180
4123,117002,112105,180,41220,1,"""2""",42180,42360
4123,112105,103003,180,41220,1,"""2""",42360,42540
4123,103003,118002,180,41220,1,"""2""",42540,42720
4123,118002,106002,60,41220,1,"""2""",42720,42780
4123,106002,118102,60,41220,1,"""2""",42780,42840
4123,118102,101004,120,41220,1,"""2""",42840,42960
4123,101004,502802,120,41220,1,"""2""",42960,43080
4123,502802,500904,120,41220,1,"""2""",43080,43200
4123,500904,501602,60,41220,1,"""2""",43200,43260
4123,501602,501802,60,41220,1,"""2""",43260,43320
4123,501802,502000,60,41220,1,"""2""",43320,43380
4123,502000,501704,120,41220,1,"""2""",43380,43500
4123,501704,502502,60,41220,1,"""2""",43500,43560
4123,502502,501500,60,41220,1,"""2""",43560,43620
4123,501500,500500,60,41220,1,"""2""",43620,43680
4123,500500,500300,60,41220,1,"""2""",43680,43740
4123,500300,500200,60,41220,1,"""2""",43740,43800
4123,500200,502300,180,41220,1,"""2""",43800,43980
4123,204600,200600,0,41820,1,"""2""",41820,41820
4123,200600,204200,60,41820,1,"""2""",41820,41880
4123,204200,204500,60,41820,1,"""2""",41880,41940
4123,204500,200500,120,41820,1,"""2""",41940,42060
4123,200500,205603,60,41820,1,"""2""",42060,42120
4123,205603,205503,60,41820,1,"""2""",42120,42180
4123,205503,207802,60,41820,1,"""2""",42180,42240
4123,207802,203900,180,41820,1,"""2""",42240,42420
4123,203900,201503,60,41820,1,"""2""",42420,42480
4123,201503,208103,120,41820,1,"""2""",42480,42600
4123,208103,119004,120,41820,1,"""2""",42600,42720
4123,119004,117002,60,41820,1,"""2""",42720,42780
4123,117002,112105,180,41820,1,"""2""",42780,42960
4123,112105,103003,180,41820,1,"""2""",42960,43140
4123,103003,118002,180,41820,1,"""2""",43140,43320
4123,118002,106002,60,41820,1,"""2""",43320,43380
4123,106002,118102,60,41820,1,"""2""",43380,43440
4123,118102,101004,120,41820,1,"""2""",43440,43560
4123,101004,502802,120,41820,1,"""2""",43560,43680
4123,502802,500904,120,41820,1,"""2""",43680,43800
4123,500904,501602,60,41820,1,"""2""",43800,43860
4123,501602,501802,60,41820,1,"""2""",43860,43920
4123,501802,502000,60,41820,1,"""2""",43920,43980
4123,502000,501704,120,41820,1,"""2""",43980,44100
4123,501704,502502,60,41820,1,"""2""",44100,44160
4123,502502,501500,60,41820,1,"""2""",44160,44220
4123,501500,500500,60,41820,1,"""2""",44220,44280
4123,500500,500300,60,41820,1,"""2""",44280,44340
4123,500300,500200,60,41820,1,"""2""",44340,44400
4123,500200,502300,180,41820,1,"""2""",44400,44580
4123,204600,200600,0,42420,1,"""2""",42420,42420
4123,200600,204200,60,42420,1,"""2""",42420,42480
4123,204200,204500,60,42420,1,"""2""",42480,42540
4123,204500,200500,120,42420,1,"""2""",42540,42660
4123,200500,205603,60,42420,1,"""2""",42660,42720
4123,205603,205503,60,42420,1,"""2""",42720,42780
4123,205503,207802,60,42420,1,"""2""",42780,42840
4123,207802,203900,180,42420,1,"""2""",42840,43020
4123,203900,201503,60,42420,1,"""2""",43020,43080
4123,201503,208103,120,42420,1,"""2""",43080,43200
4123,208103,119004,120,42420,1,"""2""",43200,43320
4123,119004,117002,60,42420,1,"""2""",43320,43380
4123,117002,112105,180,42420,1,"""2""",43380,43560
4123,112105,103003,180,42420,1,"""2""",43560,43740
4123,103003,118002,180,42420,1,"""2""",43740,43920
4123,118002,106002,60,42420,1,"""2""",43920,43980
4123,106002,118102,60,42420,1,"""2""",43980,44040
4123,118102,101004,120,42420,1,"""2""",44040,44160
4123,101004,502802,120,42420,1,"""2""",44160,44280
4123,502802,500904,120,42420,1,"""2""",44280,44400
4123,500904,501602,60,42420,1,"""2""",44400,44460
4123,501602,501802,60,42420,1,"""2""",44460,44520
4123,501802,502000,60,42420,1,"""2""",44520,44580
4123,502000,501704,120,42420,1,"""2""",44580,44700
4123,501704,502502,60,42420,1,"""2""",44700,44760
4123,502502,501500,60,42420,1,"""2""",44760,44820
4123,501500,500500,60,42420,1,"""2""",44820,44880
4123,500500,500300,60,42420,1,"""2""",44880,44940
4123,500300,500200,60,42420,1,"""2""",44940,45000
4123,500200,502300,180,42420,1,"""2""",45000,45180
4123,204600,200600,0,43020,1,"""2""",43020,43020
4123,200600,204200,60,43020,1,"""2""",43020,43080
4123,204200,204500,60,43020,1,"""2""",43080,43140
4123,204500,200500,120,43020,1,"""2""",43140,43260
4123,200500,205603,60,43020,1,"""2""",43260,43320
4123,205603,205503,60,43020,1,"""2""",43320,43380
4123,205503,207802,60,43020,1,"""2""",43380,43440
4123,207802,203900,180,43020,1,"""2""",43440,43620
4123,203900,201503,60,43020,1,"""2""",43620,43680
4123,201503,208103,120,43020,1,"""2""",43680,43800
4123,208103,119004,120,43020,1,"""2""",43800,43920
4123,119004,117002,60,43020,1,"""2""",43920,43980
4123,117002,112105,180,43020,1,"""2""",43980,44160
4123,112105,103003,180,43020,1,"""2""",44160,44340
4123,103003,118002,180,43020,1,"""2""",44340,44520
4123,118002,106002,60,43020,1,"""2""",44520,44580
4123,106002,118102,60,43020,1,"""2""",44580,44640
4123,118102,101004,120,43020,1,"""2""",44640,44760
4123,101004,502802,120,43020,1,"""2""",44760,44880
4123,502802,500904,120,43020,1,"""2""",44880,45000
4123,500904,501602,60,43020,1,"""2""",45000,45060
4123,501602,501802,60,43020,1,"""2""",45060,45120
4123,501802,502000,60,43020,1,"""2""",45120,45180
4123,502000,501704,120,43020,1,"""2""",45180,45300
4123,501704,502502,60,43020,1,"""2""",45300,45360
4123,502502,501500,60,43020,1,"""2""",45360,45420
4123,501500,500500,60,43020,1,"""2""",45420,45480
4123,500500,500300,60,43020,1,"""2""",45480,45540
4123,500300,500200,60,43020,1,"""2""",45540,45600
4123,500200,502300,180,43020,1,"""2""",45600,45780
4123,204600,200600,0,43620,1,"""2""",43620,43620
4123,200600,204200,60,43620,1,"""2""",43620,43680
4123,204200,204500,60,43620,1,"""2""",43680,43740
4123,204500,200500,120,43620,1,"""2""",43740,43860
4123,200500,205603,60,43620,1,"""2""",43860,43920
4123,205603,205503,60,43620,1,"""2""",43920,43980
4123,205503,207802,60,43620,1,"""2""",43980,44040
4123,207802,203900,180,43620,1,"""2""",44040,44220
4123,203900,201503,60,43620,1,"""2""",44220,44280
4123,201503,208103,120,43620,1,"""2""",44280,44400
4123,208103,119004,120,43620,1,"""2""",44400,44520
4123,119004,117002,60,43620,1,"""2""",44520,44580
4123,117002,112105,180,43620,1,"""2""",44580,44760
4123,112105,103003,180,43620,1,"""2""",44760,44940
4123,103003,118002,180,43620,1,"""2""",44940,45120
4123,118002,106002,60,43620,1,"""2""",45120,45180
4123,106002,118102,60,43620,1,"""2""",45180,45240
4123,118102,101004,120,43620,1,"""2""",45240,45360
4123,101004,502802,120,43620,1,"""2""",45360,45480
4123,502802,500904,120,43620,1,"""2""",45480,45600
4123,500904,501602,60,43620,1,"""2""",45600,45660
4123,501602,501802,60,43620,1,"""2""",45660,45720
4123,501802,502000,60,43620,1,"""2""",45720,45780
4123,502000,501704,120,43620,1,"""2""",45780,45900
4123,501704,502502,60,43620,1,"""2""",45900,45960
4123,502502,501500,60,43620,1,"""2""",45960,46020
4123,501500,500500,60,43620,1,"""2""",46020,46080
4123,500500,500300,60,43620,1,"""2""",46080,46140
4123,500300,500200,60,43620,1,"""2""",46140,46200
4123,500200,502300,180,43620,1,"""2""",46200,46380
4123,204600,200600,0,44220,1,"""2""",44220,44220
4123,200600,204200,60,44220,1,"""2""",44220,44280
4123,204200,204500,60,44220,1,"""2""",44280,44340
4123,204500,200500,120,44220,1,"""2""",44340,44460
4123,200500,205603,60,44220,1,"""2""",44460,44520
4123,205603,205503,60,44220,1,"""2""",44520,44580
4123,205503,207802,60,44220,1,"""2""",44580,44640
4123,207802,203900,180,44220,1,"""2""",44640,44820
4123,203900,201503,60,44220,1,"""2""",44820,44880
4123,201503,208103,120,44220,1,"""2""",44880,45000
4123,208103,119004,120,44220,1,"""2""",45000,45120
4123,119004,117002,60,44220,1,"""2""",45120,45180
4123,117002,112105,180,44220,1,"""2""",45180,45360
4123,112105,103003,180,44220,1,"""2""",45360,45540
4123,103003,118002,180,44220,1,"""2""",45540,45720
4123,118002,106002,60,44220,1,"""2""",45720,45780
4123,106002,118102,60,44220,1,"""2""",45780,45840
4123,118102,101004,120,44220,1,"""2""",45840,45960
4123,101004,502802,120,44220,1,"""2""",45960,46080
4123,502802,500904,120,44220,1,"""2""",46080,46200
4123,500904,501602,60,44220,1,"""2""",46200,46260
4123,501602,501802,60,44220,1,"""2""",46260,46320
4123,501802,502000,60,44220,1,"""2""",46320,46380
4123,502000,501704,120,44220,1,"""2""",46380,46500
4123,501704,502502,60,44220,1,"""2""",46500,46560
4123,502502,501500,60,44220,1,"""2""",46560,46620
4123,501500,500500,60,44220,1,"""2""",46620,46680
4123,500500,500300,60,44220,1,"""2""",46680,46740
4123,500300,500200,60,44220,1,"""2""",46740,46800
4123,500200,502300,180,44220,1,"""2""",46800,46980
4123,204600,200600,0,44820,1,"""2""",44820,44820
4123,200600,204200,60,44820,1,"""2""",44820,44880
4123,204200,204500,60,44820,1,"""2""",44880,44940
4123,204500,200500,120,44820,1,"""2""",44940,45060
4123,200500,205603,60,44820,1,"""2""",45060,45120
4123,205603,205503,60,44820,1,"""2""",45120,45180
4123,205503,207802,60,44820,1,"""2""",45180,45240
4123,207802,203900,180,44820,1,"""2""",45240,45420
4123,203900,201503,60,44820,1,"""2""",45420,45480
4123,201503,208103,120,44820,1,"""2""",45480,45600
4123,208103,119004,120,44820,1,"""2""",45600,45720
4123,119004,117002,60,44820,1,"""2""",45720,45780
4123,117002,112105,180,44820,1,"""2""",45780,45960
4123,112105,103003,180,44820,1,"""2""",45960,46140
4123,103003,118002,180,44820,1,"""2""",46140,46320
4123,118002,106002,60,44820,1,"""2""",46320,46380
4123,106002,118102,60,44820,1,"""2""",46380,46440
4123,118102,101004,120,44820,1,"""2""",46440,46560
4123,101004,502802,120,44820,1,"""2""",46560,46680
4123,502802,500904,120,44820,1,"""2""",46680,46800
4123,500904,501602,60,44820,1,"""2""",46800,46860
4123,501602,501802,60,44820,1,"""2""",46860,46920
4123,501802,502000,60,44820,1,"""2""",46920,46980
4123,502000,501704,120,44820,1,"""2""",46980,47100
4123,501704,502502,60,44820,1,"""2""",47100,47160
4123,502502,501500,60,44820,1,"""2""",47160,47220
4123,501500,500500,60,44820,1,"""2""",47220,47280
4123,500500,500300,60,44820,1,"""2""",47280,47340
4123,500300,500200,60,44820,1,"""2""",47340,47400
4123,500200,502300,180,44820,1,"""2""",47400,47580
4123,204600,200600,0,45420,1,"""2""",45420,45420
4123,200600,204200,60,45420,1,"""2""",45420,45480
4123,204200,204500,60,45420,1,"""2""",45480,45540
4123,204500,200500,120,45420,1,"""2""",45540,45660
4123,200500,205603,60,45420,1,"""2""",45660,45720
4123,205603,205503,60,45420,1,"""2""",45720,45780
4123,205503,207802,60,45420,1,"""2""",45780,45840
4123,207802,203900,180,45420,1,"""2""",45840,46020
4123,203900,201503,60,45420,1,"""2""",46020,46080
4123,201503,208103,120,45420,1,"""2""",46080,46200
4123,208103,119004,120,45420,1,"""2""",46200,46320
4123,119004,117002,60,45420,1,"""2""",46320,46380
4123,117002,112105,180,45420,1,"""2""",46380,46560
4123,112105,103003,180,45420,1,"""2""",46560,46740
4123,103003,118002,180,45420,1,"""2""",46740,46920
4123,118002,106002,60,45420,1,"""2""",46920,46980
4123,106002,118102,60,45420,1,"""2""",46980,47040
4123,118102,101004,120,45420,1,"""2""",47040,47160
4123,101004,502802,120,45420,1,"""2""",47160,47280
4123,502802,500904,120,45420,1,"""2""",47280,47400
4123,500904,501602,60,45420,1,"""2""",47400,47460
4123,501602,501802,60,45420,1,"""2""",47460,47520
4123,501802,502000,60,45420,1,"""2""",47520,47580
4123,502000,501704,120,45420,1,"""2""",47580,47700
4123,501704,502502,60,45420,1,"""2""",47700,47760
4123,502502,501500,60,45420,1,"""2""",47760,47820
4123,501500,500500,60,45420,1,"""2""",47820,47880
4123,500500,500300,60,45420,1,"""2""",47880,47940
4123,500300,500200,60,45420,1,"""2""",47940,48000
4123,500200,502300,180,45420,1,"""2""",48000,48180
4123,204600,200600,0,46020,1,"""2""",46020,46020
4123,200600,204200,60,46020,1,"""2""",46020,46080
4123,204200,204500,60,46020,1,"""2""",46080,46140
4123,204500,200500,120,46020,1,"""2""",46140,46260
4123,200500,205603,60,46020,1,"""2""",46260,46320
4123,205603,205503,60,46020,1,"""2""",46320,46380
4123,205503,207802,60,46020,1,"""2""",46380,46440
4123,207802,203900,180,46020,1,"""2""",46440,46620
4123,203900,201503,60,46020,1,"""2""",46620,46680
4123,201503,208103,120,46020,1,"""2""",46680,46800
4123,208103,119004,120,46020,1,"""2""",46800,46920
4123,119004,117002,60,46020,1,"""2""",46920,46980
4123,117002,112105,180,46020,1,"""2""",46980,47160
4123,112105,103003,180,46020,1,"""2""",47160,47340
4123,103003,118002,180,46020,1,"""2""",47340,47520
4123,118002,106002,60,46020,1,"""2""",47520,47580
4123,106002,118102,60,46020,1,"""2""",47580,47640
4123,118102,101004,120,46020,1,"""2""",47640,47760
4123,101004,502802,120,46020,1,"""2""",47760,47880
4123,502802,500904,120,46020,1,"""2""",47880,48000
4123,500904,501602,60,46020,1,"""2""",48000,48060
4123,501602,501802,60,46020,1,"""2""",48060,48120
4123,501802,502000,60,46020,1,"""2""",48120,48180
4123,502000,501704,120,46020,1,"""2""",48180,48300
4123,501704,502502,60,46020,1,"""2""",48300,48360
4123,502502,501500,60,46020,1,"""2""",48360,48420
4123,501500,500500,60,46020,1,"""2""",48420,48480
4123,500500,500300,60,46020,1,"""2""",48480,48540
4123,500300,500200,60,46020,1,"""2""",48540,48600
4123,500200,502300,180,46020,1,"""2""",48600,48780
4123,204600,200600,0,46620,1,"""2""",46620,46620
4123,200600,204200,60,46620,1,"""2""",46620,46680
4123,204200,204500,60,46620,1,"""2""",46680,46740
4123,204500,200500,120,46620,1,"""2""",46740,46860
4123,200500,205603,60,46620,1,"""2""",46860,46920
4123,205603,205503,60,46620,1,"""2""",46920,46980
4123,205503,207802,60,46620,1,"""2""",46980,47040
4123,207802,203900,180,46620,1,"""2""",47040,47220
4123,203900,201503,60,46620,1,"""2""",47220,47280
4123,201503,208103,120,46620,1,"""2""",47280,47400
4123,208103,119004,120,46620,1,"""2""",47400,47520
4123,119004,117002,60,46620,1,"""2""",47520,47580
4123,117002,112105,180,46620,1,"""2""",47580,47760
4123,112105,103003,180,46620,1,"""2""",47760,47940
4123,103003,118002,180,46620,1,"""2""",47940,48120
4123,118002,106002,60,46620,1,"""2""",48120,48180
4123,106002,118102,60,46620,1,"""2""",48180,48240
4123,118102,101004,120,46620,1,"""2""",48240,48360
4123,101004,502802,120,46620,1,"""2""",48360,48480
4123,502802,500904,120,46620,1,"""2""",48480,48600
4123,500904,501602,60,46620,1,"""2""",48600,48660
4123,501602,501802,60,46620,1,"""2""",48660,48720
4123,501802,502000,60,46620,1,"""2""",48720,48780
4123,502000,501704,120,46620,1,"""2""",48780,48900
4123,501704,502502,60,46620,1,"""2""",48900,48960
4123,502502,501500,60,46620,1,"""2""",48960,49020
4123,501500,500500,60,46620,1,"""2""",49020,49080
4123,500500,500300,60,46620,1,"""2""",49080,49140
4123,500300,500200,60,46620,1,"""2""",49140,49200
4123,500200,502300,180,46620,1,"""2""",49200,49380
4123,204600,200600,0,47220,1,"""2""",47220,47220
4123,200600,204200,60,47220,1,"""2""",47220,47280
4123,204200,204500,60,47220,1,"""2""",47280,47340
4123,204500,200500,120,47220,1,"""2""",47340,47460
4123,200500,205603,60,47220,1,"""2""",47460,47520
4123,205603,205503,60,47220,1,"""2""",47520,47580
4123,205503,207802,60,47220,1,"""2""",47580,47640
4123,207802,203900,180,47220,1,"""2""",47640,47820
4123,203900,201503,60,47220,1,"""2""",47820,47880
4123,201503,208103,120,47220,1,"""2""",47880,48000
4123,208103,119004,120,47220,1,"""2""",48000,48120
4123,119004,117002,60,47220,1,"""2""",48120,48180
4123,117002,112105,180,47220,1,"""2""",48180,48360
4123,112105,103003,180,47220,1,"""2""",48360,48540
4123,103003,118002,180,47220,1,"""2""",48540,48720
4123,118002,106002,60,47220,1,"""2""",48720,48780
4123,106002,118102,60,47220,1,"""2""",48780,48840
4123,118102,101004,120,47220,1,"""2""",48840,48960
4123,101004,502802,120,47220,1,"""2""",48960,49080
4123,502802,500904,120,47220,1,"""2""",49080,49200
4123,500904,501602,60,47220,1,"""2""",49200,49260
4123,501602,501802,60,47220,1,"""2""",49260,49320
4123,501802,502000,60,47220,1,"""2""",49320,49380
4123,502000,501704,120,47220,1,"""2""",49380,49500
4123,501704,502502,60,47220,1,"""2""",49500,49560
4123,502502,501500,60,47220,1,"""2""",49560,49620
4123,501500,500500,60,47220,1,"""2""",49620,49680
4123,500500,500300,60,47220,1,"""2""",49680,49740
4123,500300,500200,60,47220,1,"""2""",49740,49800
4123,500200,502300,180,47220,1,"""2""",49800,49980
4123,204600,200600,0,47820,1,"""2""",47820,47820
4123,200600,204200,60,47820,1,"""2""",47820,47880
4123,204200,204500,60,47820,1,"""2""",47880,47940
4123,204500,200500,120,47820,1,"""2""",47940,48060
4123,200500,205603,60,47820,1,"""2""",48060,48120
4123,205603,205503,60,47820,1,"""2""",48120,48180
4123,205503,207802,60,47820,1,"""2""",48180,48240
4123,207802,203900,180,47820,1,"""2""",48240,48420
4123,203900,201503,60,47820,1,"""2""",48420,48480
4123,201503,208103,120,47820,1,"""2""",48480,48600
4123,208103,119004,120,47820,1,"""2""",48600,48720
4123,119004,117002,60,47820,1,"""2""",48720,48780
4123,117002,112105,180,47820,1,"""2""",48780,48960
4123,112105,103003,180,47820,1,"""2""",48960,49140
4123,103003,118002,180,47820,1,"""2""",49140,49320
4123,118002,106002,60,47820,1,"""2""",49320,49380
4123,106002,118102,60,47820,1,"""2""",49380,49440
4123,118102,101004,120,47820,1,"""2""",49440,49560
4123,101004,502802,120,47820,1,"""2""",49560,49680
4123,502802,500904,120,47820,1,"""2""",49680,49800
4123,500904,501602,60,47820,1,"""2""",49800,49860
4123,501602,501802,60,47820,1,"""2""",49860,49920
4123,501802,502000,60,47820,1,"""2""",49920,49980
4123,502000,501704,120,47820,1,"""2""",49980,50100
4123,501704,502502,60,47820,1,"""2""",50100,50160
4123,502502,501500,60,47820,1,"""2""",50160,50220
4123,501500,500500,60,47820,1,"""2""",50220,50280
4123,500500,500300,60,47820,1,"""2""",50280,50340
4123,500300,500200,60,47820,1,"""2""",50340,50400
4123,500200,502300,180,47820,1,"""2""",50400,50580
4123,204600,200600,0,48420,1,"""2""",48420,48420
4123,200600,204200,60,48420,1,"""2""",48420,48480
4123,204200,204500,60,48420,1,"""2""",48480,48540
4123,204500,200500,120,48420,1,"""2""",48540,48660
4123,200500,205603,60,48420,1,"""2""",48660,48720
4123,205603,205503,60,48420,1,"""2""",48720,48780
4123,205503,207802,60,48420,1,"""2""",48780,48840
4123,207802,203900,180,48420,1,"""2""",48840,49020
4123,203900,201503,60,48420,1,"""2""",49020,49080
4123,201503,208103,120,48420,1,"""2""",49080,49200
4123,208103,119004,120,48420,1,"""2""",49200,49320
4123,119004,117002,60,48420,1,"""2""",49320,49380
4123,117002,112105,180,48420,1,"""2""",49380,49560
4123,112105,103003,180,48420,1,"""2""",49560,49740
4123,103003,118002,180,48420,1,"""2""",49740,49920
4123,118002,106002,60,48420,1,"""2""",49920,49980
4123,106002,118102,60,48420,1,"""2""",49980,50040
4123,118102,101004,120,48420,1,"""2""",50040,50160
4123,101004,502802,120,48420,1,"""2""",50160,50280
4123,502802,500904,120,48420,1,"""2""",50280,50400
4123,500904,501602,60,48420,1,"""2""",50400,50460
4123,501602,501802,60,48420,1,"""2""",50460,50520
4123,501802,502000,60,48420,1,"""2""",50520,50580
4123,502000,501704,120,48420,1,"""2""",50580,50700
4123,501704,502502,60,48420,1,"""2""",50700,50760
4123,502502,501500,60,48420,1,"""2""",50760,50820
4123,501500,500500,60,48420,1,"""2""",50820,50880
4123,500500,500300,60,48420,1,"""2""",50880,50940
4123,500300,500200,60,48420,1,"""2""",50940,51000
4123,500200,502300,180,48420,1,"""2""",51000,51180
4123,204600,200600,0,49020,1,"""2""",49020,49020
4123,200600,204200,60,49020,1,"""2""",49020,49080
4123,204200,204500,60,49020,1,"""2""",49080,49140
4123,204500,200500,120,49020,1,"""2""",49140,49260
4123,200500,205603,60,49020,1,"""2""",49260,49320
4123,205603,205503,60,49020,1,"""2""",49320,49380
4123,205503,207802,60,49020,1,"""2""",49380,49440
4123,207802,203900,180,49020,1,"""2""",49440,49620
4123,203900,201503,60,49020,1,"""2""",49620,49680
4123,201503,208103,120,49020,1,"""2""",49680,49800
4123,208103,119004,120,49020,1,"""2""",49800,49920
4123,119004,117002,60,49020,1,"""2""",49920,49980
4123,117002,112105,180,49020,1,"""2""",49980,50160
4123,112105,103003,180,49020,1,"""2""",50160,50340
4123,103003,118002,180,49020,1,"""2""",50340,50520
4123,118002,106002,60,49020,1,"""2""",50520,50580
4123,106002,118102,60,49020,1,"""2""",50580,50640
4123,118102,101004,120,49020,1,"""2""",50640,50760
4123,101004,502802,120,49020,1,"""2""",50760,50880
4123,502802,500904,120,49020,1,"""2""",50880,51000
4123,500904,501602,60,49020,1,"""2""",51000,51060
4123,501602,501802,60,49020,1,"""2""",51060,51120
4123,501802,502000,60,49020,1,"""2""",51120,51180
4123,502000,501704,120,49020,1,"""2""",51180,51300
4123,501704,502502,60,49020,1,"""2""",51300,51360
4123,502502,501500,60,49020,1,"""2""",51360,51420
4123,501500,500500,60,49020,1,"""2""",51420,51480
4123,500500,500300,60,49020,1,"""2""",51480,51540
4123,500300,500200,60,49020,1,"""2""",51540,51600
4123,500200,502300,180,49020,1,"""2""",51600,51780
4123,204600,200600,0,49620,1,"""2""",49620,49620
4123,200600,204200,60,49620,1,"""2""",49620,49680
4123,204200,204500,60,49620,1,"""2""",49680,49740
4123,204500,200500,120,49620,1,"""2""",49740,49860
4123,200500,205603,60,49620,1,"""2""",49860,49920
4123,205603,205503,60,49620,1,"""2""",49920,49980
4123,205503,207802,60,49620,1,"""2""",49980,50040
4123,207802,203900,180,49620,1,"""2""",50040,50220
4123,203900,201503,60,49620,1,"""2""",50220,50280
4123,201503,208103,120,49620,1,"""2""",50280,50400
4123,208103,119004,120,49620,1,"""2""",50400,50520
4123,119004,117002,60,49620,1,"""2""",50520,50580
4123,117002,112105,180,49620,1,"""2""",50580,50760
4123,112105,103003,180,49620,1,"""2""",50760,50940
4123,103003,118002,180,49620,1,"""2""",50940,51120
4123,118002,106002,60,49620,1,"""2""",51120,51180
4123,106002,118102,60,49620,1,"""2""",51180,51240
4123,118102,101004,120,49620,1,"""2""",51240,51360
4123,101004,502802,120,49620,1,"""2""",51360,51480
4123,502802,500904,120,49620,1,"""2""",51480,51600
4123,500904,501602,60,49620,1,"""2""",51600,51660
4123,501602,501802,60,49620,1,"""2""",51660,51720
4123,501802,502000,60,49620,1,"""2""",51720,51780
4123,502000,501704,120,49620,1,"""2""",51780,51900
4123,501704,502502,60,49620,1,"""2""",51900,51960
4123,502502,501500,60,49620,1,"""2""",51960,52020
4123,501500,500500,60,49620,1,"""2""",52020,52080
4123,500500,500300,60,49620,1,"""2""",52080,52140
4123,500300,500200,60,49620,1,"""2""",52140,52200
4123,500200,502300,180,49620,1,"""2""",52200,52380
4123,204600,200600,0,50220,1,"""2""",50220,50220
4123,200600,204200,60,50220,1,"""2""",50220,50280
4123,204200,204500,60,50220,1,"""2""",50280,50340
4123,204500,200500,120,50220,1,"""2""",50340,50460
4123,200500,205603,60,50220,1,"""2""",50460,50520
4123,205603,205503,60,50220,1,"""2""",50520,50580
4123,205503,207802,60,50220,1,"""2""",50580,50640
4123,207802,203900,180,50220,1,"""2""",50640,50820
4123,203900,201503,60,50220,1,"""2""",50820,50880
4123,201503,208103,120,50220,1,"""2""",50880,51000
4123,208103,119004,120,50220,1,"""2""",51000,51120
4123,119004,117002,60,50220,1,"""2""",51120,51180
4123,117002,112105,180,50220,1,"""2""",51180,51360
4123,112105,103003,180,50220,1,"""2""",51360,51540
4123,103003,118002,180,50220,1,"""2""",51540,51720
4123,118002,106002,60,50220,1,"""2""",51720,51780
4123,106002,118102,60,50220,1,"""2""",51780,51840
4123,118102,101004,120,50220,1,"""2""",51840,51960
4123,101004,502802,120,50220,1,"""2""",51960,52080
4123,502802,500904,120,50220,1,"""2""",52080,52200
4123,500904,501602,60,50220,1,"""2""",52200,52260
4123,501602,501802,60,50220,1,"""2""",52260,52320
4123,501802,502000,60,50220,1,"""2""",52320,52380
4123,502000,501704,120,50220,1,"""2""",52380,52500
4123,501704,502502,60,50220,1,"""2""",52500,52560
4123,502502,501500,60,50220,1,"""2""",52560,52620
4123,501500,500500,60,50220,1,"""2""",52620,52680
4123,500500,500300,60,50220,1,"""2""",52680,52740
4123,500300,500200,60,50220,1,"""2""",52740,52800
4123,500200,502300,180,50220,1,"""2""",52800,52980
4123,204600,200600,0,50820,1,"""2""",50820,50820
4123,200600,204200,60,50820,1,"""2""",50820,50880
4123,204200,204500,60,50820,1,"""2""",50880,50940
4123,204500,200500,120,50820,1,"""2""",50940,51060
4123,200500,205603,60,50820,1,"""2""",51060,51120
4123,205603,205503,60,50820,1,"""2""",51120,51180
4123,205503,207802,60,50820,1,"""2""",51180,51240
4123,207802,203900,180,50820,1,"""2""",51240,51420
4123,203900,201503,60,50820,1,"""2""",51420,51480
4123,201503,208103,120,50820,1,"""2""",51480,51600
4123,208103,119004,120,50820,1,"""2""",51600,51720
4123,119004,117002,60,50820,1,"""2""",51720,51780
4123,117002,112105,180,50820,1,"""2""",51780,51960
4123,112105,103003,180,50820,1,"""2""",51960,52140
4123,103003,118002,180,50820,1,"""2""",52140,52320
4123,118002,106002,60,50820,1,"""2""",52320,52380
4123,106002,118102,60,50820,1,"""2""",52380,52440
4123,118102,101004,120,50820,1,"""2""",52440,52560
4123,101004,502802,120,50820,1,"""2""",52560,52680
4123,502802,500904,120,50820,1,"""2""",52680,52800
4123,500904,501602,60,50820,1,"""2""",52800,52860
4123,501602,501802,60,50820,1,"""2""",52860,52920
4123,501802,502000,60,50820,1,"""2""",52920,52980
4123,502000,501704,120,50820,1,"""2""",52980,53100
4123,501704,502502,60,50820,1,"""2""",53100,53160
4123,502502,501500,60,50820,1,"""2""",53160,53220
4123,501500,500500,60,50820,1,"""2""",53220,53280
4123,500500,500300,60,50820,1,"""2""",53280,53340
4123,500300,500200,60,50820,1,"""2""",53340,53400
4123,500200,502300,180,50820,1,"""2""",53400,53580
4123,204600,200600,0,51420,1,"""2""",51420,51420
4123,200600,204200,60,51420,1,"""2""",51420,51480
4123,204200,204500,60,51420,1,"""2""",51480,51540
4123,204500,200500,120,51420,1,"""2""",51540,51660
4123,200500,205603,60,51420,1,"""2""",51660,51720
4123,205603,205503,60,51420,1,"""2""",51720,51780
4123,205503,207802,60,51420,1,"""2""",51780,51840
4123,207802,203900,180,51420,1,"""2""",51840,52020
4123,203900,201503,60,51420,1,"""2""",52020,52080
4123,201503,208103,120,51420,1,"""2""",52080,52200
4123,208103,119004,120,51420,1,"""2""",52200,52320
4123,119004,117002,60,51420,1,"""2""",52320,52380
4123,117002,112105,180,51420,1,"""2""",52380,52560
4123,112105,103003,180,51420,1,"""2""",52560,52740
4123,103003,118002,180,51420,1,"""2""",52740,52920
4123,118002,106002,60,51420,1,"""2""",52920,52980
4123,106002,118102,60,51420,1,"""2""",52980,53040
4123,118102,101004,120,51420,1,"""2""",53040,53160
4123,101004,502802,120,51420,1,"""2""",53160,53280
4123,502802,500904,120,51420,1,"""2""",53280,53400
4123,500904,501602,60,51420,1,"""2""",53400,53460
4123,501602,501802,60,51420,1,"""2""",53460,53520
4123,501802,502000,60,51420,1,"""2""",53520,53580
4123,502000,501704,120,51420,1,"""2""",53580,53700
4123,501704,502502,60,51420,1,"""2""",53700,53760
4123,502502,501500,60,51420,1,"""2""",53760,53820
4123,501500,500500,60,51420,1,"""2""",53820,53880
4123,500500,500300,60,51420,1,"""2""",53880,53940
4123,500300,500200,60,51420,1,"""2""",53940,54000
4123,500200,502300,180,51420,1,"""2""",54000,54180
4123,204600,200600,0,52020,1,"""2""",52020,52020
4123,200600,204200,60,52020,1,"""2""",52020,52080
4123,204200,204500,60,52020,1,"""2""",52080,52140
4123,204500,200500,120,52020,1,"""2""",52140,52260
4123,200500,205603,60,52020,1,"""2""",52260,52320
4123,205603,205503,60,52020,1,"""2""",52320,52380
4123,205503,207802,60,52020,1,"""2""",52380,52440
4123,207802,203900,180,52020,1,"""2""",52440,52620
4123,203900,201503,60,52020,1,"""2""",52620,52680
4123,201503,208103,120,52020,1,"""2""",52680,52800
4123,208103,119004,120,52020,1,"""2""",52800,52920
4123,119004,117002,60,52020,1,"""2""",52920,52980
4123,117002,112105,180,52020,1,"""2""",52980,53160
4123,112105,103003,180,52020,1,"""2""",53160,53340
4123,103003,118002,180,52020,1,"""2""",53340,53520
4123,118002,106002,60,52020,1,"""2""",53520,53580
4123,106002,118102,60,52020,1,"""2""",53580,53640
4123,118102,101004,120,52020,1,"""2""",53640,53760
4123,101004,502802,120,52020,1,"""2""",53760,53880
4123,502802,500904,120,52020,1,"""2""",53880,54000
4123,500904,501602,60,52020,1,"""2""",54000,54060
4123,501602,501802,60,52020,1,"""2""",54060,54120
4123,501802,502000,60,52020,1,"""2""",54120,54180
4123,502000,501704,120,52020,1,"""2""",54180,54300
4123,501704,502502,60,52020,1,"""2""",54300,54360
4123,502502,501500,60,52020,1,"""2""",54360,54420
4123,501500,500500,60,52020,1,"""2""",54420,54480
4123,500500,500300,60,52020,1,"""2""",54480,54540
4123,500300,500200,60,52020,1,"""2""",54540,54600
4123,500200,502300,180,52020,1,"""2""",54600,54780
4123,204600,200600,0,52620,1,"""2""",52620,52620
4123,200600,204200,60,52620,1,"""2""",52620,52680
4123,204200,204500,60,52620,1,"""2""",52680,52740
4123,204500,200500,120,52620,1,"""2""",52740,52860
4123,200500,205603,60,52620,1,"""2""",52860,52920
4123,205603,205503,60,52620,1,"""2""",52920,52980
4123,205503,207802,60,52620,1,"""2""",52980,53040
4123,207802,203900,180,52620,1,"""2""",53040,53220
4123,203900,201503,60,52620,1,"""2""",53220,53280
4123,201503,208103,120,52620,1,"""2""",53280,53400
4123,208103,119004,120,52620,1,"""2""",53400,53520
4123,119004,117002,60,52620,1,"""2""",53520,53580
4123,117002,112105,180,52620,1,"""2""",53580,53760
4123,112105,103003,180,52620,1,"""2""",53760,53940
4123,103003,118002,180,52620,1,"""2""",53940,54120
4123,118002,106002,60,52620,1,"""2""",54120,54180
4123,106002,118102,60,52620,1,"""2""",54180,54240
4123,118102,101004,120,52620,1,"""2""",54240,54360
4123,101004,502802,120,52620,1,"""2""",54360,54480
4123,502802,500904,120,52620,1,"""2""",54480,54600
4123,500904,501602,60,52620,1,"""2""",54600,54660
4123,501602,501802,60,52620,1,"""2""",54660,54720
4123,501802,502000,60,52620,1,"""2""",54720,54780
4123,502000,501704,120,52620,1,"""2""",54780,54900
4123,501704,502502,60,52620,1,"""2""",54900,54960
4123,502502,501500,60,52620,1,"""2""",54960,55020
4123,501500,500500,60,52620,1,"""2""",55020,55080
4123,500500,500300,60,52620,1,"""2""",55080,55140
4123,500300,500200,60,52620,1,"""2""",55140,55200
4123,500200,502300,180,52620,1,"""2""",55200,55380
4123,204600,200600,0,53220,1,"""2""",53220,53220
4123,200600,204200,60,53220,1,"""2""",53220,53280
4123,204200,204500,60,53220,1,"""2""",53280,53340
4123,204500,200500,120,53220,1,"""2""",53340,53460
4123,200500,205603,60,53220,1,"""2""",53460,53520
4123,205603,205503,60,53220,1,"""2""",53520,53580
4123,205503,207802,60,53220,1,"""2""",53580,53640
4123,207802,203900,180,53220,1,"""2""",53640,53820
4123,203900,201503,60,53220,1,"""2""",53820,53880
4123,201503,208103,120,53220,1,"""2""",53880,54000
4123,208103,119004,120,53220,1,"""2""",54000,54120
4123,119004,117002,60,53220,1,"""2""",54120,54180
4123,117002,112105,180,53220,1,"""2""",54180,54360
4123,112105,103003,180,53220,1,"""2""",54360,54540
4123,103003,118002,180,53220,1,"""2""",54540,54720
4123,118002,106002,60,53220,1,"""2""",54720,54780
4123,106002,118102,60,53220,1,"""2""",54780,54840
4123,118102,101004,120,53220,1,"""2""",54840,54960
4123,101004,502802,120,53220,1,"""2""",54960,55080
4123,502802,500904,120,53220,1,"""2""",55080,55200
4123,500904,501602,60,53220,1,"""2""",55200,55260
4123,501602,501802,60,53220,1,"""2""",55260,55320
4123,501802,502000,60,53220,1,"""2""",55320,55380
4123,502000,501704,120,53220,1,"""2""",55380,55500
4123,501704,502502,60,53220,1,"""2""",55500,55560
4123,502502,501500,60,53220,1,"""2""",55560,55620
4123,501500,500500,60,53220,1,"""2""",55620,55680
4123,500500,500300,60,53220,1,"""2""",55680,55740
4123,500300,500200,60,53220,1,"""2""",55740,55800
4123,500200,502300,180,53220,1,"""2""",55800,55980
4123,204600,200600,0,53820,1,"""2""",53820,53820
4123,200600,204200,60,53820,1,"""2""",53820,53880
4123,204200,204500,60,53820,1,"""2""",53880,53940
4123,204500,200500,120,53820,1,"""2""",53940,54060
4123,200500,205603,60,53820,1,"""2""",54060,54120
4123,205603,205503,60,53820,1,"""2""",54120,54180
4123,205503,207802,60,53820,1,"""2""",54180,54240
4123,207802,203900,180,53820,1,"""2""",54240,54420
4123,203900,201503,60,53820,1,"""2""",54420,54480
4123,201503,208103,120,53820,1,"""2""",54480,54600
4123,208103,119004,120,53820,1,"""2""",54600,54720
4123,119004,117002,60,53820,1,"""2""",54720,54780
4123,117002,112105,180,53820,1,"""2""",54780,54960
4123,112105,103003,180,53820,1,"""2""",54960,55140
4123,103003,118002,180,53820,1,"""2""",55140,55320
4123,118002,106002,60,53820,1,"""2""",55320,55380
4123,106002,118102,60,53820,1,"""2""",55380,55440
4123,118102,101004,120,53820,1,"""2""",55440,55560
4123,101004,502802,120,53820,1,"""2""",55560,55680
4123,502802,500904,120,53820,1,"""2""",55680,55800
4123,500904,501602,60,53820,1,"""2""",55800,55860
4123,501602,501802,60,53820,1,"""2""",55860,55920
4123,501802,502000,60,53820,1,"""2""",55920,55980
4123,502000,501704,120,53820,1,"""2""",55980,56100
4123,501704,502502,60,53820,1,"""2""",56100,56160
4123,502502,501500,60,53820,1,"""2""",56160,56220
4123,501500,500500,60,53820,1,"""2""",56220,56280
4123,500500,500300,60,53820,1,"""2""",56280,56340
4123,500300,500200,60,53820,1,"""2""",56340,56400
4123,500200,502300,180,53820,1,"""2""",56400,56580
4123,204600,200600,0,54420,1,"""2""",54420,54420
4123,200600,204200,60,54420,1,"""2""",54420,54480
4123,204200,204500,60,54420,1,"""2""",54480,54540
4123,204500,200500,120,54420,1,"""2""",54540,54660
4123,200500,205603,60,54420,1,"""2""",54660,54720
4123,205603,205503,60,54420,1,"""2""",54720,54780
4123,205503,207802,60,54420,1,"""2""",54780,54840
4123,207802,203900,180,54420,1,"""2""",54840,55020
4123,203900,201503,60,54420,1,"""2""",55020,55080
4123,201503,208103,120,54420,1,"""2""",55080,55200
4123,208103,119004,120,54420,1,"""2""",55200,55320
4123,119004,117002,60,54420,1,"""2""",55320,55380
4123,117002,112105,180,54420,1,"""2""",55380,55560
4123,112105,103003,180,54420,1,"""2""",55560,55740
4123,103003,118002,180,54420,1,"""2""",55740,55920
4123,118002,106002,60,54420,1,"""2""",55920,55980
4123,106002,118102,60,54420,1,"""2""",55980,56040
4123,118102,101004,120,54420,1,"""2""",56040,56160
4123,101004,502802,120,54420,1,"""2""",56160,56280
4123,502802,500904,120,54420,1,"""2""",56280,56400
4123,500904,501602,60,54420,1,"""2""",56400,56460
4123,501602,501802,60,54420,1,"""2""",56460,56520
4123,501802,502000,60,54420,1,"""2""",56520,56580
4123,502000,501704,120,54420,1,"""2""",56580,56700
4123,501704,502502,60,54420,1,"""2""",56700,56760
4123,502502,501500,60,54420,1,"""2""",56760,56820
4123,501500,500500,60,54420,1,"""2""",56820,56880
4123,500500,500300,60,54420,1,"""2""",56880,56940
4123,500300,500200,60,54420,1,"""2""",56940,57000
4123,500200,502300,180,54420,1,"""2""",57000,57180
4123,204600,200600,0,55020,1,"""2""",55020,55020
4123,200600,204200,60,55020,1,"""2""",55020,55080
4123,204200,204500,60,55020,1,"""2""",55080,55140
4123,204500,200500,120,55020,1,"""2""",55140,55260
4123,200500,205603,60,55020,1,"""2""",55260,55320
4123,205603,205503,60,55020,1,"""2""",55320,55380
4123,205503,207802,60,55020,1,"""2""",55380,55440
4123,207802,203900,180,55020,1,"""2""",55440,55620
4123,203900,201503,60,55020,1,"""2""",55620,55680
4123,201503,208103,120,55020,1,"""2""",55680,55800
4123,208103,119004,120,55020,1,"""2""",55800,55920
4123,119004,117002,60,55020,1,"""2""",55920,55980
4123,117002,112105,180,55020,1,"""2""",55980,56160
4123,112105,103003,180,55020,1,"""2""",56160,56340
4123,103003,118002,180,55020,1,"""2""",56340,56520
4123,118002,106002,60,55020,1,"""2""",56520,56580
4123,106002,118102,60,55020,1,"""2""",56580,56640
4123,118102,101004,120,55020,1,"""2""",56640,56760
4123,101004,502802,120,55020,1,"""2""",56760,56880
4123,502802,500904,120,55020,1,"""2""",56880,57000
4123,500904,501602,60,55020,1,"""2""",57000,57060
4123,501602,501802,60,55020,1,"""2""",57060,57120
4123,501802,502000,60,55020,1,"""2""",57120,57180
4123,502000,501704,120,55020,1,"""2""",57180,57300
4123,501704,502502,60,55020,1,"""2""",57300,57360
4123,502502,501500,60,55020,1,"""2""",57360,57420
4123,501500,500500,60,55020,1,"""2""",57420,57480
4123,500500,500300,60,55020,1,"""2""",57480,57540
4123,500300,500200,60,55020,1,"""2""",57540,57600
4123,500200,502300,180,55020,1,"""2""",57600,57780
4123,204600,200600,0,55620,1,"""2""",55620,55620
4123,200600,204200,60,55620,1,"""2""",55620,55680
4123,204200,204500,60,55620,1,"""2""",55680,55740
4123,204500,200500,120,55620,1,"""2""",55740,55860
4123,200500,205603,60,55620,1,"""2""",55860,55920
4123,205603,205503,60,55620,1,"""2""",55920,55980
4123,205503,207802,60,55620,1,"""2""",55980,56040
4123,207802,203900,180,55620,1,"""2""",56040,56220
4123,203900,201503,60,55620,1,"""2""",56220,56280
4123,201503,208103,120,55620,1,"""2""",56280,56400
4123,208103,119004,120,55620,1,"""2""",56400,56520
4123,119004,117002,60,55620,1,"""2""",56520,56580
4123,117002,112105,180,55620,1,"""2""",56580,56760
4123,112105,103003,180,55620,1,"""2""",56760,56940
4123,103003,118002,180,55620,1,"""2""",56940,57120
4123,118002,106002,60,55620,1,"""2""",57120,57180
4123,106002,118102,60,55620,1,"""2""",57180,57240
4123,118102,101004,120,55620,1,"""2""",57240,57360
4123,101004,502802,120,55620,1,"""2""",57360,57480
4123,502802,500904,120,55620,1,"""2""",57480,57600
4123,500904,501602,60,55620,1,"""2""",57600,57660
4123,501602,501802,60,55620,1,"""2""",57660,57720
4123,501802,502000,60,55620,1,"""2""",57720,57780
4123,502000,501704,120,55620,1,"""2""",57780,57900
4123,501704,502502,60,55620,1,"""2""",57900,57960
4123,502502,501500,60,55620,1,"""2""",57960,58020
4123,501500,500500,60,55620,1,"""2""",58020,58080
4123,500500,500300,60,55620,1,"""2""",58080,58140
4123,500300,500200,60,55620,1,"""2""",58140,58200
4123,500200,502300,180,55620,1,"""2""",58200,58380
4123,204600,200600,0,56220,1,"""2""",56220,56220
4123,200600,204200,60,56220,1,"""2""",56220,56280
4123,204200,204500,60,56220,1,"""2""",56280,56340
4123,204500,200500,120,56220,1,"""2""",56340,56460
4123,200500,205603,60,56220,1,"""2""",56460,56520
4123,205603,205503,60,56220,1,"""2""",56520,56580
4123,205503,207802,60,56220,1,"""2""",56580,56640
4123,207802,203900,180,56220,1,"""2""",56640,56820
4123,203900,201503,60,56220,1,"""2""",56820,56880
4123,201503,208103,120,56220,1,"""2""",56880,57000
4123,208103,119004,120,56220,1,"""2""",57000,57120
4123,119004,117002,60,56220,1,"""2""",57120,57180
4123,117002,112105,180,56220,1,"""2""",57180,57360
4123,112105,103003,180,56220,1,"""2""",57360,57540
4123,103003,118002,180,56220,1,"""2""",57540,57720
4123,118002,106002,60,56220,1,"""2""",57720,57780
4123,106002,118102,60,56220,1,"""2""",57780,57840
4123,118102,101004,120,56220,1,"""2""",57840,57960
4123,101004,502802,120,56220,1,"""2""",57960,58080
4123,502802,500904,120,56220,1,"""2""",58080,58200
4123,500904,501602,60,56220,1,"""2""",58200,58260
4123,501602,501802,60,56220,1,"""2""",58260,58320
4123,501802,502000,60,56220,1,"""2""",58320,58380
4123,502000,501704,120,56220,1,"""2""",58380,58500
4123,501704,502502,60,56220,1,"""2""",58500,58560
4123,502502,501500,60,56220,1,"""2""",58560,58620
4123,501500,500500,60,56220,1,"""2""",58620,58680
4123,500500,500300,60,56220,1,"""2""",58680,58740
4123,500300,500200,60,56220,1,"""2""",58740,58800
4123,500200,502300,180,56220,1,"""2""",58800,58980
4123,204600,200600,0,56820,1,"""2""",56820,56820
4123,200600,204200,60,56820,1,"""2""",56820,56880
4123,204200,204500,60,56820,1,"""2""",56880,56940
4123,204500,200500,120,56820,1,"""2""",56940,57060
4123,200500,205603,60,56820,1,"""2""",57060,57120
4123,205603,205503,60,56820,1,"""2""",57120,57180
4123,205503,207802,60,56820,1,"""2""",57180,57240
4123,207802,203900,180,56820,1,"""2""",57240,57420
4123,203900,201503,60,56820,1,"""2""",57420,57480
4123,201503,208103,120,56820,1,"""2""",57480,57600
4123,208103,119004,120,56820,1,"""2""",57600,57720
4123,119004,117002,60,56820,1,"""2""",57720,57780
4123,117002,112105,180,56820,1,"""2""",57780,57960
4123,112105,103003,180,56820,1,"""2""",57960,58140
4123,103003,118002,180,56820,1,"""2""",58140,58320
4123,118002,106002,60,56820,1,"""2""",58320,58380
4123,106002,118102,60,56820,1,"""2""",58380,58440
4123,118102,101004,120,56820,1,"""2""",58440,58560
4123,101004,502802,120,56820,1,"""2""",58560,58680
4123,502802,500904,120,56820,1,"""2""",58680,58800
4123,500904,501602,60,56820,1,"""2""",58800,58860
4123,501602,501802,60,56820,1,"""2""",58860,58920
4123,501802,502000,60,56820,1,"""2""",58920,58980
4123,502000,501704,120,56820,1,"""2""",58980,59100
4123,501704,502502,60,56820,1,"""2""",59100,59160
4123,502502,501500,60,56820,1,"""2""",59160,59220
4123,501500,500500,60,56820,1,"""2""",59220,59280
4123,500500,500300,60,56820,1,"""2""",59280,59340
4123,500300,500200,60,56820,1,"""2""",59340,59400
4123,500200,502300,180,56820,1,"""2""",59400,59580
4123,204600,200600,0,57420,1,"""2""",57420,57420
4123,200600,204200,60,57420,1,"""2""",57420,57480
4123,204200,204500,60,57420,1,"""2""",57480,57540
4123,204500,200500,120,57420,1,"""2""",57540,57660
4123,200500,205603,60,57420,1,"""2""",57660,57720
4123,205603,205503,60,57420,1,"""2""",57720,57780
4123,205503,207802,60,57420,1,"""2""",57780,57840
4123,207802,203900,180,57420,1,"""2""",57840,58020
4123,203900,201503,60,57420,1,"""2""",58020,58080
4123,201503,208103,120,57420,1,"""2""",58080,58200
4123,208103,119004,120,57420,1,"""2""",58200,58320
4123,119004,117002,60,57420,1,"""2""",58320,58380
4123,117002,112105,180,57420,1,"""2""",58380,58560
4123,112105,103003,180,57420,1,"""2""",58560,58740
4123,103003,118002,180,57420,1,"""2""",58740,58920
4123,118002,106002,60,57420,1,"""2""",58920,58980
4123,106002,118102,60,57420,1,"""2""",58980,59040
4123,118102,101004,120,57420,1,"""2""",59040,59160
4123,101004,502802,120,57420,1,"""2""",59160,59280
4123,502802,500904,120,57420,1,"""2""",59280,59400
4123,500904,501602,60,57420,1,"""2""",59400,59460
4123,501602,501802,60,57420,1,"""2""",59460,59520
4123,501802,502000,60,57420,1,"""2""",59520,59580
4123,502000,501704,120,57420,1,"""2""",59580,59700
4123,501704,502502,60,57420,1,"""2""",59700,59760
4123,502502,501500,60,57420,1,"""2""",59760,59820
4123,501500,500500,60,57420,1,"""2""",59820,59880
4123,500500,500300,60,57420,1,"""2""",59880,59940
4123,500300,500200,60,57420,1,"""2""",59940,60000
4123,500200,502300,180,57420,1,"""2""",60000,60180
4123,204600,200600,0,58020,1,"""2""",58020,58020
4123,200600,204200,60,58020,1,"""2""",58020,58080
4123,204200,204500,60,58020,1,"""2""",58080,58140
4123,204500,200500,120,58020,1,"""2""",58140,58260
4123,200500,205603,60,58020,1,"""2""",58260,58320
4123,205603,205503,60,58020,1,"""2""",58320,58380
4123,205503,207802,60,58020,1,"""2""",58380,58440
4123,207802,203900,180,58020,1,"""2""",58440,58620
4123,203900,201503,60,58020,1,"""2""",58620,58680
4123,201503,208103,120,58020,1,"""2""",58680,58800
4123,208103,119004,120,58020,1,"""2""",58800,58920
4123,119004,117002,60,58020,1,"""2""",58920,58980
4123,117002,112105,180,58020,1,"""2""",58980,59160
4123,112105,103003,180,58020,1,"""2""",59160,59340
4123,103003,118002,180,58020,1,"""2""",59340,59520
4123,118002,106002,60,58020,1,"""2""",59520,59580
4123,106002,118102,60,58020,1,"""2""",59580,59640
4123,118102,101004,120,58020,1,"""2""",59640,59760
4123,101004,502802,120,58020,1,"""2""",59760,59880
4123,502802,500904,120,58020,1,"""2""",59880,60000
4123,500904,501602,60,58020,1,"""2""",60000,60060
4123,501602,501802,60,58020,1,"""2""",60060,60120
4123,501802,502000,60,58020,1,"""2""",60120,60180
4123,502000,501704,120,58020,1,"""2""",60180,60300
4123,501704,502502,60,58020,1,"""2""",60300,60360
4123,502502,501500,60,58020,1,"""2""",60360,60420
4123,501500,500500,60,58020,1,"""2""",60420,60480
4123,500500,500300,60,58020,1,"""2""",60480,60540
4123,500300,500200,60,58020,1,"""2""",60540,60600
4123,500200,502300,180,58020,1,"""2""",60600,60780
4123,204600,200600,0,58620,1,"""2""",58620,58620
4123,200600,204200,60,58620,1,"""2""",58620,58680
4123,204200,204500,60,58620,1,"""2""",58680,58740
4123,204500,200500,120,58620,1,"""2""",58740,58860
4123,200500,205603,60,58620,1,"""2""",58860,58920
4123,205603,205503,60,58620,1,"""2""",58920,58980
4123,205503,207802,60,58620,1,"""2""",58980,59040
4123,207802,203900,180,58620,1,"""2""",59040,59220
4123,203900,201503,60,58620,1,"""2""",59220,59280
4123,201503,208103,120,58620,1,"""2""",59280,59400
4123,208103,119004,120,58620,1,"""2""",59400,59520
4123,119004,117002,60,58620,1,"""2""",59520,59580
4123,117002,112105,180,58620,1,"""2""",59580,59760
4123,112105,103003,180,58620,1,"""2""",59760,59940
4123,103003,118002,180,58620,1,"""2""",59940,60120
4123,118002,106002,60,58620,1,"""2""",60120,60180
4123,106002,118102,60,58620,1,"""2""",60180,60240
4123,118102,101004,120,58620,1,"""2""",60240,60360
4123,101004,502802,120,58620,1,"""2""",60360,60480
4123,502802,500904,120,58620,1,"""2""",60480,60600
4123,500904,501602,60,58620,1,"""2""",60600,60660
4123,501602,501802,60,58620,1,"""2""",60660,60720
4123,501802,502000,60,58620,1,"""2""",60720,60780
4123,502000,501704,120,58620,1,"""2""",60780,60900
4123,501704,502502,60,58620,1,"""2""",60900,60960
4123,502502,501500,60,58620,1,"""2""",60960,61020
4123,501500,500500,60,58620,1,"""2""",61020,61080
4123,500500,500300,60,58620,1,"""2""",61080,61140
4123,500300,500200,60,58620,1,"""2""",61140,61200
4123,500200,502300,180,58620,1,"""2""",61200,61380
4123,204600,200600,0,59220,1,"""2""",59220,59220
4123,200600,204200,60,59220,1,"""2""",59220,59280
4123,204200,204500,60,59220,1,"""2""",59280,59340
4123,204500,200500,120,59220,1,"""2""",59340,59460
4123,200500,205603,60,59220,1,"""2""",59460,59520
4123,205603,205503,60,59220,1,"""2""",59520,59580
4123,205503,207802,60,59220,1,"""2""",59580,59640
4123,207802,203900,180,59220,1,"""2""",59640,59820
4123,203900,201503,60,59220,1,"""2""",59820,59880
4123,201503,208103,120,59220,1,"""2""",59880,60000
4123,208103,119004,120,59220,1,"""2""",60000,60120
4123,119004,117002,60,59220,1,"""2""",60120,60180
4123,117002,112105,180,59220,1,"""2""",60180,60360
4123,112105,103003,180,59220,1,"""2""",60360,60540
4123,103003,118002,180,59220,1,"""2""",60540,60720
4123,118002,106002,60,59220,1,"""2""",60720,60780
4123,106002,118102,60,59220,1,"""2""",60780,60840
4123,118102,101004,120,59220,1,"""2""",60840,60960
4123,101004,502802,120,59220,1,"""2""",60960,61080
4123,502802,500904,120,59220,1,"""2""",61080,61200
4123,500904,501602,60,59220,1,"""2""",61200,61260
4123,501602,501802,60,59220,1,"""2""",61260,61320
4123,501802,502000,60,59220,1,"""2""",61320,61380
4123,502000,501704,120,59220,1,"""2""",61380,61500
4123,501704,502502,60,59220,1,"""2""",61500,61560
4123,502502,501500,60,59220,1,"""2""",61560,61620
4123,501500,500500,60,59220,1,"""2""",61620,61680
4123,500500,500300,60,59220,1,"""2""",61680,61740
4123,500300,500200,60,59220,1,"""2""",61740,61800
4123,500200,502300,180,59220,1,"""2""",61800,61980
4123,204600,200600,0,59820,1,"""2""",59820,59820
4123,200600,204200,60,59820,1,"""2""",59820,59880
4123,204200,204500,60,59820,1,"""2""",59880,59940
4123,204500,200500,120,59820,1,"""2""",59940,60060
4123,200500,205603,60,59820,1,"""2""",60060,60120
4123,205603,205503,60,59820,1,"""2""",60120,60180
4123,205503,207802,60,59820,1,"""2""",60180,60240
4123,207802,203900,180,59820,1,"""2""",60240,60420
4123,203900,201503,60,59820,1,"""2""",60420,60480
4123,201503,208103,120,59820,1,"""2""",60480,60600
4123,208103,119004,120,59820,1,"""2""",60600,60720
4123,119004,117002,60,59820,1,"""2""",60720,60780
4123,117002,112105,180,59820,1,"""2""",60780,60960
4123,112105,103003,180,59820,1,"""2""",60960,61140
4123,103003,118002,180,59820,1,"""2""",61140,61320
4123,118002,106002,60,59820,1,"""2""",61320,61380
4123,106002,118102,60,59820,1,"""2""",61380,61440
4123,118102,101004,120,59820,1,"""2""",61440,61560
4123,101004,502802,120,59820,1,"""2""",61560,61680
4123,502802,500904,120,59820,1,"""2""",61680,61800
4123,500904,501602,60,59820,1,"""2""",61800,61860
4123,501602,501802,60,59820,1,"""2""",61860,61920
4123,501802,502000,60,59820,1,"""2""",61920,61980
4123,502000,501704,120,59820,1,"""2""",61980,62100
4123,501704,502502,60,59820,1,"""2""",62100,62160
4123,502502,501500,60,59820,1,"""2""",62160,62220
4123,501500,500500,60,59820,1,"""2""",62220,62280
4123,500500,500300,60,59820,1,"""2""",62280,62340
4123,500300,500200,60,59820,1,"""2""",62340,62400
4123,500200,502300,180,59820,1,"""2""",62400,62580
4123,204600,200600,0,60420,1,"""2""",60420,60420
4123,200600,204200,60,60420,1,"""2""",60420,60480
4123,204200,204500,60,60420,1,"""2""",60480,60540
4123,204500,200500,120,60420,1,"""2""",60540,60660
4123,200500,205603,60,60420,1,"""2""",60660,60720
4123,205603,205503,60,60420,1,"""2""",60720,60780
4123,205503,207802,60,60420,1,"""2""",60780,60840
4123,207802,203900,180,60420,1,"""2""",60840,61020
4123,203900,201503,60,60420,1,"""2""",61020,61080
4123,201503,208103,120,60420,1,"""2""",61080,61200
4123,208103,119004,120,60420,1,"""2""",61200,61320
4123,119004,117002,60,60420,1,"""2""",61320,61380
4123,117002,112105,180,60420,1,"""2""",61380,61560
4123,112105,103003,180,60420,1,"""2""",61560,61740
4123,103003,118002,180,60420,1,"""2""",61740,61920
4123,118002,106002,60,60420,1,"""2""",61920,61980
4123,106002,118102,60,60420,1,"""2""",61980,62040
4123,118102,101004,120,60420,1,"""2""",62040,62160
4123,101004,502802,120,60420,1,"""2""",62160,62280
4123,502802,500904,120,60420,1,"""2""",62280,62400
4123,500904,501602,60,60420,1,"""2""",62400,62460
4123,501602,501802,60,60420,1,"""2""",62460,62520
4123,501802,502000,60,60420,1,"""2""",62520,62580
4123,502000,501704,120,60420,1,"""2""",62580,62700
4123,501704,502502,60,60420,1,"""2""",62700,62760
4123,502502,501500,60,60420,1,"""2""",62760,62820
4123,501500,500500,60,60420,1,"""2""",62820,62880
4123,500500,500300,60,60420,1,"""2""",62880,62940
4123,500300,500200,60,60420,1,"""2""",62940,63000
4123,500200,502300,180,60420,1,"""2""",63000,63180
4123,204600,200600,0,61020,1,"""2""",61020,61020
4123,200600,204200,60,61020,1,"""2""",61020,61080
4123,204200,204500,60,61020,1,"""2""",61080,61140
4123,204500,200500,120,61020,1,"""2""",61140,61260
4123,200500,205603,60,61020,1,"""2""",61260,61320
4123,205603,205503,60,61020,1,"""2""",61320,61380
4123,205503,207802,60,61020,1,"""2""",61380,61440
4123,207802,203900,180,61020,1,"""2""",61440,61620
4123,203900,201503,60,61020,1,"""2""",61620,61680
4123,201503,208103,120,61020,1,"""2""",61680,61800
4123,208103,119004,120,61020,1,"""2""",61800,61920
4123,119004,117002,60,61020,1,"""2""",61920,61980
4123,117002,112105,180,61020,1,"""2""",61980,62160
4123,112105,103003,180,61020,1,"""2""",62160,62340
4123,103003,118002,180,61020,1,"""2""",62340,62520
4123,118002,106002,60,61020,1,"""2""",62520,62580
4123,106002,118102,60,61020,1,"""2""",62580,62640
4123,118102,101004,120,61020,1,"""2""",62640,62760
4123,101004,502802,120,61020,1,"""2""",62760,62880
4123,502802,500904,120,61020,1,"""2""",62880,63000
4123,500904,501602,60,61020,1,"""2""",63000,63060
4123,501602,501802,60,61020,1,"""2""",63060,63120
4123,501802,502000,60,61020,1,"""2""",63120,63180
4123,502000,501704,120,61020,1,"""2""",63180,63300
4123,501704,502502,60,61020,1,"""2""",63300,63360
4123,502502,501500,60,61020,1,"""2""",63360,63420
4123,501500,500500,60,61020,1,"""2""",63420,63480
4123,500500,500300,60,61020,1,"""2""",63480,63540
4123,500300,500200,60,61020,1,"""2""",63540,63600
4123,500200,502300,180,61020,1,"""2""",63600,63780
4123,204600,200600,0,61620,1,"""2""",61620,61620
4123,200600,204200,60,61620,1,"""2""",61620,61680
4123,204200,204500,60,61620,1,"""2""",61680,61740
4123,204500,200500,120,61620,1,"""2""",61740,61860
4123,200500,205603,60,61620,1,"""2""",61860,61920
4123,205603,205503,60,61620,1,"""2""",61920,61980
4123,205503,207802,60,61620,1,"""2""",61980,62040
4123,207802,203900,180,61620,1,"""2""",62040,62220
4123,203900,201503,60,61620,1,"""2""",62220,62280
4123,201503,208103,120,61620,1,"""2""",62280,62400
4123,208103,119004,120,61620,1,"""2""",62400,62520
4123,119004,117002,60,61620,1,"""2""",62520,62580
4123,117002,112105,180,61620,1,"""2""",62580,62760
4123,112105,103003,180,61620,1,"""2""",62760,62940
4123,103003,118002,180,61620,1,"""2""",62940,63120
4123,118002,106002,60,61620,1,"""2""",63120,63180
4123,106002,118102,60,61620,1,"""2""",63180,63240
4123,118102,101004,120,61620,1,"""2""",63240,63360
4123,101004,502802,120,61620,1,"""2""",63360,63480
4123,502802,500904,120,61620,1,"""2""",63480,63600
4123,500904,501602,60,61620,1,"""2""",63600,63660
4123,501602,501802,60,61620,1,"""2""",63660,63720
4123,501802,502000,60,61620,1,"""2""",63720,63780
4123,502000,501704,120,61620,1,"""2""",63780,63900
4123,501704,502502,60,61620,1,"""2""",63900,63960
4123,502502,501500,60,61620,1,"""2""",63960,64020
4123,501500,500500,60,61620,1,"""2""",64020,64080
4123,500500,500300,60,61620,1,"""2""",64080,64140
4123,500300,500200,60,61620,1,"""2""",64140,64200
4123,500200,502300,180,61620,1,"""2""",64200,64380
4123,204600,200600,0,62220,1,"""2""",62220,62220
4123,200600,204200,60,62220,1,"""2""",62220,62280
4123,204200,204500,60,62220,1,"""2""",62280,62340
4123,204500,200500,120,62220,1,"""2""",62340,62460
4123,200500,205603,60,62220,1,"""2""",62460,62520
4123,205603,205503,60,62220,1,"""2""",62520,62580
4123,205503,207802,60,62220,1,"""2""",62580,62640
4123,207802,203900,180,62220,1,"""2""",62640,62820
4123,203900,201503,60,62220,1,"""2""",62820,62880
4123,201503,208103,120,62220,1,"""2""",62880,63000
4123,208103,119004,120,62220,1,"""2""",63000,63120
4123,119004,117002,60,62220,1,"""2""",63120,63180
4123,117002,112105,180,62220,1,"""2""",63180,63360
4123,112105,103003,180,62220,1,"""2""",63360,63540
4123,103003,118002,180,62220,1,"""2""",63540,63720
4123,118002,106002,60,62220,1,"""2""",63720,63780
4123,106002,118102,60,62220,1,"""2""",63780,63840
4123,118102,101004,120,62220,1,"""2""",63840,63960
4123,101004,502802,120,62220,1,"""2""",63960,64080
4123,502802,500904,120,62220,1,"""2""",64080,64200
4123,500904,501602,60,62220,1,"""2""",64200,64260
4123,501602,501802,60,62220,1,"""2""",64260,64320
4123,501802,502000,60,62220,1,"""2""",64320,64380
4123,502000,501704,120,62220,1,"""2""",64380,64500
4123,501704,502502,60,62220,1,"""2""",64500,64560
4123,502502,501500,60,62220,1,"""2""",64560,64620
4123,501500,500500,60,62220,1,"""2""",64620,64680
4123,500500,500300,60,62220,1,"""2""",64680,64740
4123,500300,500200,60,62220,1,"""2""",64740,64800
4123,500200,502300,180,62220,1,"""2""",64800,64980
4123,204600,200600,0,62820,1,"""2""",62820,62820
4123,200600,204200,60,62820,1,"""2""",62820,62880
4123,204200,204500,60,62820,1,"""2""",62880,62940
4123,204500,200500,120,62820,1,"""2""",62940,63060
4123,200500,205603,60,62820,1,"""2""",63060,63120
4123,205603,205503,60,62820,1,"""2""",63120,63180
4123,205503,207802,60,62820,1,"""2""",63180,63240
4123,207802,203900,180,62820,1,"""2""",63240,63420
4123,203900,201503,60,62820,1,"""2""",63420,63480
4123,201503,208103,120,62820,1,"""2""",63480,63600
4123,208103,119004,120,62820,1,"""2""",63600,63720
4123,119004,117002,60,62820,1,"""2""",63720,63780
4123,117002,112105,180,62820,1,"""2""",63780,63960
4123,112105,103003,180,62820,1,"""2""",63960,64140
4123,103003,118002,180,62820,1,"""2""",64140,64320
4123,118002,106002,60,62820,1,"""2""",64320,64380
4123,106002,118102,60,62820,1,"""2""",64380,64440
4123,118102,101004,120,62820,1,"""2""",64440,64560
4123,101004,502802,120,62820,1,"""2""",64560,64680
4123,502802,500904,120,62820,1,"""2""",64680,64800
4123,500904,501602,60,62820,1,"""2""",64800,64860
4123,501602,501802,60,62820,1,"""2""",64860,64920
4123,501802,502000,60,62820,1,"""2""",64920,64980
4123,502000,501704,120,62820,1,"""2""",64980,65100
4123,501704,502502,60,62820,1,"""2""",65100,65160
4123,502502,501500,60,62820,1,"""2""",65160,65220
4123,501500,500500,60,62820,1,"""2""",65220,65280
4123,500500,500300,60,62820,1,"""2""",65280,65340
4123,500300,500200,60,62820,1,"""2""",65340,65400
4123,500200,502300,180,62820,1,"""2""",65400,65580
4123,204600,200600,0,63420,1,"""2""",63420,63420
4123,200600,204200,60,63420,1,"""2""",63420,63480
4123,204200,204500,60,63420,1,"""2""",63480,63540
4123,204500,200500,120,63420,1,"""2""",63540,63660
4123,200500,205603,60,63420,1,"""2""",63660,63720
4123,205603,205503,60,63420,1,"""2""",63720,63780
4123,205503,207802,60,63420,1,"""2""",63780,63840
4123,207802,203900,180,63420,1,"""2""",63840,64020
4123,203900,201503,60,63420,1,"""2""",64020,64080
4123,201503,208103,120,63420,1,"""2""",64080,64200
4123,208103,119004,120,63420,1,"""2""",64200,64320
4123,119004,117002,60,63420,1,"""2""",64320,64380
4123,117002,112105,180,63420,1,"""2""",64380,64560
4123,112105,103003,180,63420,1,"""2""",64560,64740
4123,103003,118002,180,63420,1,"""2""",64740,64920
4123,118002,106002,60,63420,1,"""2""",64920,64980
4123,106002,118102,60,63420,1,"""2""",64980,65040
4123,118102,101004,120,63420,1,"""2""",65040,65160
4123,101004,502802,120,63420,1,"""2""",65160,65280
4123,502802,500904,120,63420,1,"""2""",65280,65400
4123,500904,501602,60,63420,1,"""2""",65400,65460
4123,501602,501802,60,63420,1,"""2""",65460,65520
4123,501802,502000,60,63420,1,"""2""",65520,65580
4123,502000,501704,120,63420,1,"""2""",65580,65700
4123,501704,502502,60,63420,1,"""2""",65700,65760
4123,502502,501500,60,63420,1,"""2""",65760,65820
4123,501500,500500,60,63420,1,"""2""",65820,65880
4123,500500,500300,60,63420,1,"""2""",65880,65940
4123,500300,500200,60,63420,1,"""2""",65940,66000
4123,500200,502300,180,63420,1,"""2""",66000,66180
4123,204600,200600,0,64020,1,"""2""",64020,64020
4123,200600,204200,60,64020,1,"""2""",64020,64080
4123,204200,204500,60,64020,1,"""2""",64080,64140
4123,204500,200500,120,64020,1,"""2""",64140,64260
4123,200500,205603,60,64020,1,"""2""",64260,64320
4123,205603,205503,60,64020,1,"""2""",64320,64380
4123,205503,207802,60,64020,1,"""2""",64380,64440
4123,207802,203900,180,64020,1,"""2""",64440,64620
4123,203900,201503,60,64020,1,"""2""",64620,64680
4123,201503,208103,120,64020,1,"""2""",64680,64800
4123,208103,119004,120,64020,1,"""2""",64800,64920
4123,119004,117002,60,64020,1,"""2""",64920,64980
4123,117002,112105,180,64020,1,"""2""",64980,65160
4123,112105,103003,180,64020,1,"""2""",65160,65340
4123,103003,118002,180,64020,1,"""2""",65340,65520
4123,118002,106002,60,64020,1,"""2""",65520,65580
4123,106002,118102,60,64020,1,"""2""",65580,65640
4123,118102,101004,120,64020,1,"""2""",65640,65760
4123,101004,502802,120,64020,1,"""2""",65760,65880
4123,502802,500904,120,64020,1,"""2""",65880,66000
4123,500904,501602,60,64020,1,"""2""",66000,66060
4123,501602,501802,60,64020,1,"""2""",66060,66120
4123,501802,502000,60,64020,1,"""2""",66120,66180
4123,502000,501704,120,64020,1,"""2""",66180,66300
4123,501704,502502,60,64020,1,"""2""",66300,66360
4123,502502,501500,60,64020,1,"""2""",66360,66420
4123,501500,500500,60,64020,1,"""2""",66420,66480
4123,500500,500300,60,64020,1,"""2""",66480,66540
4123,500300,500200,60,64020,1,"""2""",66540,66600
4123,500200,502300,180,64020,1,"""2""",66600,66780
4123,204600,200600,0,64620,1,"""2""",64620,64620
4123,200600,204200,60,64620,1,"""2""",64620,64680
4123,204200,204500,60,64620,1,"""2""",64680,64740
4123,204500,200500,120,64620,1,"""2""",64740,64860
4123,200500,205603,60,64620,1,"""2""",64860,64920
4123,205603,205503,60,64620,1,"""2""",64920,64980
4123,205503,207802,60,64620,1,"""2""",64980,65040
4123,207802,203900,180,64620,1,"""2""",65040,65220
4123,203900,201503,60,64620,1,"""2""",65220,65280
4123,201503,208103,120,64620,1,"""2""",65280,65400
4123,208103,119004,120,64620,1,"""2""",65400,65520
4123,119004,117002,60,64620,1,"""2""",65520,65580
4123,117002,112105,180,64620,1,"""2""",65580,65760
4123,112105,103003,180,64620,1,"""2""",65760,65940
4123,103003,118002,180,64620,1,"""2""",65940,66120
4123,118002,106002,60,64620,1,"""2""",66120,66180
4123,106002,118102,60,64620,1,"""2""",66180,66240
4123,118102,101004,120,64620,1,"""2""",66240,66360
4123,101004,502802,120,64620,1,"""2""",66360,66480
4123,502802,500904,120,64620,1,"""2""",66480,66600
4123,500904,501602,60,64620,1,"""2""",66600,66660
4123,501602,501802,60,64620,1,"""2""",66660,66720
4123,501802,502000,60,64620,1,"""2""",66720,66780
4123,502000,501704,120,64620,1,"""2""",66780,66900
4123,501704,502502,60,64620,1,"""2""",66900,66960
4123,502502,501500,60,64620,1,"""2""",66960,67020
4123,501500,500500,60,64620,1,"""2""",67020,67080
4123,500500,500300,60,64620,1,"""2""",67080,67140
4123,500300,500200,60,64620,1,"""2""",67140,67200
4123,500200,502300,180,64620,1,"""2""",67200,67380
4123,204600,200600,0,65220,1,"""2""",65220,65220
4123,200600,204200,60,65220,1,"""2""",65220,65280
4123,204200,204500,60,65220,1,"""2""",65280,65340
4123,204500,200500,120,65220,1,"""2""",65340,65460
4123,200500,205603,60,65220,1,"""2""",65460,65520
4123,205603,205503,60,65220,1,"""2""",65520,65580
4123,205503,207802,60,65220,1,"""2""",65580,65640
4123,207802,203900,180,65220,1,"""2""",65640,65820
4123,203900,201503,60,65220,1,"""2""",65820,65880
4123,201503,208103,120,65220,1,"""2""",65880,66000
4123,208103,119004,120,65220,1,"""2""",66000,66120
4123,119004,117002,60,65220,1,"""2""",66120,66180
4123,117002,112105,180,65220,1,"""2""",66180,66360
4123,112105,103003,180,65220,1,"""2""",66360,66540
4123,103003,118002,180,65220,1,"""2""",66540,66720
4123,118002,106002,60,65220,1,"""2""",66720,66780
4123,106002,118102,60,65220,1,"""2""",66780,66840
4123,118102,101004,120,65220,1,"""2""",66840,66960
4123,101004,502802,120,65220,1,"""2""",66960,67080
4123,502802,500904,120,65220,1,"""2""",67080,67200
4123,500904,501602,60,65220,1,"""2""",67200,67260
4123,501602,501802,60,65220,1,"""2""",67260,67320
4123,501802,502000,60,65220,1,"""2""",67320,67380
4123,502000,501704,120,65220,1,"""2""",67380,67500
4123,501704,502502,60,65220,1,"""2""",67500,67560
4123,502502,501500,60,65220,1,"""2""",67560,67620
4123,501500,500500,60,65220,1,"""2""",67620,67680
4123,500500,500300,60,65220,1,"""2""",67680,67740
4123,500300,500200,60,65220,1,"""2""",67740,67800
4123,500200,502300,180,65220,1,"""2""",67800,67980
4123,204600,200600,0,65820,1,"""2""",65820,65820
4123,200600,204200,60,65820,1,"""2""",65820,65880
4123,204200,204500,60,65820,1,"""2""",65880,65940
4123,204500,200500,120,65820,1,"""2""",65940,66060
4123,200500,205603,60,65820,1,"""2""",66060,66120
4123,205603,205503,60,65820,1,"""2""",66120,66180
4123,205503,207802,60,65820,1,"""2""",66180,66240
4123,207802,203900,180,65820,1,"""2""",66240,66420
4123,203900,201503,60,65820,1,"""2""",66420,66480
4123,201503,208103,120,65820,1,"""2""",66480,66600
4123,208103,119004,120,65820,1,"""2""",66600,66720
4123,119004,117002,60,65820,1,"""2""",66720,66780
4123,117002,112105,180,65820,1,"""2""",66780,66960
4123,112105,103003,180,65820,1,"""2""",66960,67140
4123,103003,118002,180,65820,1,"""2""",67140,67320
4123,118002,106002,60,65820,1,"""2""",67320,67380
4123,106002,118102,60,65820,1,"""2""",67380,67440
4123,118102,101004,120,65820,1,"""2""",67440,67560
4123,101004,502802,120,65820,1,"""2""",67560,67680
4123,502802,500904,120,65820,1,"""2""",67680,67800
4123,500904,501602,60,65820,1,"""2""",67800,67860
4123,501602,501802,60,65820,1,"""2""",67860,67920
4123,501802,502000,60,65820,1,"""2""",67920,67980
4123,502000,501704,120,65820,1,"""2""",67980,68100
4123,501704,502502,60,65820,1,"""2""",68100,68160
4123,502502,501500,60,65820,1,"""2""",68160,68220
4123,501500,500500,60,65820,1,"""2""",68220,68280
4123,500500,500300,60,65820,1,"""2""",68280,68340
4123,500300,500200,60,65820,1,"""2""",68340,68400
4123,500200,502300,180,65820,1,"""2""",68400,68580
4123,204600,200600,0,66420,1,"""2""",66420,66420
4123,200600,204200,60,66420,1,"""2""",66420,66480
4123,204200,204500,60,66420,1,"""2""",66480,66540
4123,204500,200500,120,66420,1,"""2""",66540,66660
4123,200500,205603,60,66420,1,"""2""",66660,66720
4123,205603,205503,60,66420,1,"""2""",66720,66780
4123,205503,207802,60,66420,1,"""2""",66780,66840
4123,207802,203900,180,66420,1,"""2""",66840,67020
4123,203900,201503,60,66420,1,"""2""",67020,67080
4123,201503,208103,120,66420,1,"""2""",67080,67200
4123,208103,119004,120,66420,1,"""2""",67200,67320
4123,119004,117002,60,66420,1,"""2""",67320,67380
4123,117002,112105,180,66420,1,"""2""",67380,67560
4123,112105,103003,180,66420,1,"""2""",67560,67740
4123,103003,118002,180,66420,1,"""2""",67740,67920
4123,118002,106002,60,66420,1,"""2""",67920,67980
4123,106002,118102,60,66420,1,"""2""",67980,68040
4123,118102,101004,120,66420,1,"""2""",68040,68160
4123,101004,502802,120,66420,1,"""2""",68160,68280
4123,502802,500904,120,66420,1,"""2""",68280,68400
4123,500904,501602,60,66420,1,"""2""",68400,68460
4123,501602,501802,60,66420,1,"""2""",68460,68520
4123,501802,502000,60,66420,1,"""2""",68520,68580
4123,502000,501704,120,66420,1,"""2""",68580,68700
4123,501704,502502,60,66420,1,"""2""",68700,68760
4123,502502,501500,60,66420,1,"""2""",68760,68820
4123,501500,500500,60,66420,1,"""2""",68820,68880
4123,500500,500300,60,66420,1,"""2""",68880,68940
4123,500300,500200,60,66420,1,"""2""",68940,69000
4123,500200,502300,180,66420,1,"""2""",69000,69180
4123,204600,200600,0,67020,1,"""2""",67020,67020
4123,200600,204200,60,67020,1,"""2""",67020,67080
4123,204200,204500,60,67020,1,"""2""",67080,67140
4123,204500,200500,120,67020,1,"""2""",67140,67260
4123,200500,205603,60,67020,1,"""2""",67260,67320
4123,205603,205503,60,67020,1,"""2""",67320,67380
4123,205503,207802,60,67020,1,"""2""",67380,67440
4123,207802,203900,180,67020,1,"""2""",67440,67620
4123,203900,201503,60,67020,1,"""2""",67620,67680
4123,201503,208103,120,67020,1,"""2""",67680,67800
4123,208103,119004,120,67020,1,"""2""",67800,67920
4123,119004,117002,60,67020,1,"""2""",67920,67980
4123,117002,112105,180,67020,1,"""2""",67980,68160
4123,112105,103003,180,67020,1,"""2""",68160,68340
4123,103003,118002,180,67020,1,"""2""",68340,68520
4123,118002,106002,60,67020,1,"""2""",68520,68580
4123,106002,118102,60,67020,1,"""2""",68580,68640
4123,118102,101004,120,67020,1,"""2""",68640,68760
4123,101004,502802,120,67020,1,"""2""",68760,68880
4123,502802,500904,120,67020,1,"""2""",68880,69000
4123,500904,501602,60,67020,1,"""2""",69000,69060
4123,501602,501802,60,67020,1,"""2""",69060,69120
4123,501802,502000,60,67020,1,"""2""",69120,69180
4123,502000,501704,120,67020,1,"""2""",69180,69300
4123,501704,502502,60,67020,1,"""2""",69300,69360
4123,502502,501500,60,67020,1,"""2""",69360,69420
4123,501500,500500,60,67020,1,"""2""",69420,69480
4123,500500,500300,60,67020,1,"""2""",69480,69540
4123,500300,500200,60,67020,1,"""2""",69540,69600
4123,500200,502300,180,67020,1,"""2""",69600,69780
4123,204600,200600,0,67620,1,"""2""",67620,67620
4123,200600,204200,60,67620,1,"""2""",67620,67680
4123,204200,204500,60,67620,1,"""2""",67680,67740
4123,204500,200500,120,67620,1,"""2""",67740,67860
4123,200500,205603,60,67620,1,"""2""",67860,67920
4123,205603,205503,60,67620,1,"""2""",67920,67980
4123,205503,207802,60,67620,1,"""2""",67980,68040
4123,207802,203900,180,67620,1,"""2""",68040,68220
4123,203900,201503,60,67620,1,"""2""",68220,68280
4123,201503,208103,120,67620,1,"""2""",68280,68400
4123,208103,119004,120,67620,1,"""2""",68400,68520
4123,119004,117002,60,67620,1,"""2""",68520,68580
4123,117002,112105,180,67620,1,"""2""",68580,68760
4123,112105,103003,180,67620,1,"""2""",68760,68940
4123,103003,118002,180,67620,1,"""2""",68940,69120
4123,118002,106002,60,67620,1,"""2""",69120,69180
4123,106002,118102,60,67620,1,"""2""",69180,69240
4123,118102,101004,120,67620,1,"""2""",69240,69360
4123,101004,502802,120,67620,1,"""2""",69360,69480
4123,502802,500904,120,67620,1,"""2""",69480,69600
4123,500904,501602,60,67620,1,"""2""",69600,69660
4123,501602,501802,60,67620,1,"""2""",69660,69720
4123,501802,502000,60,67620,1,"""2""",69720,69780
4123,502000,501704,120,67620,1,"""2""",69780,69900
4123,501704,502502,60,67620,1,"""2""",69900,69960
4123,502502,501500,60,67620,1,"""2""",69960,70020
4123,501500,500500,60,67620,1,"""2""",70020,70080
4123,500500,500300,60,67620,1,"""2""",70080,70140
4123,500300,500200,60,67620,1,"""2""",70140,70200
4123,500200,502300,180,67620,1,"""2""",70200,70380
4123,204600,200600,0,68220,1,"""2""",68220,68220
4123,200600,204200,60,68220,1,"""2""",68220,68280
4123,204200,204500,60,68220,1,"""2""",68280,68340
4123,204500,200500,120,68220,1,"""2""",68340,68460
4123,200500,205603,60,68220,1,"""2""",68460,68520
4123,205603,205503,60,68220,1,"""2""",68520,68580
4123,205503,207802,60,68220,1,"""2""",68580,68640
4123,207802,203900,180,68220,1,"""2""",68640,68820
4123,203900,201503,60,68220,1,"""2""",68820,68880
4123,201503,208103,120,68220,1,"""2""",68880,69000
4123,208103,119004,120,68220,1,"""2""",69000,69120
4123,119004,117002,60,68220,1,"""2""",69120,69180
4123,117002,112105,180,68220,1,"""2""",69180,69360
4123,112105,103003,180,68220,1,"""2""",69360,69540
4123,103003,118002,180,68220,1,"""2""",69540,69720
4123,118002,106002,60,68220,1,"""2""",69720,69780
4123,106002,118102,60,68220,1,"""2""",69780,69840
4123,118102,101004,120,68220,1,"""2""",69840,69960
4123,101004,502802,120,68220,1,"""2""",69960,70080
4123,502802,500904,120,68220,1,"""2""",70080,70200
4123,500904,501602,60,68220,1,"""2""",70200,70260
4123,501602,501802,60,68220,1,"""2""",70260,70320
4123,501802,502000,60,68220,1,"""2""",70320,70380
4123,502000,501704,120,68220,1,"""2""",70380,70500
4123,501704,502502,60,68220,1,"""2""",70500,70560
4123,502502,501500,60,68220,1,"""2""",70560,70620
4123,501500,500500,60,68220,1,"""2""",70620,70680
4123,500500,500300,60,68220,1,"""2""",70680,70740
4123,500300,500200,60,68220,1,"""2""",70740,70800
4123,500200,502300,180,68220,1,"""2""",70800,70980
4123,204600,200600,0,68820,1,"""2""",68820,68820
4123,200600,204200,60,68820,1,"""2""",68820,68880
4123,204200,204500,60,68820,1,"""2""",68880,68940
4123,204500,200500,120,68820,1,"""2""",68940,69060
4123,200500,205603,60,68820,1,"""2""",69060,69120
4123,205603,205503,60,68820,1,"""2""",69120,69180
4123,205503,207802,60,68820,1,"""2""",69180,69240
4123,207802,203900,180,68820,1,"""2""",69240,69420
4123,203900,201503,60,68820,1,"""2""",69420,69480
4123,201503,208103,120,68820,1,"""2""",69480,69600
4123,208103,119004,120,68820,1,"""2""",69600,69720
4123,119004,117002,60,68820,1,"""2""",69720,69780
4123,117002,112105,180,68820,1,"""2""",69780,69960
4123,112105,103003,180,68820,1,"""2""",69960,70140
4123,103003,118002,180,68820,1,"""2""",70140,70320
4123,118002,106002,60,68820,1,"""2""",70320,70380
4123,106002,118102,60,68820,1,"""2""",70380,70440
4123,118102,101004,120,68820,1,"""2""",70440,70560
4123,101004,502802,120,68820,1,"""2""",70560,70680
4123,502802,500904,120,68820,1,"""2""",70680,70800
4123,500904,501602,60,68820,1,"""2""",70800,70860
4123,501602,501802,60,68820,1,"""2""",70860,70920
4123,501802,502000,60,68820,1,"""2""",70920,70980
4123,502000,501704,120,68820,1,"""2""",70980,71100
4123,501704,502502,60,68820,1,"""2""",71100,71160
4123,502502,501500,60,68820,1,"""2""",71160,71220
4123,501500,500500,60,68820,1,"""2""",71220,71280
4123,500500,500300,60,68820,1,"""2""",71280,71340
4123,500300,500200,60,68820,1,"""2""",71340,71400
4123,500200,502300,180,68820,1,"""2""",71400,71580
4123,204600,200600,0,69420,1,"""2""",69420,69420
4123,200600,204200,60,69420,1,"""2""",69420,69480
4123,204200,204500,60,69420,1,"""2""",69480,69540
4123,204500,200500,120,69420,1,"""2""",69540,69660
4123,200500,205603,60,69420,1,"""2""",69660,69720
4123,205603,205503,60,69420,1,"""2""",69720,69780
4123,205503,207802,60,69420,1,"""2""",69780,69840
4123,207802,203900,180,69420,1,"""2""",69840,70020
4123,203900,201503,60,69420,1,"""2""",70020,70080
4123,201503,208103,120,69420,1,"""2""",70080,70200
4123,208103,119004,120,69420,1,"""2""",70200,70320
4123,119004,117002,60,69420,1,"""2""",70320,70380
4123,117002,112105,180,69420,1,"""2""",70380,70560
4123,112105,103003,180,69420,1,"""2""",70560,70740
4123,103003,118002,180,69420,1,"""2""",70740,70920
4123,118002,106002,60,69420,1,"""2""",70920,70980
4123,106002,118102,60,69420,1,"""2""",70980,71040
4123,118102,101004,120,69420,1,"""2""",71040,71160
4123,101004,502802,120,69420,1,"""2""",71160,71280
4123,502802,500904,120,69420,1,"""2""",71280,71400
4123,500904,501602,60,69420,1,"""2""",71400,71460
4123,501602,501802,60,69420,1,"""2""",71460,71520
4123,501802,502000,60,69420,1,"""2""",71520,71580
4123,502000,501704,120,69420,1,"""2""",71580,71700
4123,501704,502502,60,69420,1,"""2""",71700,71760
4123,502502,501500,60,69420,1,"""2""",71760,71820
4123,501500,500500,60,69420,1,"""2""",71820,71880
4123,500500,500300,60,69420,1,"""2""",71880,71940
4123,500300,500200,60,69420,1,"""2""",71940,72000
4123,500200,502300,180,69420,1,"""2""",72000,72180
4123,204600,200600,0,69900,1,"""2""",69900,69900
4123,200600,204200,60,69900,1,"""2""",69900,69960
4123,204200,204500,60,69900,1,"""2""",69960,70020
4123,204500,200500,120,69900,1,"""2""",70020,70140
4123,200500,205603,60,69900,1,"""2""",70140,70200
4123,205603,205503,60,69900,1,"""2""",70200,70260
4123,205503,207802,60,69900,1,"""2""",70260,70320
4123,207802,203900,180,69900,1,"""2""",70320,70500
4123,203900,201503,60,69900,1,"""2""",70500,70560
4123,201503,208103,120,69900,1,"""2""",70560,70680
4123,208103,119004,120,69900,1,"""2""",70680,70800
4123,119004,117002,60,69900,1,"""2""",70800,70860
4123,117002,112105,180,69900,1,"""2""",70860,71040
4123,112105,103003,180,69900,1,"""2""",71040,71220
4123,103003,118002,180,69900,1,"""2""",71220,71400
4123,118002,106002,60,69900,1,"""2""",71400,71460
4123,106002,118102,60,69900,1,"""2""",71460,71520
4123,118102,101004,120,69900,1,"""2""",71520,71640
4123,101004,502802,120,69900,1,"""2""",71640,71760
4123,502802,500904,120,69900,1,"""2""",71760,71880
4123,500904,501602,60,69900,1,"""2""",71880,71940
4123,501602,501802,60,69900,1,"""2""",71940,72000
4123,501802,502000,60,69900,1,"""2""",72000,72060
4123,502000,501704,120,69900,1,"""2""",72060,72180
4123,501704,502502,60,69900,1,"""2""",72180,72240
4123,502502,501500,60,69900,1,"""2""",72240,72300
4123,501500,500500,60,69900,1,"""2""",72300,72360
4123,500500,500300,60,69900,1,"""2""",72360,72420
4123,500300,500200,60,69900,1,"""2""",72420,72480
4123,500200,502300,180,69900,1,"""2""",72480,72660
4124,204600,200600,0,20520,1,"""2""",20520,20520
4124,200600,204200,60,20520,1,"""2""",20520,20580
4124,204200,204500,60,20520,1,"""2""",20580,20640
4124,204500,200500,120,20520,1,"""2""",20640,20760
4124,200500,205603,60,20520,1,"""2""",20760,20820
4124,205603,205503,60,20520,1,"""2""",20820,20880
4124,205503,207802,60,20520,1,"""2""",20880,20940
4124,207802,203900,120,20520,1,"""2""",20940,21060
4124,203900,201503,60,20520,1,"""2""",21060,21120
4124,201503,208103,120,20520,1,"""2""",21120,21240
4124,208103,119004,120,20520,1,"""2""",21240,21360
4124,119004,117002,60,20520,1,"""2""",21360,21420
4124,117002,112105,180,20520,1,"""2""",21420,21600
4124,112105,103003,180,20520,1,"""2""",21600,21780
4124,103003,118002,180,20520,1,"""2""",21780,21960
4124,118002,106002,60,20520,1,"""2""",21960,22020
4124,106002,118102,60,20520,1,"""2""",22020,22080
4124,118102,101004,120,20520,1,"""2""",22080,22200
4124,101004,502802,120,20520,1,"""2""",22200,22320
4124,502802,500904,60,20520,1,"""2""",22320,22380
4124,500904,501602,60,20520,1,"""2""",22380,22440
4124,501602,501802,60,20520,1,"""2""",22440,22500
4124,501802,502000,60,20520,1,"""2""",22500,22560
4124,502000,501704,120,20520,1,"""2""",22560,22680
4124,501704,502502,60,20520,1,"""2""",22680,22740
4124,502502,501500,60,20520,1,"""2""",22740,22800
4124,501500,500500,60,20520,1,"""2""",22800,22860
4124,500500,500300,60,20520,1,"""2""",22860,22920
4124,500300,500200,60,20520,1,"""2""",22920,22980
4124,500200,502300,180,20520,1,"""2""",22980,23160
4124,204600,200600,0,21060,1,"""2""",21060,21060
4124,200600,204200,60,21060,1,"""2""",21060,21120
4124,204200,204500,60,21060,1,"""2""",21120,21180
4124,204500,200500,120,21060,1,"""2""",21180,21300
4124,200500,205603,60,21060,1,"""2""",21300,21360
4124,205603,205503,60,21060,1,"""2""",21360,21420
4124,205503,207802,60,21060,1,"""2""",21420,21480
4124,207802,203900,120,21060,1,"""2""",21480,21600
4124,203900,201503,60,21060,1,"""2""",21600,21660
4124,201503,208103,120,21060,1,"""2""",21660,21780
4124,208103,119004,120,21060,1,"""2""",21780,21900
4124,119004,117002,60,21060,1,"""2""",21900,21960
4124,117002,112105,180,21060,1,"""2""",21960,22140
4124,112105,103003,180,21060,1,"""2""",22140,22320
4124,103003,118002,180,21060,1,"""2""",22320,22500
4124,118002,106002,60,21060,1,"""2""",22500,22560
4124,106002,118102,60,21060,1,"""2""",22560,22620
4124,118102,101004,120,21060,1,"""2""",22620,22740
4124,101004,502802,120,21060,1,"""2""",22740,22860
4124,502802,500904,60,21060,1,"""2""",22860,22920
4124,500904,501602,60,21060,1,"""2""",22920,22980
4124,501602,501802,60,21060,1,"""2""",22980,23040
4124,501802,502000,60,21060,1,"""2""",23040,23100
4124,502000,501704,120,21060,1,"""2""",23100,23220
4124,501704,502502,60,21060,1,"""2""",23220,23280
4124,502502,501500,60,21060,1,"""2""",23280,23340
4124,501500,500500,60,21060,1,"""2""",23340,23400
4124,500500,500300,60,21060,1,"""2""",23400,23460
4124,500300,500200,60,21060,1,"""2""",23460,23520
4124,500200,502300,180,21060,1,"""2""",23520,23700
4124,204600,200600,0,21480,1,"""2""",21480,21480
4124,200600,204200,60,21480,1,"""2""",21480,21540
4124,204200,204500,60,21480,1,"""2""",21540,21600
4124,204500,200500,120,21480,1,"""2""",21600,21720
4124,200500,205603,60,21480,1,"""2""",21720,21780
4124,205603,205503,60,21480,1,"""2""",21780,21840
4124,205503,207802,60,21480,1,"""2""",21840,21900
4124,207802,203900,120,21480,1,"""2""",21900,22020
4124,203900,201503,60,21480,1,"""2""",22020,22080
4124,201503,208103,120,21480,1,"""2""",22080,22200
4124,208103,119004,120,21480,1,"""2""",22200,22320
4124,119004,117002,60,21480,1,"""2""",22320,22380
4124,117002,112105,180,21480,1,"""2""",22380,22560
4124,112105,103003,180,21480,1,"""2""",22560,22740
4124,103003,118002,180,21480,1,"""2""",22740,22920
4124,118002,106002,60,21480,1,"""2""",22920,22980
4124,106002,118102,60,21480,1,"""2""",22980,23040
4124,118102,101004,120,21480,1,"""2""",23040,23160
4124,101004,502802,120,21480,1,"""2""",23160,23280
4124,502802,500904,60,21480,1,"""2""",23280,23340
4124,500904,501602,60,21480,1,"""2""",23340,23400
4124,501602,501802,60,21480,1,"""2""",23400,23460
4124,501802,502000,60,21480,1,"""2""",23460,23520
4124,502000,501704,120,21480,1,"""2""",23520,23640
4124,501704,502502,60,21480,1,"""2""",23640,23700
4124,502502,501500,60,21480,1,"""2""",23700,23760
4124,501500,500500,60,21480,1,"""2""",23760,23820
4124,500500,500300,60,21480,1,"""2""",23820,23880
4124,500300,500200,60,21480,1,"""2""",23880,23940
4124,500200,502300,180,21480,1,"""2""",23940,24120
4124,204600,200600,0,22080,1,"""2""",22080,22080
4124,200600,204200,60,22080,1,"""2""",22080,22140
4124,204200,204500,60,22080,1,"""2""",22140,22200
4124,204500,200500,120,22080,1,"""2""",22200,22320
4124,200500,205603,60,22080,1,"""2""",22320,22380
4124,205603,205503,60,22080,1,"""2""",22380,22440
4124,205503,207802,60,22080,1,"""2""",22440,22500
4124,207802,203900,120,22080,1,"""2""",22500,22620
4124,203900,201503,60,22080,1,"""2""",22620,22680
4124,201503,208103,120,22080,1,"""2""",22680,22800
4124,208103,119004,120,22080,1,"""2""",22800,22920
4124,119004,117002,60,22080,1,"""2""",22920,22980
4124,117002,112105,180,22080,1,"""2""",22980,23160
4124,112105,103003,180,22080,1,"""2""",23160,23340
4124,103003,118002,180,22080,1,"""2""",23340,23520
4124,118002,106002,60,22080,1,"""2""",23520,23580
4124,106002,118102,60,22080,1,"""2""",23580,23640
4124,118102,101004,120,22080,1,"""2""",23640,23760
4124,101004,502802,120,22080,1,"""2""",23760,23880
4124,502802,500904,60,22080,1,"""2""",23880,23940
4124,500904,501602,60,22080,1,"""2""",23940,24000
4124,501602,501802,60,22080,1,"""2""",24000,24060
4124,501802,502000,60,22080,1,"""2""",24060,24120
4124,502000,501704,120,22080,1,"""2""",24120,24240
4124,501704,502502,60,22080,1,"""2""",24240,24300
4124,502502,501500,60,22080,1,"""2""",24300,24360
4124,501500,500500,60,22080,1,"""2""",24360,24420
4124,500500,500300,60,22080,1,"""2""",24420,24480
4124,500300,500200,60,22080,1,"""2""",24480,24540
4124,500200,502300,180,22080,1,"""2""",24540,24720
4124,204600,200600,0,22680,1,"""2""",22680,22680
4124,200600,204200,60,22680,1,"""2""",22680,22740
4124,204200,204500,60,22680,1,"""2""",22740,22800
4124,204500,200500,120,22680,1,"""2""",22800,22920
4124,200500,205603,60,22680,1,"""2""",22920,22980
4124,205603,205503,60,22680,1,"""2""",22980,23040
4124,205503,207802,60,22680,1,"""2""",23040,23100
4124,207802,203900,120,22680,1,"""2""",23100,23220
4124,203900,201503,60,22680,1,"""2""",23220,23280
4124,201503,208103,120,22680,1,"""2""",23280,23400
4124,208103,119004,120,22680,1,"""2""",23400,23520
4124,119004,117002,60,22680,1,"""2""",23520,23580
4124,117002,112105,180,22680,1,"""2""",23580,23760
4124,112105,103003,180,22680,1,"""2""",23760,23940
4124,103003,118002,180,22680,1,"""2""",23940,24120
4124,118002,106002,60,22680,1,"""2""",24120,24180
4124,106002,118102,60,22680,1,"""2""",24180,24240
4124,118102,101004,120,22680,1,"""2""",24240,24360
4124,101004,502802,120,22680,1,"""2""",24360,24480
4124,502802,500904,60,22680,1,"""2""",24480,24540
4124,500904,501602,60,22680,1,"""2""",24540,24600
4124,501602,501802,60,22680,1,"""2""",24600,24660
4124,501802,502000,60,22680,1,"""2""",24660,24720
4124,502000,501704,120,22680,1,"""2""",24720,24840
4124,501704,502502,60,22680,1,"""2""",24840,24900
4124,502502,501500,60,22680,1,"""2""",24900,24960
4124,501500,500500,60,22680,1,"""2""",24960,25020
4124,500500,500300,60,22680,1,"""2""",25020,25080
4124,500300,500200,60,22680,1,"""2""",25080,25140
4124,500200,502300,180,22680,1,"""2""",25140,25320
4124,204600,200600,0,23280,1,"""2""",23280,23280
4124,200600,204200,60,23280,1,"""2""",23280,23340
4124,204200,204500,60,23280,1,"""2""",23340,23400
4124,204500,200500,120,23280,1,"""2""",23400,23520
4124,200500,205603,60,23280,1,"""2""",23520,23580
4124,205603,205503,60,23280,1,"""2""",23580,23640
4124,205503,207802,60,23280,1,"""2""",23640,23700
4124,207802,203900,120,23280,1,"""2""",23700,23820
4124,203900,201503,60,23280,1,"""2""",23820,23880
4124,201503,208103,120,23280,1,"""2""",23880,24000
4124,208103,119004,120,23280,1,"""2""",24000,24120
4124,119004,117002,60,23280,1,"""2""",24120,24180
4124,117002,112105,180,23280,1,"""2""",24180,24360
4124,112105,103003,180,23280,1,"""2""",24360,24540
4124,103003,118002,180,23280,1,"""2""",24540,24720
4124,118002,106002,60,23280,1,"""2""",24720,24780
4124,106002,118102,60,23280,1,"""2""",24780,24840
4124,118102,101004,120,23280,1,"""2""",24840,24960
4124,101004,502802,120,23280,1,"""2""",24960,25080
4124,502802,500904,60,23280,1,"""2""",25080,25140
4124,500904,501602,60,23280,1,"""2""",25140,25200
4124,501602,501802,60,23280,1,"""2""",25200,25260
4124,501802,502000,60,23280,1,"""2""",25260,25320
4124,502000,501704,120,23280,1,"""2""",25320,25440
4124,501704,502502,60,23280,1,"""2""",25440,25500
4124,502502,501500,60,23280,1,"""2""",25500,25560
4124,501500,500500,60,23280,1,"""2""",25560,25620
4124,500500,500300,60,23280,1,"""2""",25620,25680
4124,500300,500200,60,23280,1,"""2""",25680,25740
4124,500200,502300,180,23280,1,"""2""",25740,25920
4124,204600,200600,0,23880,1,"""2""",23880,23880
4124,200600,204200,60,23880,1,"""2""",23880,23940
4124,204200,204500,60,23880,1,"""2""",23940,24000
4124,204500,200500,120,23880,1,"""2""",24000,24120
4124,200500,205603,60,23880,1,"""2""",24120,24180
4124,205603,205503,60,23880,1,"""2""",24180,24240
4124,205503,207802,60,23880,1,"""2""",24240,24300
4124,207802,203900,120,23880,1,"""2""",24300,24420
4124,203900,201503,60,23880,1,"""2""",24420,24480
4124,201503,208103,120,23880,1,"""2""",24480,24600
4124,208103,119004,120,23880,1,"""2""",24600,24720
4124,119004,117002,60,23880,1,"""2""",24720,24780
4124,117002,112105,180,23880,1,"""2""",24780,24960
4124,112105,103003,180,23880,1,"""2""",24960,25140
4124,103003,118002,180,23880,1,"""2""",25140,25320
4124,118002,106002,60,23880,1,"""2""",25320,25380
4124,106002,118102,60,23880,1,"""2""",25380,25440
4124,118102,101004,120,23880,1,"""2""",25440,25560
4124,101004,502802,120,23880,1,"""2""",25560,25680
4124,502802,500904,60,23880,1,"""2""",25680,25740
4124,500904,501602,60,23880,1,"""2""",25740,25800
4124,501602,501802,60,23880,1,"""2""",25800,25860
4124,501802,502000,60,23880,1,"""2""",25860,25920
4124,502000,501704,120,23880,1,"""2""",25920,26040
4124,501704,502502,60,23880,1,"""2""",26040,26100
4124,502502,501500,60,23880,1,"""2""",26100,26160
4124,501500,500500,60,23880,1,"""2""",26160,26220
4124,500500,500300,60,23880,1,"""2""",26220,26280
4124,500300,500200,60,23880,1,"""2""",26280,26340
4124,500200,502300,180,23880,1,"""2""",26340,26520
4125,204600,200600,0,19440,1,"""2""",19440,19440
4125,200600,204200,60,19440,1,"""2""",19440,19500
4125,204200,204500,60,19440,1,"""2""",19500,19560
4125,204500,200500,120,19440,1,"""2""",19560,19680
4125,200500,205603,60,19440,1,"""2""",19680,19740
4125,205603,205503,60,19440,1,"""2""",19740,19800
4125,205503,207802,60,19440,1,"""2""",19800,19860
4125,207802,203900,120,19440,1,"""2""",19860,19980
4125,203900,201503,60,19440,1,"""2""",19980,20040
4125,201503,208103,60,19440,1,"""2""",20040,20100
4125,208103,119004,120,19440,1,"""2""",20100,20220
4125,119004,117002,60,19440,1,"""2""",20220,20280
4125,117002,112105,120,19440,1,"""2""",20280,20400
4125,112105,103003,180,19440,1,"""2""",20400,20580
4125,103003,118002,120,19440,1,"""2""",20580,20700
4125,118002,106002,60,19440,1,"""2""",20700,20760
4125,106002,118102,60,19440,1,"""2""",20760,20820
4125,118102,101004,120,19440,1,"""2""",20820,20940
4125,101004,502802,120,19440,1,"""2""",20940,21060
4125,502802,500904,60,19440,1,"""2""",21060,21120
4125,500904,501602,60,19440,1,"""2""",21120,21180
4125,501602,501802,60,19440,1,"""2""",21180,21240
4125,501802,502000,60,19440,1,"""2""",21240,21300
4125,502000,501704,60,19440,1,"""2""",21300,21360
4125,501704,502502,60,19440,1,"""2""",21360,21420
4125,502502,501500,60,19440,1,"""2""",21420,21480
4125,501500,500500,60,19440,1,"""2""",21480,21540
4125,500500,500300,60,19440,1,"""2""",21540,21600
4125,500300,500200,60,19440,1,"""2""",21600,21660
4125,500200,502300,180,19440,1,"""2""",21660,21840
4125,204600,200600,0,20040,1,"""2""",20040,20040
4125,200600,204200,60,20040,1,"""2""",20040,20100
4125,204200,204500,60,20040,1,"""2""",20100,20160
4125,204500,200500,120,20040,1,"""2""",20160,20280
4125,200500,205603,60,20040,1,"""2""",20280,20340
4125,205603,205503,60,20040,1,"""2""",20340,20400
4125,205503,207802,60,20040,1,"""2""",20400,20460
4125,207802,203900,120,20040,1,"""2""",20460,20580
4125,203900,201503,60,20040,1,"""2""",20580,20640
4125,201503,208103,60,20040,1,"""2""",20640,20700
4125,208103,119004,120,20040,1,"""2""",20700,20820
4125,119004,117002,60,20040,1,"""2""",20820,20880
4125,117002,112105,120,20040,1,"""2""",20880,21000
4125,112105,103003,180,20040,1,"""2""",21000,21180
4125,103003,118002,120,20040,1,"""2""",21180,21300
4125,118002,106002,60,20040,1,"""2""",21300,21360
4125,106002,118102,60,20040,1,"""2""",21360,21420
4125,118102,101004,120,20040,1,"""2""",21420,21540
4125,101004,502802,120,20040,1,"""2""",21540,21660
4125,502802,500904,60,20040,1,"""2""",21660,21720
4125,500904,501602,60,20040,1,"""2""",21720,21780
4125,501602,501802,60,20040,1,"""2""",21780,21840
4125,501802,502000,60,20040,1,"""2""",21840,21900
4125,502000,501704,60,20040,1,"""2""",21900,21960
4125,501704,502502,60,20040,1,"""2""",21960,22020
4125,502502,501500,60,20040,1,"""2""",22020,22080
4125,501500,500500,60,20040,1,"""2""",22080,22140
4125,500500,500300,60,20040,1,"""2""",22140,22200
4125,500300,500200,60,20040,1,"""2""",22200,22260
4125,500200,502300,180,20040,1,"""2""",22260,22440
4235,407801,208102,480,47400,3,"""81""",47400,47880
4376,502300,502600,0,70680,1,"""1""",70680,70680
4376,502600,502501,60,70680,1,"""1""",70680,70740
4376,502501,501702,120,70680,1,"""1""",70740,70860
4376,501702,501801,60,70680,1,"""1""",70860,70920
4376,501801,501601,60,70680,1,"""1""",70920,70980
4376,501601,500903,60,70680,1,"""1""",70980,71040
4376,500903,502801,60,70680,1,"""1""",71040,71100
4376,502801,101001,120,70680,1,"""1""",71100,71220
4376,101001,118101,60,70680,1,"""1""",71220,71280
4376,118101,106001,60,70680,1,"""1""",71280,71340
4376,106001,118001,120,70680,1,"""1""",71340,71460
4376,118001,103004,180,70680,1,"""1""",71460,71640
4376,103004,112101,180,70680,1,"""1""",71640,71820
4376,112101,117001,180,70680,1,"""1""",71820,72000
4376,117001,119003,60,70680,1,"""1""",72000,72060
4376,119003,208102,120,70680,1,"""1""",72060,72180
4376,208102,201502,120,70680,1,"""1""",72180,72300
4376,201502,203903,60,70680,1,"""1""",72300,72360
4376,203903,207801,60,70680,1,"""1""",72360,72420
4376,207801,205501,60,70680,1,"""1""",72420,72480
4376,205501,205602,60,70680,1,"""1""",72480,72540
4376,205602,201000,60,70680,1,"""1""",72540,72600
4376,201000,200400,60,70680,1,"""1""",72600,72660
4376,200400,204600,120,70680,1,"""1""",72660,72780
4376,502300,502600,0,71580,1,"""1""",71580,71580
4376,502600,502501,60,71580,1,"""1""",71580,71640
4376,502501,501702,120,71580,1,"""1""",71640,71760
4376,501702,501801,60,71580,1,"""1""",71760,71820
4376,501801,501601,60,71580,1,"""1""",71820,71880
4376,501601,500903,60,71580,1,"""1""",71880,71940
4376,500903,502801,60,71580,1,"""1""",71940,72000
4376,502801,101001,120,71580,1,"""1""",72000,72120
4376,101001,118101,60,71580,1,"""1""",72120,72180
4376,118101,106001,60,71580,1,"""1""",72180,72240
4376,106001,118001,120,71580,1,"""1""",72240,72360
4376,118001,103004,180,71580,1,"""1""",72360,72540
4376,103004,112101,180,71580,1,"""1""",72540,72720
4376,112101,117001,180,71580,1,"""1""",72720,72900
4376,117001,119003,60,71580,1,"""1""",72900,72960
4376,119003,208102,120,71580,1,"""1""",72960,73080
4376,208102,201502,120,71580,1,"""1""",73080,73200
4376,201502,203903,60,71580,1,"""1""",73200,73260
4376,203903,207801,60,71580,1,"""1""",73260,73320
4376,207801,205501,60,71580,1,"""1""",73320,73380
4376,205501,205602,60,71580,1,"""1""",73380,73440
4376,205602,201000,60,71580,1,"""1""",73440,73500
4376,201000,200400,60,71580,1,"""1""",73500,73560
4376,200400,204600,120,71580,1,"""1""",73560,73680
4376,502300,502600,0,72480,1,"""1""",72480,72480
4376,502600,502501,60,72480,1,"""1""",72480,72540
4376,502501,501702,120,72480,1,"""1""",72540,72660
4376,501702,501801,60,72480,1,"""1""",72660,72720
4376,501801,501601,60,72480,1,"""1""",72720,72780
4376,501601,500903,60,72480,1,"""1""",72780,72840
4376,500903,502801,60,72480,1,"""1""",72840,72900
4376,502801,101001,120,72480,1,"""1""",72900,73020
4376,101001,118101,60,72480,1,"""1""",73020,73080
4376,118101,106001,60,72480,1,"""1""",73080,73140
4376,106001,118001,120,72480,1,"""1""",73140,73260
4376,118001,103004,180,72480,1,"""1""",73260,73440
4376,103004,112101,180,72480,1,"""1""",73440,73620
4376,112101,117001,180,72480,1,"""1""",73620,73800
4376,117001,119003,60,72480,1,"""1""",73800,73860
4376,119003,208102,120,72480,1,"""1""",73860,73980
4376,208102,201502,120,72480,1,"""1""",73980,74100
4376,201502,203903,60,72480,1,"""1""",74100,74160
4376,203903,207801,60,72480,1,"""1""",74160,74220
4376,207801,205501,60,72480,1,"""1""",74220,74280
4376,205501,205602,60,72480,1,"""1""",74280,74340
4376,205602,201000,60,72480,1,"""1""",74340,74400
4376,201000,200400,60,72480,1,"""1""",74400,74460
4376,200400,204600,120,72480,1,"""1""",74460,74580
4376,502300,502600,0,74280,1,"""1""",74280,74280
4376,502600,502501,60,74280,1,"""1""",74280,74340
4376,502501,501702,120,74280,1,"""1""",74340,74460
4376,501702,501801,60,74280,1,"""1""",74460,74520
4376,501801,501601,60,74280,1,"""1""",74520,74580
4376,501601,500903,60,74280,1,"""1""",74580,74640
4376,500903,502801,60,74280,1,"""1""",74640,74700
4376,502801,101001,120,74280,1,"""1""",74700,74820
4376,101001,118101,60,74280,1,"""1""",74820,74880
4376,118101,106001,60,74280,1,"""1""",74880,74940
4376,106001,118001,120,74280,1,"""1""",74940,75060
4376,118001,103004,180,74280,1,"""1""",75060,75240
4376,103004,112101,180,74280,1,"""1""",75240,75420
4376,112101,117001,180,74280,1,"""1""",75420,75600
4376,117001,119003,60,74280,1,"""1""",75600,75660
4376,119003,208102,120,74280,1,"""1""",75660,75780
4376,208102,201502,120,74280,1,"""1""",75780,75900
4376,201502,203903,60,74280,1,"""1""",75900,75960
4376,203903,207801,60,74280,1,"""1""",75960,76020
4376,207801,205501,60,74280,1,"""1""",76020,76080
4376,205501,205602,60,74280,1,"""1""",76080,76140
4376,205602,201000,60,74280,1,"""1""",76140,76200
4376,201000,200400,60,74280,1,"""1""",76200,76260
4376,200400,204600,120,74280,1,"""1""",76260,76380
4376,502300,502600,0,76080,1,"""1""",76080,76080
4376,502600,502501,60,76080,1,"""1""",76080,76140
4376,502501,501702,120,76080,1,"""1""",76140,76260
4376,501702,501801,60,76080,1,"""1""",76260,76320
4376,501801,501601,60,76080,1,"""1""",76320,76380
4376,501601,500903,60,76080,1,"""1""",76380,76440
4376,500903,502801,60,76080,1,"""1""",76440,76500
4376,502801,101001,120,76080,1,"""1""",76500,76620
4376,101001,118101,60,76080,1,"""1""",76620,76680
4376,118101,106001,60,76080,1,"""1""",76680,76740
4376,106001,118001,120,76080,1,"""1""",76740,76860
4376,118001,103004,180,76080,1,"""1""",76860,77040
4376,103004,112101,180,76080,1,"""1""",77040,77220
4376,112101,117001,180,76080,1,"""1""",77220,77400
4376,117001,119003,60,76080,1,"""1""",77400,77460
4376,119003,208102,120,76080,1,"""1""",77460,77580
4376,208102,201502,120,76080,1,"""1""",77580,77700
4376,201502,203903,60,76080,1,"""1""",77700,77760
4376,203903,207801,60,76080,1,"""1""",77760,77820
4376,207801,205501,60,76080,1,"""1""",77820,77880
4376,205501,205602,60,76080,1,"""1""",77880,77940
4376,205602,201000,60,76080,1,"""1""",77940,78000
4376,201000,200400,60,76080,1,"""1""",78000,78060
4376,200400,204600,120,76080,1,"""1""",78060,78180
4376,502300,502600,0,77880,1,"""1""",77880,77880
4376,502600,502501,60,77880,1,"""1""",77880,77940
4376,502501,501702,120,77880,1,"""1""",77940,78060
4376,501702,501801,60,77880,1,"""1""",78060,78120
4376,501801,501601,60,77880,1,"""1""",78120,78180
4376,501601,500903,60,77880,1,"""1""",78180,78240
4376,500903,502801,60,77880,1,"""1""",78240,78300
4376,502801,101001,120,77880,1,"""1""",78300,78420
4376,101001,118101,60,77880,1,"""1""",78420,78480
4376,118101,106001,60,77880,1,"""1""",78480,78540
4376,106001,118001,120,77880,1,"""1""",78540,78660
4376,118001,103004,180,77880,1,"""1""",78660,78840
4376,103004,112101,180,77880,1,"""1""",78840,79020
4376,112101,117001,180,77880,1,"""1""",79020,79200
4376,117001,119003,60,77880,1,"""1""",79200,79260
4376,119003,208102,120,77880,1,"""1""",79260,79380
4376,208102,201502,120,77880,1,"""1""",79380,79500
4376,201502,203903,60,77880,1,"""1""",79500,79560
4376,203903,207801,60,77880,1,"""1""",79560,79620
4376,207801,205501,60,77880,1,"""1""",79620,79680
4376,205501,205602,60,77880,1,"""1""",79680,79740
4376,205602,201000,60,77880,1,"""1""",79740,79800
4376,201000,200400,60,77880,1,"""1""",79800,79860
4376,200400,204600,120,77880,1,"""1""",79860,79980
4376,502300,502600,0,79680,1,"""1""",79680,79680
4376,502600,502501,60,79680,1,"""1""",79680,79740
4376,502501,501702,120,79680,1,"""1""",79740,79860
4376,501702,501801,60,79680,1,"""1""",79860,79920
4376,501801,501601,60,79680,1,"""1""",79920,79980
4376,501601,500903,60,79680,1,"""1""",79980,80040
4376,500903,502801,60,79680,1,"""1""",80040,80100
4376,502801,101001,120,79680,1,"""1""",80100,80220
4376,101001,118101,60,79680,1,"""1""",80220,80280
4376,118101,106001,60,79680,1,"""1""",80280,80340
4376,106001,118001,120,79680,1,"""1""",80340,80460
4376,118001,103004,180,79680,1,"""1""",80460,80640
4376,103004,112101,180,79680,1,"""1""",80640,80820
4376,112101,117001,180,79680,1,"""1""",80820,81000
4376,117001,119003,60,79680,1,"""1""",81000,81060
4376,119003,208102,120,79680,1,"""1""",81060,81180
4376,208102,201502,120,79680,1,"""1""",81180,81300
4376,201502,203903,60,79680,1,"""1""",81300,81360
4376,203903,207801,60,79680,1,"""1""",81360,81420
4376,207801,205501,60,79680,1,"""1""",81420,81480
4376,205501,205602,60,79680,1,"""1""",81480,81540
4376,205602,201000,60,79680,1,"""1""",81540,81600
4376,201000,200400,60,79680,1,"""1""",81600,81660
4376,200400,204600,120,79680,1,"""1""",81660,81780
4376,502300,502600,0,81480,1,"""1""",81480,81480
4376,502600,502501,60,81480,1,"""1""",81480,81540
4376,502501,501702,120,81480,1,"""1""",81540,81660
4376,501702,501801,60,81480,1,"""1""",81660,81720
4376,501801,501601,60,81480,1,"""1""",81720,81780
4376,501601,500903,60,81480,1,"""1""",81780,81840
4376,500903,502801,60,81480,1,"""1""",81840,81900
4376,502801,101001,120,81480,1,"""1""",81900,82020
4376,101001,118101,60,81480,1,"""1""",82020,82080
4376,118101,106001,60,81480,1,"""1""",82080,82140
4376,106001,118001,120,81480,1,"""1""",82140,82260
4376,118001,103004,180,81480,1,"""1""",82260,82440
4376,103004,112101,180,81480,1,"""1""",82440,82620
4376,112101,117001,180,81480,1,"""1""",82620,82800
4376,117001,119003,60,81480,1,"""1""",82800,82860
4376,119003,208102,120,81480,1,"""1""",82860,82980
4376,208102,201502,120,81480,1,"""1""",82980,83100
4376,201502,203903,60,81480,1,"""1""",83100,83160
4376,203903,207801,60,81480,1,"""1""",83160,83220
4376,207801,205501,60,81480,1,"""1""",83220,83280
4376,205501,205602,60,81480,1,"""1""",83280,83340
4376,205602,201000,60,81480,1,"""1""",83340,83400
4376,201000,200400,60,81480,1,"""1""",83400,83460
4376,200400,204600,120,81480,1,"""1""",83460,83580
4376,502300,502600,0,83280,1,"""1""",83280,83280
4376,502600,502501,60,83280,1,"""1""",83280,83340
4376,502501,501702,120,83280,1,"""1""",83340,83460
4376,501702,501801,60,83280,1,"""1""",83460,83520
4376,501801,501601,60,83280,1,"""1""",83520,83580
4376,501601,500903,60,83280,1,"""1""",83580,83640
4376,500903,502801,60,83280,1,"""1""",83640,83700
4376,502801,101001,120,83280,1,"""1""",83700,83820
4376,101001,118101,60,83280,1,"""1""",83820,83880
4376,118101,106001,60,83280,1,"""1""",83880,83940
4376,106001,118001,120,83280,1,"""1""",83940,84060
4376,118001,103004,180,83280,1,"""1""",84060,84240
4376,103004,112101,180,83280,1,"""1""",84240,84420
4376,112101,117001,180,83280,1,"""1""",84420,84600
4376,117001,119003,60,83280,1,"""1""",84600,84660
4376,119003,208102,120,83280,1,"""1""",84660,84780
4376,208102,201502,120,83280,1,"""1""",84780,84900
4376,201502,203903,60,83280,1,"""1""",84900,84960
4376,203903,207801,60,83280,1,"""1""",84960,85020
4376,207801,205501,60,83280,1,"""1""",85020,85080
4376,205501,205602,60,83280,1,"""1""",85080,85140
4376,205602,201000,60,83280,1,"""1""",85140,85200
4376,201000,200400,60,83280,1,"""1""",85200,85260
4376,200400,204600,120,83280,1,"""1""",85260,85380
4376,502300,502600,0,85080,1,"""1""",85080,85080
4376,502600,502501,60,85080,1,"""1""",85080,85140
4376,502501,501702,120,85080,1,"""1""",85140,85260
4376,501702,501801,60,85080,1,"""1""",85260,85320
4376,501801,501601,60,85080,1,"""1""",85320,85380
4376,501601,500903,60,85080,1,"""1""",85380,85440
4376,500903,502801,60,85080,1,"""1""",85440,85500
4376,502801,101001,120,85080,1,"""1""",85500,85620
4376,101001,118101,60,85080,1,"""1""",85620,85680
4376,118101,106001,60,85080,1,"""1""",85680,85740
4376,106001,118001,120,85080,1,"""1""",85740,85860
4376,118001,103004,180,85080,1,"""1""",85860,86040
4376,103004,112101,180,85080,1,"""1""",86040,86220
4376,112101,117001,180,85080,1,"""1""",86220,86400
4376,117001,119003,60,85080,1,"""1""",86400,86460
4376,119003,208102,120,85080,1,"""1""",86460,86580
4376,208102,201502,120,85080,1,"""1""",86580,86700
4376,201502,203903,60,85080,1,"""1""",86700,86760
4376,203903,207801,60,85080,1,"""1""",86760,86820
4376,207801,205501,60,85080,1,"""1""",86820,86880
4376,205501,205602,60,85080,1,"""1""",86880,86940
4376,205602,201000,60,85080,1,"""1""",86940,87000
4376,201000,200400,60,85080,1,"""1""",87000,87060
4376,200400,204600,120,85080,1,"""1""",87060,87180
4379,204600,200600,0,70800,1,"""2""",70800,70800
4379,200600,204200,60,70800,1,"""2""",70800,70860
4379,204200,204500,60,70800,1,"""2""",70860,70920
4379,204500,200500,120,70800,1,"""2""",70920,71040
4379,200500,205603,60,70800,1,"""2""",71040,71100
4379,205603,205503,60,70800,1,"""2""",71100,71160
4379,205503,207802,60,70800,1,"""2""",71160,71220
4379,207802,203900,120,70800,1,"""2""",71220,71340
4379,203900,201503,60,70800,1,"""2""",71340,71400
4379,201503,208103,60,70800,1,"""2""",71400,71460
4379,208103,119004,120,70800,1,"""2""",71460,71580
4379,119004,117002,60,70800,1,"""2""",71580,71640
4379,117002,112105,180,70800,1,"""2""",71640,71820
4379,112105,103003,120,70800,1,"""2""",71820,71940
4379,103003,118002,120,70800,1,"""2""",71940,72060
4379,118002,106002,60,70800,1,"""2""",72060,72120
4379,106002,118102,60,70800,1,"""2""",72120,72180
4379,118102,101004,120,70800,1,"""2""",72180,72300
4379,101004,502802,120,70800,1,"""2""",72300,72420
4379,502802,500904,60,70800,1,"""2""",72420,72480
4379,500904,501602,60,70800,1,"""2""",72480,72540
4379,501602,501802,60,70800,1,"""2""",72540,72600
4379,501802,502000,60,70800,1,"""2""",72600,72660
4379,502000,501704,60,70800,1,"""2""",72660,72720
4379,501704,502502,60,70800,1,"""2""",72720,72780
4379,502502,501500,60,70800,1,"""2""",72780,72840
4379,501500,500500,60,70800,1,"""2""",72840,72900
4379,500500,500300,60,70800,1,"""2""",72900,72960
4379,500300,500200,60,70800,1,"""2""",72960,73020
4379,500200,502300,180,70800,1,"""2""",73020,73200
4379,204600,200600,0,71700,1,"""2""",71700,71700
4379,200600,204200,60,71700,1,"""2""",71700,71760
4379,204200,204500,60,71700,1,"""2""",71760,71820
4379,204500,200500,120,71700,1,"""2""",71820,71940
4379,200500,205603,60,71700,1,"""2""",71940,72000
4379,205603,205503,60,71700,1,"""2""",72000,72060
4379,205503,207802,60,71700,1,"""2""",72060,72120
4379,207802,203900,120,71700,1,"""2""",72120,72240
4379,203900,201503,60,71700,1,"""2""",72240,72300
4379,201503,208103,60,71700,1,"""2""",72300,72360
4379,208103,119004,120,71700,1,"""2""",72360,72480
4379,119004,117002,60,71700,1,"""2""",72480,72540
4379,117002,112105,180,71700,1,"""2""",72540,72720
4379,112105,103003,120,71700,1,"""2""",72720,72840
4379,103003,118002,120,71700,1,"""2""",72840,72960
4379,118002,106002,60,71700,1,"""2""",72960,73020
4379,106002,118102,60,71700,1,"""2""",73020,73080
4379,118102,101004,120,71700,1,"""2""",73080,73200
4379,101004,502802,120,71700,1,"""2""",73200,73320
4379,502802,500904,60,71700,1,"""2""",73320,73380
4379,500904,501602,60,71700,1,"""2""",73380,73440
4379,501602,501802,60,71700,1,"""2""",73440,73500
4379,501802,502000,60,71700,1,"""2""",73500,73560
4379,502000,501704,60,71700,1,"""2""",73560,73620
4379,501704,502502,60,71700,1,"""2""",73620,73680
4379,502502,501500,60,71700,1,"""2""",73680,73740
4379,501500,500500,60,71700,1,"""2""",73740,73800
4379,500500,500300,60,71700,1,"""2""",73800,73860
4379,500300,500200,60,71700,1,"""2""",73860,73920
4379,500200,502300,180,71700,1,"""2""",73920,74100
4379,204600,200600,0,72600,1,"""2""",72600,72600
4379,200600,204200,60,72600,1,"""2""",72600,72660
4379,204200,204500,60,72600,1,"""2""",72660,72720
4379,204500,200500,120,72600,1,"""2""",72720,72840
4379,200500,205603,60,72600,1,"""2""",72840,72900
4379,205603,205503,60,72600,1,"""2""",72900,72960
4379,205503,207802,60,72600,1,"""2""",72960,73020
4379,207802,203900,120,72600,1,"""2""",73020,73140
4379,203900,201503,60,72600,1,"""2""",73140,73200
4379,201503,208103,60,72600,1,"""2""",73200,73260
4379,208103,119004,120,72600,1,"""2""",73260,73380
4379,119004,117002,60,72600,1,"""2""",73380,73440
4379,117002,112105,180,72600,1,"""2""",73440,73620
4379,112105,103003,120,72600,1,"""2""",73620,73740
4379,103003,118002,120,72600,1,"""2""",73740,73860
4379,118002,106002,60,72600,1,"""2""",73860,73920
4379,106002,118102,60,72600,1,"""2""",73920,73980
4379,118102,101004,120,72600,1,"""2""",73980,74100
4379,101004,502802,120,72600,1,"""2""",74100,74220
4379,502802,500904,60,72600,1,"""2""",74220,74280
4379,500904,501602,60,72600,1,"""2""",74280,74340
4379,501602,501802,60,72600,1,"""2""",74340,74400
4379,501802,502000,60,72600,1,"""2""",74400,74460
4379,502000,501704,60,72600,1,"""2""",74460,74520
4379,501704,502502,60,72600,1,"""2""",74520,74580
4379,502502,501500,60,72600,1,"""2""",74580,74640
4379,501500,500500,60,72600,1,"""2""",74640,74700
4379,500500,500300,60,72600,1,"""2""",74700,74760
4379,500300,500200,60,72600,1,"""2""",74760,74820
4379,500200,502300,180,72600,1,"""2""",74820,75000
4379,204600,200600,0,74400,1,"""2""",74400,74400
4379,200600,204200,60,74400,1,"""2""",74400,74460
4379,204200,204500,60,74400,1,"""2""",74460,74520
4379,204500,200500,120,74400,1,"""2""",74520,74640
4379,200500,205603,60,74400,1,"""2""",74640,74700
4379,205603,205503,60,74400,1,"""2""",74700,74760
4379,205503,207802,60,74400,1,"""2""",74760,74820
4379,207802,203900,120,74400,1,"""2""",74820,74940
4379,203900,201503,60,74400,1,"""2""",74940,75000
4379,201503,208103,60,74400,1,"""2""",75000,75060
4379,208103,119004,120,74400,1,"""2""",75060,75180
4379,119004,117002,60,74400,1,"""2""",75180,75240
4379,117002,112105,180,74400,1,"""2""",75240,75420
4379,112105,103003,120,74400,1,"""2""",75420,75540
4379,103003,118002,120,74400,1,"""2""",75540,75660
4379,118002,106002,60,74400,1,"""2""",75660,75720
4379,106002,118102,60,74400,1,"""2""",75720,75780
4379,118102,101004,120,74400,1,"""2""",75780,75900
4379,101004,502802,120,74400,1,"""2""",75900,76020
4379,502802,500904,60,74400,1,"""2""",76020,76080
4379,500904,501602,60,74400,1,"""2""",76080,76140
4379,501602,501802,60,74400,1,"""2""",76140,76200
4379,501802,502000,60,74400,1,"""2""",76200,76260
4379,502000,501704,60,74400,1,"""2""",76260,76320
4379,501704,502502,60,74400,1,"""2""",76320,76380
4379,502502,501500,60,74400,1,"""2""",76380,76440
4379,501500,500500,60,74400,1,"""2""",76440,76500
4379,500500,500300,60,74400,1,"""2""",76500,76560
4379,500300,500200,60,74400,1,"""2""",76560,76620
4379,500200,502300,180,74400,1,"""2""",76620,76800
4379,204600,200600,0,76200,1,"""2""",76200,76200
4379,200600,204200,60,76200,1,"""2""",76200,76260
4379,204200,204500,60,76200,1,"""2""",76260,76320
4379,204500,200500,120,76200,1,"""2""",76320,76440
4379,200500,205603,60,76200,1,"""2""",76440,76500
4379,205603,205503,60,76200,1,"""2""",76500,76560
4379,205503,207802,60,76200,1,"""2""",76560,76620
4379,207802,203900,120,76200,1,"""2""",76620,76740
4379,203900,201503,60,76200,1,"""2""",76740,76800
4379,201503,208103,60,76200,1,"""2""",76800,76860
4379,208103,119004,120,76200,1,"""2""",76860,76980
4379,119004,117002,60,76200,1,"""2""",76980,77040
4379,117002,112105,180,76200,1,"""2""",77040,77220
4379,112105,103003,120,76200,1,"""2""",77220,77340
4379,103003,118002,120,76200,1,"""2""",77340,77460
4379,118002,106002,60,76200,1,"""2""",77460,77520
4379,106002,118102,60,76200,1,"""2""",77520,77580
4379,118102,101004,120,76200,1,"""2""",77580,77700
4379,101004,502802,120,76200,1,"""2""",77700,77820
4379,502802,500904,60,76200,1,"""2""",77820,77880
4379,500904,501602,60,76200,1,"""2""",77880,77940
4379,501602,501802,60,76200,1,"""2""",77940,78000
4379,501802,502000,60,76200,1,"""2""",78000,78060
4379,502000,501704,60,76200,1,"""2""",78060,78120
4379,501704,502502,60,76200,1,"""2""",78120,78180
4379,502502,501500,60,76200,1,"""2""",78180,78240
4379,501500,500500,60,76200,1,"""2""",78240,78300
4379,500500,500300,60,76200,1,"""2""",78300,78360
4379,500300,500200,60,76200,1,"""2""",78360,78420
4379,500200,502300,180,76200,1,"""2""",78420,78600
4379,204600,200600,0,78000,1,"""2""",78000,78000
4379,200600,204200,60,78000,1,"""2""",78000,78060
4379,204200,204500,60,78000,1,"""2""",78060,78120
4379,204500,200500,120,78000,1,"""2""",78120,78240
4379,200500,205603,60,78000,1,"""2""",78240,78300
4379,205603,205503,60,78000,1,"""2""",78300,78360
4379,205503,207802,60,78000,1,"""2""",78360,78420
4379,207802,203900,120,78000,1,"""2""",78420,78540
4379,203900,201503,60,78000,1,"""2""",78540,78600
4379,201503,208103,60,78000,1,"""2""",78600,78660
4379,208103,119004,120,78000,1,"""2""",78660,78780
4379,119004,117002,60,78000,1,"""2""",78780,78840
4379,117002,112105,180,78000,1,"""2""",78840,79020
4379,112105,103003,120,78000,1,"""2""",79020,79140
4379,103003,118002,120,78000,1,"""2""",79140,79260
4379,118002,106002,60,78000,1,"""2""",79260,79320
4379,106002,118102,60,78000,1,"""2""",79320,79380
4379,118102,101004,120,78000,1,"""2""",79380,79500
4379,101004,502802,120,78000,1,"""2""",79500,79620
4379,502802,500904,60,78000,1,"""2""",79620,79680
4379,500904,501602,60,78000,1,"""2""",79680,79740
4379,501602,501802,60,78000,1,"""2""",79740,79800
4379,501802,502000,60,78000,1,"""2""",79800,79860
4379,502000,501704,60,78000,1,"""2""",79860,79920
4379,501704,502502,60,78000,1,"""2""",79920,79980
4379,502502,501500,60,78000,1,"""2""",79980,80040
4379,501500,500500,60,78000,1,"""2""",80040,80100
4379,500500,500300,60,78000,1,"""2""",80100,80160
4379,500300,500200,60,78000,1,"""2""",80160,80220
4379,500200,502300,180,78000,1,"""2""",80220,80400
4379,204600,200600,0,79800,1,"""2""",79800,79800
4379,200600,204200,60,79800,1,"""2""",79800,79860
4379,204200,204500,60,79800,1,"""2""",79860,79920
4379,204500,200500,120,79800,1,"""2""",79920,80040
4379,200500,205603,60,79800,1,"""2""",80040,80100
4379,205603,205503,60,79800,1,"""2""",80100,80160
4379,205503,207802,60,79800,1,"""2""",80160,80220
4379,207802,203900,120,79800,1,"""2""",80220,80340
4379,203900,201503,60,79800,1,"""2""",80340,80400
4379,201503,208103,60,79800,1,"""2""",80400,80460
4379,208103,119004,120,79800,1,"""2""",80460,80580
4379,119004,117002,60,79800,1,"""2""",80580,80640
4379,117002,112105,180,79800,1,"""2""",80640,80820
4379,112105,103003,120,79800,1,"""2""",80820,80940
4379,103003,118002,120,79800,1,"""2""",80940,81060
4379,118002,106002,60,79800,1,"""2""",81060,81120
4379,106002,118102,60,79800,1,"""2""",81120,81180
4379,118102,101004,120,79800,1,"""2""",81180,81300
4379,101004,502802,120,79800,1,"""2""",81300,81420
4379,502802,500904,60,79800,1,"""2""",81420,81480
4379,500904,501602,60,79800,1,"""2""",81480,81540
4379,501602,501802,60,79800,1,"""2""",81540,81600
4379,501802,502000,60,79800,1,"""2""",81600,81660
4379,502000,501704,60,79800,1,"""2""",81660,81720
4379,501704,502502,60,79800,1,"""2""",81720,81780
4379,502502,501500,60,79800,1,"""2""",81780,81840
4379,501500,500500,60,79800,1,"""2""",81840,81900
4379,500500,500300,60,79800,1,"""2""",81900,81960
4379,500300,500200,60,79800,1,"""2""",81960,82020
4379,500200,502300,180,79800,1,"""2""",82020,82200
4379,204600,200600,0,81600,1,"""2""",81600,81600
4379,200600,204200,60,81600,1,"""2""",81600,81660
4379,204200,204500,60,81600,1,"""2""",81660,81720
4379,204500,200500,120,81600,1,"""2""",81720,81840
4379,200500,205603,60,81600,1,"""2""",81840,81900
4379,205603,205503,60,81600,1,"""2""",81900,81960
4379,205503,207802,60,81600,1,"""2""",81960,82020
4379,207802,203900,120,81600,1,"""2""",82020,82140
4379,203900,201503,60,81600,1,"""2""",82140,82200
4379,201503,208103,60,81600,1,"""2""",82200,82260
4379,208103,119004,120,81600,1,"""2""",82260,82380
4379,119004,117002,60,81600,1,"""2""",82380,82440
4379,117002,112105,180,81600,1,"""2""",82440,82620
4379,112105,103003,120,81600,1,"""2""",82620,82740
4379,103003,118002,120,81600,1,"""2""",82740,82860
4379,118002,106002,60,81600,1,"""2""",82860,82920
4379,106002,118102,60,81600,1,"""2""",82920,82980
4379,118102,101004,120,81600,1,"""2""",82980,83100
4379,101004,502802,120,81600,1,"""2""",83100,83220
4379,502802,500904,60,81600,1,"""2""",83220,83280
4379,500904,501602,60,81600,1,"""2""",83280,83340
4379,501602,501802,60,81600,1,"""2""",83340,83400
4379,501802,502000,60,81600,1,"""2""",83400,83460
4379,502000,501704,60,81600,1,"""2""",83460,83520
4379,501704,502502,60,81600,1,"""2""",83520,83580
4379,502502,501500,60,81600,1,"""2""",83580,83640
4379,501500,500500,60,81600,1,"""2""",83640,83700
4379,500500,500300,60,81600,1,"""2""",83700,83760
4379,500300,500200,60,81600,1,"""2""",83760,83820
4379,500200,502300,180,81600,1,"""2""",83820,84000
4379,204600,200600,0,83400,1,"""2""",83400,83400
4379,200600,204200,60,83400,1,"""2""",83400,83460
4379,204200,204500,60,83400,1,"""2""",83460,83520
4379,204500,200500,120,83400,1,"""2""",83520,83640
4379,200500,205603,60,83400,1,"""2""",83640,83700
4379,205603,205503,60,83400,1,"""2""",83700,83760
4379,205503,207802,60,83400,1,"""2""",83760,83820
4379,207802,203900,120,83400,1,"""2""",83820,83940
4379,203900,201503,60,83400,1,"""2""",83940,84000
4379,201503,208103,60,83400,1,"""2""",84000,84060
4379,208103,119004,120,83400,1,"""2""",84060,84180
4379,119004,117002,60,83400,1,"""2""",84180,84240
4379,117002,112105,180,83400,1,"""2""",84240,84420
4379,112105,103003,120,83400,1,"""2""",84420,84540
4379,103003,118002,120,83400,1,"""2""",84540,84660
4379,118002,106002,60,83400,1,"""2""",84660,84720
4379,106002,118102,60,83400,1,"""2""",84720,84780
4379,118102,101004,120,83400,1,"""2""",84780,84900
4379,101004,502802,120,83400,1,"""2""",84900,85020
4379,502802,500904,60,83400,1,"""2""",85020,85080
4379,500904,501602,60,83400,1,"""2""",85080,85140
4379,501602,501802,60,83400,1,"""2""",85140,85200
4379,501802,502000,60,83400,1,"""2""",85200,85260
4379,502000,501704,60,83400,1,"""2""",85260,85320
4379,501704,502502,60,83400,1,"""2""",85320,85380
4379,502502,501500,60,83400,1,"""2""",85380,85440
4379,501500,500500,60,83400,1,"""2""",85440,85500
4379,500500,500300,60,83400,1,"""2""",85500,85560
4379,500300,500200,60,83400,1,"""2""",85560,85620
4379,500200,502300,180,83400,1,"""2""",85620,85800
4379,204600,200600,0,85200,1,"""2""",85200,85200
4379,200600,204200,60,85200,1,"""2""",85200,85260
4379,204200,204500,60,85200,1,"""2""",85260,85320
4379,204500,200500,120,85200,1,"""2""",85320,85440
4379,200500,205603,60,85200,1,"""2""",85440,85500
4379,205603,205503,60,85200,1,"""2""",85500,85560
4379,205503,207802,60,85200,1,"""2""",85560,85620
4379,207802,203900,120,85200,1,"""2""",85620,85740
4379,203900,201503,60,85200,1,"""2""",85740,85800
4379,201503,208103,60,85200,1,"""2""",85800,85860
4379,208103,119004,120,85200,1,"""2""",85860,85980
4379,119004,117002,60,85200,1,"""2""",85980,86040
4379,117002,112105,180,85200,1,"""2""",86040,86220
4379,112105,103003,120,85200,1,"""2""",86220,86340
4379,103003,118002,120,85200,1,"""2""",86340,86460
4379,118002,106002,60,85200,1,"""2""",86460,86520
4379,106002,118102,60,85200,1,"""2""",86520,86580
4379,118102,101004,120,85200,1,"""2""",86580,86700
4379,101004,502802,120,85200,1,"""2""",86700,86820
4379,502802,500904,60,85200,1,"""2""",86820,86880
4379,500904,501602,60,85200,1,"""2""",86880,86940
4379,501602,501802,60,85200,1,"""2""",86940,87000
4379,501802,502000,60,85200,1,"""2""",87000,87060
4379,502000,501704,60,85200,1,"""2""",87060,87120
4379,501704,502502,60,85200,1,"""2""",87120,87180
4379,502502,501500,60,85200,1,"""2""",87180,87240
4379,501500,500500,60,85200,1,"""2""",87240,87300
4379,500500,500300,60,85200,1,"""2""",87300,87360
4379,500300,500200,60,85200,1,"""2""",87360,87420
4379,500200,502300,180,85200,1,"""2""",87420,87600
4381,204600,200600,0,85560,1,"""6""",85560,85560
4381,200600,204200,60,85560,1,"""6""",85560,85620
4381,204200,204500,60,85560,1,"""6""",85620,85680
4381,204500,200500,120,85560,1,"""6""",85680,85800
4381,204600,200600,0,87360,1,"""6""",87360,87360
4381,200600,204200,60,87360,1,"""6""",87360,87420
4381,204200,204500,60,87360,1,"""6""",87420,87480
4381,204500,200500,120,87360,1,"""6""",87480,87600
4507,101001,118101,60,21660,4,"""3""",21660,21720
4507,118101,106001,60,21660,4,"""3""",21720,21780
4507,106001,118001,120,21660,4,"""3""",21780,21900
4507,118001,105001,180,21660,4,"""3""",21900,22080
4507,105001,34103,60,21660,4,"""3""",22080,22140
4507,34103,208102,120,21660,4,"""3""",22140,22260
4507,208102,201502,120,21660,4,"""3""",22260,22380
4507,201502,203903,60,21660,4,"""3""",22380,22440
4507,203903,201902,60,21660,4,"""3""",22440,22500
4507,201902,203601,60,21660,4,"""3""",22500,22560
4507,203601,204102,120,21660,4,"""3""",22560,22680
4507,204102,202001,120,21660,4,"""3""",22680,22800
4507,202001,200900,120,21660,4,"""3""",22800,22920
4507,101001,118101,60,22860,4,"""3""",22860,22920
4507,118101,106001,60,22860,4,"""3""",22920,22980
4507,106001,118001,120,22860,4,"""3""",22980,23100
4507,118001,105001,180,22860,4,"""3""",23100,23280
4507,105001,34103,60,22860,4,"""3""",23280,23340
4507,34103,208102,120,22860,4,"""3""",23340,23460
4507,208102,201502,120,22860,4,"""3""",23460,23580
4507,201502,203903,60,22860,4,"""3""",23580,23640
4507,203903,201902,60,22860,4,"""3""",23640,23700
4507,201902,203601,60,22860,4,"""3""",23700,23760
4507,203601,204102,120,22860,4,"""3""",23760,23880
4507,204102,202001,120,22860,4,"""3""",23880,24000
4507,202001,200900,120,22860,4,"""3""",24000,24120
4507,101001,118101,60,24060,4,"""3""",24060,24120
4507,118101,106001,60,24060,4,"""3""",24120,24180
4507,106001,118001,120,24060,4,"""3""",24180,24300
4507,118001,105001,180,24060,4,"""3""",24300,24480
4507,105001,34103,60,24060,4,"""3""",24480,24540
4507,34103,208102,120,24060,4,"""3""",24540,24660
4507,208102,201502,120,24060,4,"""3""",24660,24780
4507,201502,203903,60,24060,4,"""3""",24780,24840
4507,203903,201902,60,24060,4,"""3""",24840,24900
4507,201902,203601,60,24060,4,"""3""",24900,24960
4507,203601,204102,120,24060,4,"""3""",24960,25080
4507,204102,202001,120,24060,4,"""3""",25080,25200
4507,202001,200900,120,24060,4,"""3""",25200,25320
4508,101001,118101,60,72360,4,"""3""",72360,72420
4508,118101,106001,60,72360,4,"""3""",72420,72480
4508,106001,118001,120,72360,4,"""3""",72480,72600
4508,118001,105001,60,72360,4,"""3""",72600,72660
4508,105001,34103,60,72360,4,"""3""",72660,72720
4508,34103,208102,120,72360,4,"""3""",72720,72840
4508,208102,201502,120,72360,4,"""3""",72840,72960
4508,201502,203903,60,72360,4,"""3""",72960,73020
4508,203903,201902,60,72360,4,"""3""",73020,73080
4508,201902,203601,60,72360,4,"""3""",73080,73140
4508,203601,204102,120,72360,4,"""3""",73140,73260
4508,204102,202001,120,72360,4,"""3""",73260,73380
4508,202001,200900,120,72360,4,"""3""",73380,73500
4508,101001,118101,60,74160,4,"""3""",74160,74220
4508,118101,106001,60,74160,4,"""3""",74220,74280
4508,106001,118001,120,74160,4,"""3""",74280,74400
4508,118001,105001,60,74160,4,"""3""",74400,74460
4508,105001,34103,60,74160,4,"""3""",74460,74520
4508,34103,208102,120,74160,4,"""3""",74520,74640
4508,208102,201502,120,74160,4,"""3""",74640,74760
4508,201502,203903,60,74160,4,"""3""",74760,74820
4508,203903,201902,60,74160,4,"""3""",74820,74880
4508,201902,203601,60,74160,4,"""3""",74880,74940
4508,203601,204102,120,74160,4,"""3""",74940,75060
4508,204102,202001,120,74160,4,"""3""",75060,75180
4508,202001,200900,120,74160,4,"""3""",75180,75300
4508,101001,118101,60,75960,4,"""3""",75960,76020
4508,118101,106001,60,75960,4,"""3""",76020,76080
4508,106001,118001,120,75960,4,"""3""",76080,76200
4508,118001,105001,60,75960,4,"""3""",76200,76260
4508,105001,34103,60,75960,4,"""3""",76260,76320
4508,34103,208102,120,75960,4,"""3""",76320,76440
4508,208102,201502,120,75960,4,"""3""",76440,76560
4508,201502,203903,60,75960,4,"""3""",76560,76620
4508,203903,201902,60,75960,4,"""3""",76620,76680
4508,201902,203601,60,75960,4,"""3""",76680,76740
4508,203601,204102,120,75960,4,"""3""",76740,76860
4508,204102,202001,120,75960,4,"""3""",76860,76980
4508,202001,200900,120,75960,4,"""3""",76980,77100
4508,101001,118101,60,77760,4,"""3""",77760,77820
4508,118101,106001,60,77760,4,"""3""",77820,77880
4508,106001,118001,120,77760,4,"""3""",77880,78000
4508,118001,105001,60,77760,4,"""3""",78000,78060
4508,105001,34103,60,77760,4,"""3""",78060,78120
4508,34103,208102,120,77760,4,"""3""",78120,78240
4508,208102,201502,120,77760,4,"""3""",78240,78360
4508,201502,203903,60,77760,4,"""3""",78360,78420
4508,203903,201902,60,77760,4,"""3""",78420,78480
4508,201902,203601,60,77760,4,"""3""",78480,78540
4508,203601,204102,120,77760,4,"""3""",78540,78660
4508,204102,202001,120,77760,4,"""3""",78660,78780
4508,202001,200900,120,77760,4,"""3""",78780,78900
4508,101001,118101,60,79560,4,"""3""",79560,79620
4508,118101,106001,60,79560,4,"""3""",79620,79680
4508,106001,118001,120,79560,4,"""3""",79680,79800
4508,118001,105001,60,79560,4,"""3""",79800,79860
4508,105001,34103,60,79560,4,"""3""",79860,79920
4508,34103,208102,120,79560,4,"""3""",79920,80040
4508,208102,201502,120,79560,4,"""3""",80040,80160
4508,201502,203903,60,79560,4,"""3""",80160,80220
4508,203903,201902,60,79560,4,"""3""",80220,80280
4508,201902,203601,60,79560,4,"""3""",80280,80340
4508,203601,204102,120,79560,4,"""3""",80340,80460
4508,204102,202001,120,79560,4,"""3""",80460,80580
4508,202001,200900,120,79560,4,"""3""",80580,80700
4508,101001,118101,60,81360,4,"""3""",81360,81420
4508,118101,106001,60,81360,4,"""3""",81420,81480
4508,106001,118001,120,81360,4,"""3""",81480,81600
4508,118001,105001,60,81360,4,"""3""",81600,81660
4508,105001,34103,60,81360,4,"""3""",81660,81720
4508,34103,208102,120,81360,4,"""3""",81720,81840
4508,208102,201502,120,81360,4,"""3""",81840,81960
4508,201502,203903,60,81360,4,"""3""",81960,82020
4508,203903,201902,60,81360,4,"""3""",82020,82080
4508,201902,203601,60,81360,4,"""3""",82080,82140
4508,203601,204102,120,81360,4,"""3""",82140,82260
4508,204102,202001,120,81360,4,"""3""",82260,82380
4508,202001,200900,120,81360,4,"""3""",82380,82500
4508,101001,118101,60,83160,4,"""3""",83160,83220
4508,118101,106001,60,83160,4,"""3""",83220,83280
4508,106001,118001,120,83160,4,"""3""",83280,83400
4508,118001,105001,60,83160,4,"""3""",83400,83460
4508,105001,34103,60,83160,4,"""3""",83460,83520
4508,34103,208102,120,83160,4,"""3""",83520,83640
4508,208102,201502,120,83160,4,"""3""",83640,83760
4508,201502,203903,60,83160,4,"""3""",83760,83820
4508,203903,201902,60,83160,4,"""3""",83820,83880
4508,201902,203601,60,83160,4,"""3""",83880,83940
4508,203601,204102,120,83160,4,"""3""",83940,84060
4508,204102,202001,120,83160,4,"""3""",84060,84180
4508,202001,200900,120,83160,4,"""3""",84180,84300
4508,101001,118101,60,84960,4,"""3""",84960,85020
4508,118101,106001,60,84960,4,"""3""",85020,85080
4508,106001,118001,120,84960,4,"""3""",85080,85200
4508,118001,105001,60,84960,4,"""3""",85200,85260
4508,105001,34103,60,84960,4,"""3""",85260,85320
4508,34103,208102,120,84960,4,"""3""",85320,85440
4508,208102,201502,120,84960,4,"""3""",85440,85560
4508,201502,203903,60,84960,4,"""3""",85560,85620
4508,203903,201902,60,84960,4,"""3""",85620,85680
4508,201902,203601,60,84960,4,"""3""",85680,85740
4508,203601,204102,120,84960,4,"""3""",85740,85860
4508,204102,202001,120,84960,4,"""3""",85860,85980
4508,202001,200900,120,84960,4,"""3""",85980,86100
4508,101001,118101,60,86760,4,"""3""",86760,86820
4508,118101,106001,60,86760,4,"""3""",86820,86880
4508,106001,118001,120,86760,4,"""3""",86880,87000
4508,118001,105001,60,86760,4,"""3""",87000,87060
4508,105001,34103,60,86760,4,"""3""",87060,87120
4508,34103,208102,120,86760,4,"""3""",87120,87240
4508,208102,201502,120,86760,4,"""3""",87240,87360
4508,201502,203903,60,86760,4,"""3""",87360,87420
4508,203903,201902,60,86760,4,"""3""",87420,87480
4508,201902,203601,60,86760,4,"""3""",87480,87540
4508,203601,204102,120,86760,4,"""3""",87540,87660
4508,204102,202001,120,86760,4,"""3""",87660,87780
4508,202001,200900,120,86760,4,"""3""",87780,87900
4534,503800,504001,0,70740,6,"""1""",70740,70740
4534,504001,501101,60,70740,6,"""1""",70740,70800
4534,501101,503302,60,70740,6,"""1""",70800,70860
4534,503302,503901,60,70740,6,"""1""",70860,70920
4534,503901,500402,60,70740,6,"""1""",70920,70980
4534,500402,501201,60,70740,6,"""1""",70980,71040
4534,501201,500102,60,70740,6,"""1""",71040,71100
4534,500102,500801,60,70740,6,"""1""",71100,71160
4534,500801,502201,60,70740,6,"""1""",71160,71220
4534,502201,102002,180,70740,6,"""1""",71220,71400
4534,102002,101103,120,70740,6,"""1""",71400,71520
4534,101103,115100,60,70740,6,"""1""",71520,71580
4534,115100,109015,60,70740,6,"""1""",71580,71640
4534,109015,112107,180,70740,6,"""1""",71640,71820
4534,112107,403102,60,70740,6,"""1""",71820,71880
4534,403102,404101,120,70740,6,"""1""",71880,72000
4534,404101,403001,60,70740,6,"""1""",72000,72060
4534,403001,406803,60,70740,6,"""1""",72060,72120
4534,406803,408003,120,70740,6,"""1""",72120,72240
4534,408003,400501,60,70740,6,"""1""",72240,72300
4534,400501,406302,60,70740,6,"""1""",72300,72360
4534,406302,409601,120,70740,6,"""1""",72360,72480
4534,409601,405200,120,70740,6,"""1""",72480,72600
4534,503800,504001,0,72540,6,"""1""",72540,72540
4534,504001,501101,60,72540,6,"""1""",72540,72600
4534,501101,503302,60,72540,6,"""1""",72600,72660
4534,503302,503901,60,72540,6,"""1""",72660,72720
4534,503901,500402,60,72540,6,"""1""",72720,72780
4534,500402,501201,60,72540,6,"""1""",72780,72840
4534,501201,500102,60,72540,6,"""1""",72840,72900
4534,500102,500801,60,72540,6,"""1""",72900,72960
4534,500801,502201,60,72540,6,"""1""",72960,73020
4534,502201,102002,180,72540,6,"""1""",73020,73200
4534,102002,101103,120,72540,6,"""1""",73200,73320
4534,101103,115100,60,72540,6,"""1""",73320,73380
4534,115100,109015,60,72540,6,"""1""",73380,73440
4534,109015,112107,180,72540,6,"""1""",73440,73620
4534,112107,403102,60,72540,6,"""1""",73620,73680
4534,403102,404101,120,72540,6,"""1""",73680,73800
4534,404101,403001,60,72540,6,"""1""",73800,73860
4534,403001,406803,60,72540,6,"""1""",73860,73920
4534,406803,408003,120,72540,6,"""1""",73920,74040
4534,408003,400501,60,72540,6,"""1""",74040,74100
4534,400501,406302,60,72540,6,"""1""",74100,74160
4534,406302,409601,120,72540,6,"""1""",74160,74280
4534,409601,405200,120,72540,6,"""1""",74280,74400
4534,503800,504001,0,74340,6,"""1""",74340,74340
4534,504001,501101,60,74340,6,"""1""",74340,74400
4534,501101,503302,60,74340,6,"""1""",74400,74460
4534,503302,503901,60,74340,6,"""1""",74460,74520
4534,503901,500402,60,74340,6,"""1""",74520,74580
4534,500402,501201,60,74340,6,"""1""",74580,74640
4534,501201,500102,60,74340,6,"""1""",74640,74700
4534,500102,500801,60,74340,6,"""1""",74700,74760
4534,500801,502201,60,74340,6,"""1""",74760,74820
4534,502201,102002,180,74340,6,"""1""",74820,75000
4534,102002,101103,120,74340,6,"""1""",75000,75120
4534,101103,115100,60,74340,6,"""1""",75120,75180
4534,115100,109015,60,74340,6,"""1""",75180,75240
4534,109015,112107,180,74340,6,"""1""",75240,75420
4534,112107,403102,60,74340,6,"""1""",75420,75480
4534,403102,404101,120,74340,6,"""1""",75480,75600
4534,404101,403001,60,74340,6,"""1""",75600,75660
4534,403001,406803,60,74340,6,"""1""",75660,75720
4534,406803,408003,120,74340,6,"""1""",75720,75840
4534,408003,400501,60,74340,6,"""1""",75840,75900
4534,400501,406302,60,74340,6,"""1""",75900,75960
4534,406302,409601,120,74340,6,"""1""",75960,76080
4534,409601,405200,120,74340,6,"""1""",76080,76200
4534,503800,504001,0,76140,6,"""1""",76140,76140
4534,504001,501101,60,76140,6,"""1""",76140,76200
4534,501101,503302,60,76140,6,"""1""",76200,76260
4534,503302,503901,60,76140,6,"""1""",76260,76320
4534,503901,500402,60,76140,6,"""1""",76320,76380
4534,500402,501201,60,76140,6,"""1""",76380,76440
4534,501201,500102,60,76140,6,"""1""",76440,76500
4534,500102,500801,60,76140,6,"""1""",76500,76560
4534,500801,502201,60,76140,6,"""1""",76560,76620
4534,502201,102002,180,76140,6,"""1""",76620,76800
4534,102002,101103,120,76140,6,"""1""",76800,76920
4534,101103,115100,60,76140,6,"""1""",76920,76980
4534,115100,109015,60,76140,6,"""1""",76980,77040
4534,109015,112107,180,76140,6,"""1""",77040,77220
4534,112107,403102,60,76140,6,"""1""",77220,77280
4534,403102,404101,120,76140,6,"""1""",77280,77400
4534,404101,403001,60,76140,6,"""1""",77400,77460
4534,403001,406803,60,76140,6,"""1""",77460,77520
4534,406803,408003,120,76140,6,"""1""",77520,77640
4534,408003,400501,60,76140,6,"""1""",77640,77700
4534,400501,406302,60,76140,6,"""1""",77700,77760
4534,406302,409601,120,76140,6,"""1""",77760,77880
4534,409601,405200,120,76140,6,"""1""",77880,78000
4534,503800,504001,0,77940,6,"""1""",77940,77940
4534,504001,501101,60,77940,6,"""1""",77940,78000
4534,501101,503302,60,77940,6,"""1""",78000,78060
4534,503302,503901,60,77940,6,"""1""",78060,78120
4534,503901,500402,60,77940,6,"""1""",78120,78180
4534,500402,501201,60,77940,6,"""1""",78180,78240
4534,501201,500102,60,77940,6,"""1""",78240,78300
4534,500102,500801,60,77940,6,"""1""",78300,78360
4534,500801,502201,60,77940,6,"""1""",78360,78420
4534,502201,102002,180,77940,6,"""1""",78420,78600
4534,102002,101103,120,77940,6,"""1""",78600,78720
4534,101103,115100,60,77940,6,"""1""",78720,78780
4534,115100,109015,60,77940,6,"""1""",78780,78840
4534,109015,112107,180,77940,6,"""1""",78840,79020
4534,112107,403102,60,77940,6,"""1""",79020,79080
4534,403102,404101,120,77940,6,"""1""",79080,79200
4534,404101,403001,60,77940,6,"""1""",79200,79260
4534,403001,406803,60,77940,6,"""1""",79260,79320
4534,406803,408003,120,77940,6,"""1""",79320,79440
4534,408003,400501,60,77940,6,"""1""",79440,79500
4534,400501,406302,60,77940,6,"""1""",79500,79560
4534,406302,409601,120,77940,6,"""1""",79560,79680
4534,409601,405200,120,77940,6,"""1""",79680,79800
4534,503800,504001,0,79740,6,"""1""",79740,79740
4534,504001,501101,60,79740,6,"""1""",79740,79800
4534,501101,503302,60,79740,6,"""1""",79800,79860
4534,503302,503901,60,79740,6,"""1""",79860,79920
4534,503901,500402,60,79740,6,"""1""",79920,79980
4534,500402,501201,60,79740,6,"""1""",79980,80040
4534,501201,500102,60,79740,6,"""1""",80040,80100
4534,500102,500801,60,79740,6,"""1""",80100,80160
4534,500801,502201,60,79740,6,"""1""",80160,80220
4534,502201,102002,180,79740,6,"""1""",80220,80400
4534,102002,101103,120,79740,6,"""1""",80400,80520
4534,101103,115100,60,79740,6,"""1""",80520,80580
4534,115100,109015,60,79740,6,"""1""",80580,80640
4534,109015,112107,180,79740,6,"""1""",80640,80820
4534,112107,403102,60,79740,6,"""1""",80820,80880
4534,403102,404101,120,79740,6,"""1""",80880,81000
4534,404101,403001,60,79740,6,"""1""",81000,81060
4534,403001,406803,60,79740,6,"""1""",81060,81120
4534,406803,408003,120,79740,6,"""1""",81120,81240
4534,408003,400501,60,79740,6,"""1""",81240,81300
4534,400501,406302,60,79740,6,"""1""",81300,81360
4534,406302,409601,120,79740,6,"""1""",81360,81480
4534,409601,405200,120,79740,6,"""1""",81480,81600
4534,503800,504001,0,81540,6,"""1""",81540,81540
4534,504001,501101,60,81540,6,"""1""",81540,81600
4534,501101,503302,60,81540,6,"""1""",81600,81660
4534,503302,503901,60,81540,6,"""1""",81660,81720
4534,503901,500402,60,81540,6,"""1""",81720,81780
4534,500402,501201,60,81540,6,"""1""",81780,81840
4534,501201,500102,60,81540,6,"""1""",81840,81900
4534,500102,500801,60,81540,6,"""1""",81900,81960
4534,500801,502201,60,81540,6,"""1""",81960,82020
4534,502201,102002,180,81540,6,"""1""",82020,82200
4534,102002,101103,120,81540,6,"""1""",82200,82320
4534,101103,115100,60,81540,6,"""1""",82320,82380
4534,115100,109015,60,81540,6,"""1""",82380,82440
4534,109015,112107,180,81540,6,"""1""",82440,82620
4534,112107,403102,60,81540,6,"""1""",82620,82680
4534,403102,404101,120,81540,6,"""1""",82680,82800
4534,404101,403001,60,81540,6,"""1""",82800,82860
4534,403001,406803,60,81540,6,"""1""",82860,82920
4534,406803,408003,120,81540,6,"""1""",82920,83040
4534,408003,400501,60,81540,6,"""1""",83040,83100
4534,400501,406302,60,81540,6,"""1""",83100,83160
4534,406302,409601,120,81540,6,"""1""",83160,83280
4534,409601,405200,120,81540,6,"""1""",83280,83400
4534,503800,504001,0,83340,6,"""1""",83340,83340
4534,504001,501101,60,83340,6,"""1""",83340,83400
4534,501101,503302,60,83340,6,"""1""",83400,83460
4534,503302,503901,60,83340,6,"""1""",83460,83520
4534,503901,500402,60,83340,6,"""1""",83520,83580
4534,500402,501201,60,83340,6,"""1""",83580,83640
4534,501201,500102,60,83340,6,"""1""",83640,83700
4534,500102,500801,60,83340,6,"""1""",83700,83760
4534,500801,502201,60,83340,6,"""1""",83760,83820
4534,502201,102002,180,83340,6,"""1""",83820,84000
4534,102002,101103,120,83340,6,"""1""",84000,84120
4534,101103,115100,60,83340,6,"""1""",84120,84180
4534,115100,109015,60,83340,6,"""1""",84180,84240
4534,109015,112107,180,83340,6,"""1""",84240,84420
4534,112107,403102,60,83340,6,"""1""",84420,84480
4534,403102,404101,120,83340,6,"""1""",84480,84600
4534,404101,403001,60,83340,6,"""1""",84600,84660
4534,403001,406803,60,83340,6,"""1""",84660,84720
4534,406803,408003,120,83340,6,"""1""",84720,84840
4534,408003,400501,60,83340,6,"""1""",84840,84900
4534,400501,406302,60,83340,6,"""1""",84900,84960
4534,406302,409601,120,83340,6,"""1""",84960,85080
4534,409601,405200,120,83340,6,"""1""",85080,85200
4535,503800,504001,0,85140,6,"""7""",85140,85140
4535,504001,501101,60,85140,6,"""7""",85140,85200
4535,501101,503302,60,85140,6,"""7""",85200,85260
4535,503302,503901,60,85140,6,"""7""",85260,85320
4535,503901,500402,60,85140,6,"""7""",85320,85380
4535,500402,501201,60,85140,6,"""7""",85380,85440
4535,501201,500102,60,85140,6,"""7""",85440,85500
4535,500102,500801,60,85140,6,"""7""",85500,85560
4535,500801,502201,60,85140,6,"""7""",85560,85620
4535,502201,102002,180,85140,6,"""7""",85620,85800
4535,102002,101103,120,85140,6,"""7""",85800,85920
4535,101103,115100,60,85140,6,"""7""",85920,85980
4535,115100,109015,60,85140,6,"""7""",85980,86040
4535,109015,112107,180,85140,6,"""7""",86040,86220
4535,112107,403102,60,85140,6,"""7""",86220,86280
4535,403102,404101,120,85140,6,"""7""",86280,86400
4535,404101,403001,60,85140,6,"""7""",86400,86460
4535,403001,406803,60,85140,6,"""7""",86460,86520
4535,406803,408003,120,85140,6,"""7""",86520,86640
4535,408003,400501,60,85140,6,"""7""",86640,86700
4535,400501,406302,60,85140,6,"""7""",86700,86760
4541,112104,403102,60,52980,204,"""1""",52980,53040
4541,403102,402501,180,52980,204,"""1""",53040,53220
4541,402501,408004,120,52980,204,"""1""",53220,53340
4541,408004,409601,180,52980,204,"""1""",53340,53520
4541,409601,405200,120,52980,204,"""1""",53520,53640
4541,405200,407906,120,52980,204,"""1""",53640,53760
4541,407906,26503,360,52980,204,"""1""",53760,54120
4541,26503,33901,120,52980,204,"""1""",54120,54240
4541,33901,301301,120,52980,204,"""1""",54240,54360
4541,301301,301002,120,52980,204,"""1""",54360,54480
4541,301002,301202,60,52980,204,"""1""",54480,54540
4541,301202,300200,180,52980,204,"""1""",54540,54720
4541,112104,403102,60,54780,204,"""1""",54780,54840
4541,403102,402501,180,54780,204,"""1""",54840,55020
4541,402501,408004,120,54780,204,"""1""",55020,55140
4541,408004,409601,180,54780,204,"""1""",55140,55320
4541,409601,405200,120,54780,204,"""1""",55320,55440
4541,405200,407906,120,54780,204,"""1""",55440,55560
4541,407906,26503,360,54780,204,"""1""",55560,55920
4541,26503,33901,120,54780,204,"""1""",55920,56040
4541,33901,301301,120,54780,204,"""1""",56040,56160
4541,301301,301002,120,54780,204,"""1""",56160,56280
4541,301002,301202,60,54780,204,"""1""",56280,56340
4541,301202,300200,180,54780,204,"""1""",56340,56520
4541,112104,403102,60,56580,204,"""1""",56580,56640
4541,403102,402501,180,56580,204,"""1""",56640,56820
4541,402501,408004,120,56580,204,"""1""",56820,56940
4541,408004,409601,180,56580,204,"""1""",56940,57120
4541,409601,405200,120,56580,204,"""1""",57120,57240
4541,405200,407906,120,56580,204,"""1""",57240,57360
4541,407906,26503,360,56580,204,"""1""",57360,57720
4541,26503,33901,120,56580,204,"""1""",57720,57840
4541,33901,301301,120,56580,204,"""1""",57840,57960
4541,301301,301002,120,56580,204,"""1""",57960,58080
4541,301002,301202,60,56580,204,"""1""",58080,58140
4541,301202,300200,180,56580,204,"""1""",58140,58320
4541,112104,403102,60,57480,204,"""1""",57480,57540
4541,403102,402501,180,57480,204,"""1""",57540,57720
4541,402501,408004,120,57480,204,"""1""",57720,57840
4541,408004,409601,180,57480,204,"""1""",57840,58020
4541,409601,405200,120,57480,204,"""1""",58020,58140
4541,405200,407906,120,57480,204,"""1""",58140,58260
4541,407906,26503,360,57480,204,"""1""",58260,58620
4541,26503,33901,120,57480,204,"""1""",58620,58740
4541,33901,301301,120,57480,204,"""1""",58740,58860
4541,301301,301002,120,57480,204,"""1""",58860,58980
4541,301002,301202,60,57480,204,"""1""",58980,59040
4541,301202,300200,180,57480,204,"""1""",59040,59220
4541,112104,403102,60,58380,204,"""1""",58380,58440
4541,403102,402501,180,58380,204,"""1""",58440,58620
4541,402501,408004,120,58380,204,"""1""",58620,58740
4541,408004,409601,180,58380,204,"""1""",58740,58920
4541,409601,405200,120,58380,204,"""1""",58920,59040
4541,405200,407906,120,58380,204,"""1""",59040,59160
4541,407906,26503,360,58380,204,"""1""",59160,59520
4541,26503,33901,120,58380,204,"""1""",59520,59640
4541,33901,301301,120,58380,204,"""1""",59640,59760
4541,301301,301002,120,58380,204,"""1""",59760,59880
4541,301002,301202,60,58380,204,"""1""",59880,59940
4541,301202,300200,180,58380,204,"""1""",59940,60120
4541,112104,403102,60,59280,204,"""1""",59280,59340
4541,403102,402501,180,59280,204,"""1""",59340,59520
4541,402501,408004,120,59280,204,"""1""",59520,59640
4541,408004,409601,180,59280,204,"""1""",59640,59820
4541,409601,405200,120,59280,204,"""1""",59820,59940
4541,405200,407906,120,59280,204,"""1""",59940,60060
4541,407906,26503,360,59280,204,"""1""",60060,60420
4541,26503,33901,120,59280,204,"""1""",60420,60540
4541,33901,301301,120,59280,204,"""1""",60540,60660
4541,301301,301002,120,59280,204,"""1""",60660,60780
4541,301002,301202,60,59280,204,"""1""",60780,60840
4541,301202,300200,180,59280,204,"""1""",60840,61020
4541,112104,403102,60,60180,204,"""1""",60180,60240
4541,403102,402501,180,60180,204,"""1""",60240,60420
4541,402501,408004,120,60180,204,"""1""",60420,60540
4541,408004,409601,180,60180,204,"""1""",60540,60720
4541,409601,405200,120,60180,204,"""1""",60720,60840
4541,405200,407906,120,60180,204,"""1""",60840,60960
4541,407906,26503,360,60180,204,"""1""",60960,61320
4541,26503,33901,120,60180,204,"""1""",61320,61440
4541,33901,301301,120,60180,204,"""1""",61440,61560
4541,301301,301002,120,60180,204,"""1""",61560,61680
4541,301002,301202,60,60180,204,"""1""",61680,61740
4541,301202,300200,180,60180,204,"""1""",61740,61920
4541,112104,403102,60,61980,204,"""1""",61980,62040
4541,403102,402501,180,61980,204,"""1""",62040,62220
4541,402501,408004,120,61980,204,"""1""",62220,62340
4541,408004,409601,180,61980,204,"""1""",62340,62520
4541,409601,405200,120,61980,204,"""1""",62520,62640
4541,405200,407906,120,61980,204,"""1""",62640,62760
4541,407906,26503,360,61980,204,"""1""",62760,63120
4541,26503,33901,120,61980,204,"""1""",63120,63240
4541,33901,301301,120,61980,204,"""1""",63240,63360
4541,301301,301002,120,61980,204,"""1""",63360,63480
4541,301002,301202,60,61980,204,"""1""",63480,63540
4541,301202,300200,180,61980,204,"""1""",63540,63720
4541,112104,403102,60,63780,204,"""1""",63780,63840
4541,403102,402501,180,63780,204,"""1""",63840,64020
4541,402501,408004,120,63780,204,"""1""",64020,64140
4541,408004,409601,180,63780,204,"""1""",64140,64320
4541,409601,405200,120,63780,204,"""1""",64320,64440
4541,405200,407906,120,63780,204,"""1""",64440,64560
4541,407906,26503,360,63780,204,"""1""",64560,64920
4541,26503,33901,120,63780,204,"""1""",64920,65040
4541,33901,301301,120,63780,204,"""1""",65040,65160
4541,301301,301002,120,63780,204,"""1""",65160,65280
4541,301002,301202,60,63780,204,"""1""",65280,65340
4541,301202,300200,180,63780,204,"""1""",65340,65520
4541,112104,403102,60,65580,204,"""1""",65580,65640
4541,403102,402501,180,65580,204,"""1""",65640,65820
4541,402501,408004,120,65580,204,"""1""",65820,65940
4541,408004,409601,180,65580,204,"""1""",65940,66120
4541,409601,405200,120,65580,204,"""1""",66120,66240
4541,405200,407906,120,65580,204,"""1""",66240,66360
4541,407906,26503,360,65580,204,"""1""",66360,66720
4541,26503,33901,120,65580,204,"""1""",66720,66840
4541,33901,301301,120,65580,204,"""1""",66840,66960
4541,301301,301002,120,65580,204,"""1""",66960,67080
4541,301002,301202,60,65580,204,"""1""",67080,67140
4541,301202,300200,180,65580,204,"""1""",67140,67320
4545,112107,403102,60,26520,206,"""3""",26520,26580
4545,403102,404101,120,26520,206,"""3""",26580,26700
4545,404101,408101,240,26520,206,"""3""",26700,26940
4545,408101,409601,180,26520,206,"""3""",26940,27120
4545,409601,405200,120,26520,206,"""3""",27120,27240
4545,112107,403102,60,27720,206,"""3""",27720,27780
4545,403102,404101,120,27720,206,"""3""",27780,27900
4545,404101,408101,240,27720,206,"""3""",27900,28140
4545,408101,409601,180,27720,206,"""3""",28140,28320
4545,409601,405200,120,27720,206,"""3""",28320,28440
4545,112107,403102,60,28920,206,"""3""",28920,28980
4545,403102,404101,120,28920,206,"""3""",28980,29100
4545,404101,408101,240,28920,206,"""3""",29100,29340
4545,408101,409601,180,28920,206,"""3""",29340,29520
4545,409601,405200,120,28920,206,"""3""",29520,29640
4545,112107,403102,60,30120,206,"""3""",30120,30180
4545,403102,404101,120,30120,206,"""3""",30180,30300
4545,404101,408101,240,30120,206,"""3""",30300,30540
4545,408101,409601,180,30120,206,"""3""",30540,30720
4545,409601,405200,120,30120,206,"""3""",30720,30840
4545,112107,403102,60,31320,206,"""3""",31320,31380
4545,403102,404101,120,31320,206,"""3""",31380,31500
4545,404101,408101,240,31320,206,"""3""",31500,31740
4545,408101,409601,180,31320,206,"""3""",31740,31920
4545,409601,405200,120,31320,206,"""3""",31920,32040
4557,300200,300101,60,35460,79,"""1""",35460,35520
4557,300101,301302,180,35460,79,"""1""",35520,35700
4557,301302,301401,60,35460,79,"""1""",35700,35760
4557,301401,300902,180,35460,79,"""1""",35760,35940
4557,300902,209902,120,35460,79,"""1""",35940,36060
4557,209902,400704,180,35460,79,"""1""",36060,36240
4557,400704,408503,60,35460,79,"""1""",36240,36300
4557,408503,405602,60,35460,79,"""1""",36300,36360
4557,405602,407102,60,35460,79,"""1""",36360,36420
4557,407102,404202,60,35460,79,"""1""",36420,36480
4557,404202,117000,60,35460,79,"""1""",36480,36540
4557,117000,112104,180,35460,79,"""1""",36540,36720
4557,300200,300101,60,39060,79,"""1""",39060,39120
4557,300101,301302,180,39060,79,"""1""",39120,39300
4557,301302,301401,60,39060,79,"""1""",39300,39360
4557,301401,300902,180,39060,79,"""1""",39360,39540
4557,300902,209902,120,39060,79,"""1""",39540,39660
4557,209902,400704,180,39060,79,"""1""",39660,39840
4557,400704,408503,60,39060,79,"""1""",39840,39900
4557,408503,405602,60,39060,79,"""1""",39900,39960
4557,405602,407102,60,39060,79,"""1""",39960,40020
4557,407102,404202,60,39060,79,"""1""",40020,40080
4557,404202,117000,60,39060,79,"""1""",40080,40140
4557,117000,112104,180,39060,79,"""1""",40140,40320
4557,300200,300101,60,42660,79,"""1""",42660,42720
4557,300101,301302,180,42660,79,"""1""",42720,42900
4557,301302,301401,60,42660,79,"""1""",42900,42960
4557,301401,300902,180,42660,79,"""1""",42960,43140
4557,300902,209902,120,42660,79,"""1""",43140,43260
4557,209902,400704,180,42660,79,"""1""",43260,43440
4557,400704,408503,60,42660,79,"""1""",43440,43500
4557,408503,405602,60,42660,79,"""1""",43500,43560
4557,405602,407102,60,42660,79,"""1""",43560,43620
4557,407102,404202,60,42660,79,"""1""",43620,43680
4557,404202,117000,60,42660,79,"""1""",43680,43740
4557,117000,112104,180,42660,79,"""1""",43740,43920
4557,300200,300101,60,46260,79,"""1""",46260,46320
4557,300101,301302,180,46260,79,"""1""",46320,46500
4557,301302,301401,60,46260,79,"""1""",46500,46560
4557,301401,300902,180,46260,79,"""1""",46560,46740
4557,300902,209902,120,46260,79,"""1""",46740,46860
4557,209902,400704,180,46260,79,"""1""",46860,47040
4557,400704,408503,60,46260,79,"""1""",47040,47100
4557,408503,405602,60,46260,79,"""1""",47100,47160
4557,405602,407102,60,46260,79,"""1""",47160,47220
4557,407102,404202,60,46260,79,"""1""",47220,47280
4557,404202,117000,60,46260,79,"""1""",47280,47340
4557,117000,112104,180,46260,79,"""1""",47340,47520
4557,300200,300101,60,49860,79,"""1""",49860,49920
4557,300101,301302,180,49860,79,"""1""",49920,50100
4557,301302,301401,60,49860,79,"""1""",50100,50160
4557,301401,300902,180,49860,79,"""1""",50160,50340
4557,300902,209902,120,49860,79,"""1""",50340,50460
4557,209902,400704,180,49860,79,"""1""",50460,50640
4557,400704,408503,60,49860,79,"""1""",50640,50700
4557,408503,405602,60,49860,79,"""1""",50700,50760
4557,405602,407102,60,49860,79,"""1""",50760,50820
4557,407102,404202,60,49860,79,"""1""",50820,50880
4557,404202,117000,60,49860,79,"""1""",50880,50940
4557,117000,112104,180,49860,79,"""1""",50940,51120
4557,300200,300101,60,53460,79,"""1""",53460,53520
4557,300101,301302,180,53460,79,"""1""",53520,53700
4557,301302,301401,60,53460,79,"""1""",53700,53760
4557,301401,300902,180,53460,79,"""1""",53760,53940
4557,300902,209902,120,53460,79,"""1""",53940,54060
4557,209902,400704,180,53460,79,"""1""",54060,54240
4557,400704,408503,60,53460,79,"""1""",54240,54300
4557,408503,405602,60,53460,79,"""1""",54300,54360
4557,405602,407102,60,53460,79,"""1""",54360,54420
4557,407102,404202,60,53460,79,"""1""",54420,54480
4557,404202,117000,60,53460,79,"""1""",54480,54540
4557,117000,112104,180,53460,79,"""1""",54540,54720
4557,300200,300101,60,55860,79,"""1""",55860,55920
4557,300101,301302,180,55860,79,"""1""",55920,56100
4557,301302,301401,60,55860,79,"""1""",56100,56160
4557,301401,300902,180,55860,79,"""1""",56160,56340
4557,300902,209902,120,55860,79,"""1""",56340,56460
4557,209902,400704,180,55860,79,"""1""",56460,56640
4557,400704,408503,60,55860,79,"""1""",56640,56700
4557,408503,405602,60,55860,79,"""1""",56700,56760
4557,405602,407102,60,55860,79,"""1""",56760,56820
4557,407102,404202,60,55860,79,"""1""",56820,56880
4557,404202,117000,60,55860,79,"""1""",56880,56940
4557,117000,112104,180,55860,79,"""1""",56940,57120
4557,300200,300101,60,57060,79,"""1""",57060,57120
4557,300101,301302,180,57060,79,"""1""",57120,57300
4557,301302,301401,60,57060,79,"""1""",57300,57360
4557,301401,300902,180,57060,79,"""1""",57360,57540
4557,300902,209902,120,57060,79,"""1""",57540,57660
4557,209902,400704,180,57060,79,"""1""",57660,57840
4557,400704,408503,60,57060,79,"""1""",57840,57900
4557,408503,405602,60,57060,79,"""1""",57900,57960
4557,405602,407102,60,57060,79,"""1""",57960,58020
4557,407102,404202,60,57060,79,"""1""",58020,58080
4557,404202,117000,60,57060,79,"""1""",58080,58140
4557,117000,112104,180,57060,79,"""1""",58140,58320
4557,300200,300101,60,58260,79,"""1""",58260,58320
4557,300101,301302,180,58260,79,"""1""",58320,58500
4557,301302,301401,60,58260,79,"""1""",58500,58560
4557,301401,300902,180,58260,79,"""1""",58560,58740
4557,300902,209902,120,58260,79,"""1""",58740,58860
4557,209902,400704,180,58260,79,"""1""",58860,59040
4557,400704,408503,60,58260,79,"""1""",59040,59100
4557,408503,405602,60,58260,79,"""1""",59100,59160
4557,405602,407102,60,58260,79,"""1""",59160,59220
4557,407102,404202,60,58260,79,"""1""",59220,59280
4557,404202,117000,60,58260,79,"""1""",59280,59340
4557,117000,112104,180,58260,79,"""1""",59340,59520
4557,300200,300101,60,59460,79,"""1""",59460,59520
4557,300101,301302,180,59460,79,"""1""",59520,59700
4557,301302,301401,60,59460,79,"""1""",59700,59760
4557,301401,300902,180,59460,79,"""1""",59760,59940
4557,300902,209902,120,59460,79,"""1""",59940,60060
4557,209902,400704,180,59460,79,"""1""",60060,60240
4557,400704,408503,60,59460,79,"""1""",60240,60300
4557,408503,405602,60,59460,79,"""1""",60300,60360
4557,405602,407102,60,59460,79,"""1""",60360,60420
4557,407102,404202,60,59460,79,"""1""",60420,60480
4557,404202,117000,60,59460,79,"""1""",60480,60540
4557,117000,112104,180,59460,79,"""1""",60540,60720
4557,300200,300101,60,60660,79,"""1""",60660,60720
4557,300101,301302,180,60660,79,"""1""",60720,60900
4557,301302,301401,60,60660,79,"""1""",60900,60960
4557,301401,300902,180,60660,79,"""1""",60960,61140
4557,300902,209902,120,60660,79,"""1""",61140,61260
4557,209902,400704,180,60660,79,"""1""",61260,61440
4557,400704,408503,60,60660,79,"""1""",61440,61500
4557,408503,405602,60,60660,79,"""1""",61500,61560
4557,405602,407102,60,60660,79,"""1""",61560,61620
4557,407102,404202,60,60660,79,"""1""",61620,61680
4557,404202,117000,60,60660,79,"""1""",61680,61740
4557,117000,112104,180,60660,79,"""1""",61740,61920
4557,300200,300101,60,61860,79,"""1""",61860,61920
4557,300101,301302,180,61860,79,"""1""",61920,62100
4557,301302,301401,60,61860,79,"""1""",62100,62160
4557,301401,300902,180,61860,79,"""1""",62160,62340
4557,300902,209902,120,61860,79,"""1""",62340,62460
4557,209902,400704,180,61860,79,"""1""",62460,62640
4557,400704,408503,60,61860,79,"""1""",62640,62700
4557,408503,405602,60,61860,79,"""1""",62700,62760
4557,405602,407102,60,61860,79,"""1""",62760,62820
4557,407102,404202,60,61860,79,"""1""",62820,62880
4557,404202,117000,60,61860,79,"""1""",62880,62940
4557,117000,112104,180,61860,79,"""1""",62940,63120
4557,300200,300101,60,63060,79,"""1""",63060,63120
4557,300101,301302,180,63060,79,"""1""",63120,63300
4557,301302,301401,60,63060,79,"""1""",63300,63360
4557,301401,300902,180,63060,79,"""1""",63360,63540
4557,300902,209902,120,63060,79,"""1""",63540,63660
4557,209902,400704,180,63060,79,"""1""",63660,63840
4557,400704,408503,60,63060,79,"""1""",63840,63900
4557,408503,405602,60,63060,79,"""1""",63900,63960
4557,405602,407102,60,63060,79,"""1""",63960,64020
4557,407102,404202,60,63060,79,"""1""",64020,64080
4557,404202,117000,60,63060,79,"""1""",64080,64140
4557,117000,112104,180,63060,79,"""1""",64140,64320
4557,300200,300101,60,64260,79,"""1""",64260,64320
4557,300101,301302,180,64260,79,"""1""",64320,64500
4557,301302,301401,60,64260,79,"""1""",64500,64560
4557,301401,300902,180,64260,79,"""1""",64560,64740
4557,300902,209902,120,64260,79,"""1""",64740,64860
4557,209902,400704,180,64260,79,"""1""",64860,65040
4557,400704,408503,60,64260,79,"""1""",65040,65100
4557,408503,405602,60,64260,79,"""1""",65100,65160
4557,405602,407102,60,64260,79,"""1""",65160,65220
4557,407102,404202,60,64260,79,"""1""",65220,65280
4557,404202,117000,60,64260,79,"""1""",65280,65340
4557,117000,112104,180,64260,79,"""1""",65340,65520
4557,300200,300101,60,65460,79,"""1""",65460,65520
4557,300101,301302,180,65460,79,"""1""",65520,65700
4557,301302,301401,60,65460,79,"""1""",65700,65760
4557,301401,300902,180,65460,79,"""1""",65760,65940
4557,300902,209902,120,65460,79,"""1""",65940,66060
4557,209902,400704,180,65460,79,"""1""",66060,66240
4557,400704,408503,60,65460,79,"""1""",66240,66300
4557,408503,405602,60,65460,79,"""1""",66300,66360
4557,405602,407102,60,65460,79,"""1""",66360,66420
4557,407102,404202,60,65460,79,"""1""",66420,66480
4557,404202,117000,60,65460,79,"""1""",66480,66540
4557,117000,112104,180,65460,79,"""1""",66540,66720
4557,300200,300101,60,68820,79,"""1""",68820,68880
4557,300101,301302,180,68820,79,"""1""",68880,69060
4557,301302,301401,60,68820,79,"""1""",69060,69120
4557,301401,300902,180,68820,79,"""1""",69120,69300
4557,300902,209902,120,68820,79,"""1""",69300,69420
4557,209902,400704,180,68820,79,"""1""",69420,69600
4557,400704,408503,60,68820,79,"""1""",69600,69660
4557,408503,405602,60,68820,79,"""1""",69660,69720
4557,405602,407102,60,68820,79,"""1""",69720,69780
4557,407102,404202,60,68820,79,"""1""",69780,69840
4557,404202,117000,60,68820,79,"""1""",69840,69900
4557,117000,112104,180,68820,79,"""1""",69900,70080
4558,300902,209902,120,75480,79,"""15""",75480,75600
4558,209902,400704,180,75480,79,"""15""",75600,75780
4558,400704,408503,60,75480,79,"""15""",75780,75840
4558,408503,405602,60,75480,79,"""15""",75840,75900
4558,405602,407102,60,75480,79,"""15""",75900,75960
4558,407102,404202,60,75480,79,"""15""",75960,76020
4558,404202,117000,60,75480,79,"""15""",76020,76080
4558,117000,112104,120,75480,79,"""15""",76080,76200
4559,112101,117001,180,22800,79,"""2""",22800,22980
4559,117001,404201,60,22800,79,"""2""",22980,23040
4559,404201,407101,60,22800,79,"""2""",23040,23100
4559,407101,405601,60,22800,79,"""2""",23100,23160
4559,405601,408502,60,22800,79,"""2""",23160,23220
4559,408502,209903,240,22800,79,"""2""",23220,23460
4559,209903,300903,60,22800,79,"""2""",23460,23520
4559,300903,301402,180,22800,79,"""2""",23520,23700
4559,301402,301301,60,22800,79,"""2""",23700,23760
4559,301301,300102,180,22800,79,"""2""",23760,23940
4559,300102,300200,120,22800,79,"""2""",23940,24060
4559,112101,117001,180,24000,79,"""2""",24000,24180
4559,117001,404201,60,24000,79,"""2""",24180,24240
4559,404201,407101,60,24000,79,"""2""",24240,24300
4559,407101,405601,60,24000,79,"""2""",24300,24360
4559,405601,408502,60,24000,79,"""2""",24360,24420
4559,408502,209903,240,24000,79,"""2""",24420,24660
4559,209903,300903,60,24000,79,"""2""",24660,24720
4559,300903,301402,180,24000,79,"""2""",24720,24900
4559,301402,301301,60,24000,79,"""2""",24900,24960
4559,301301,300102,180,24000,79,"""2""",24960,25140
4559,300102,300200,120,24000,79,"""2""",25140,25260
4559,112101,117001,180,25200,79,"""2""",25200,25380
4559,117001,404201,60,25200,79,"""2""",25380,25440
4559,404201,407101,60,25200,79,"""2""",25440,25500
4559,407101,405601,60,25200,79,"""2""",25500,25560
4559,405601,408502,60,25200,79,"""2""",25560,25620
4559,408502,209903,240,25200,79,"""2""",25620,25860
4559,209903,300903,60,25200,79,"""2""",25860,25920
4559,300903,301402,180,25200,79,"""2""",25920,26100
4559,301402,301301,60,25200,79,"""2""",26100,26160
4559,301301,300102,180,25200,79,"""2""",26160,26340
4559,300102,300200,120,25200,79,"""2""",26340,26460
4559,112101,117001,180,26400,79,"""2""",26400,26580
4559,117001,404201,60,26400,79,"""2""",26580,26640
4559,404201,407101,60,26400,79,"""2""",26640,26700
4559,407101,405601,60,26400,79,"""2""",26700,26760
4559,405601,408502,60,26400,79,"""2""",26760,26820
4559,408502,209903,240,26400,79,"""2""",26820,27060
4559,209903,300903,60,26400,79,"""2""",27060,27120
4559,300903,301402,180,26400,79,"""2""",27120,27300
4559,301402,301301,60,26400,79,"""2""",27300,27360
4559,301301,300102,180,26400,79,"""2""",27360,27540
4559,300102,300200,120,26400,79,"""2""",27540,27660
4559,112101,117001,180,27600,79,"""2""",27600,27780
4559,117001,404201,60,27600,79,"""2""",27780,27840
4559,404201,407101,60,27600,79,"""2""",27840,27900
4559,407101,405601,60,27600,79,"""2""",27900,27960
4559,405601,408502,60,27600,79,"""2""",27960,28020
4559,408502,209903,240,27600,79,"""2""",28020,28260
4559,209903,300903,60,27600,79,"""2""",28260,28320
4559,300903,301402,180,27600,79,"""2""",28320,28500
4559,301402,301301,60,27600,79,"""2""",28500,28560
4559,301301,300102,180,27600,79,"""2""",28560,28740
4559,300102,300200,120,27600,79,"""2""",28740,28860
4559,112101,117001,180,28800,79,"""2""",28800,28980
4559,117001,404201,60,28800,79,"""2""",28980,29040
4559,404201,407101,60,28800,79,"""2""",29040,29100
4559,407101,405601,60,28800,79,"""2""",29100,29160
4559,405601,408502,60,28800,79,"""2""",29160,29220
4559,408502,209903,240,28800,79,"""2""",29220,29460
4559,209903,300903,60,28800,79,"""2""",29460,29520
4559,300903,301402,180,28800,79,"""2""",29520,29700
4559,301402,301301,60,28800,79,"""2""",29700,29760
4559,301301,300102,180,28800,79,"""2""",29760,29940
4559,300102,300200,120,28800,79,"""2""",29940,30060
4559,112101,117001,180,30000,79,"""2""",30000,30180
4559,117001,404201,60,30000,79,"""2""",30180,30240
4559,404201,407101,60,30000,79,"""2""",30240,30300
4559,407101,405601,60,30000,79,"""2""",30300,30360
4559,405601,408502,60,30000,79,"""2""",30360,30420
4559,408502,209903,240,30000,79,"""2""",30420,30660
4559,209903,300903,60,30000,79,"""2""",30660,30720
4559,300903,301402,180,30000,79,"""2""",30720,30900
4559,301402,301301,60,30000,79,"""2""",30900,30960
4559,301301,300102,180,30000,79,"""2""",30960,31140
4559,300102,300200,120,30000,79,"""2""",31140,31260
4559,112101,117001,180,31200,79,"""2""",31200,31380
4559,117001,404201,60,31200,79,"""2""",31380,31440
4559,404201,407101,60,31200,79,"""2""",31440,31500
4559,407101,405601,60,31200,79,"""2""",31500,31560
4559,405601,408502,60,31200,79,"""2""",31560,31620
4559,408502,209903,240,31200,79,"""2""",31620,31860
4559,209903,300903,60,31200,79,"""2""",31860,31920
4559,300903,301402,180,31200,79,"""2""",31920,32100
4559,301402,301301,60,31200,79,"""2""",32100,32160
4559,301301,300102,180,31200,79,"""2""",32160,32340
4559,300102,300200,120,31200,79,"""2""",32340,32460
4559,112101,117001,180,32400,79,"""2""",32400,32580
4559,117001,404201,60,32400,79,"""2""",32580,32640
4559,404201,407101,60,32400,79,"""2""",32640,32700
4559,407101,405601,60,32400,79,"""2""",32700,32760
4559,405601,408502,60,32400,79,"""2""",32760,32820
4559,408502,209903,240,32400,79,"""2""",32820,33060
4559,209903,300903,60,32400,79,"""2""",33060,33120
4559,300903,301402,180,32400,79,"""2""",33120,33300
4559,301402,301301,60,32400,79,"""2""",33300,33360
4559,301301,300102,180,32400,79,"""2""",33360,33540
4559,300102,300200,120,32400,79,"""2""",33540,33660
4559,112101,117001,180,33600,79,"""2""",33600,33780
4559,117001,404201,60,33600,79,"""2""",33780,33840
4559,404201,407101,60,33600,79,"""2""",33840,33900
4559,407101,405601,60,33600,79,"""2""",33900,33960
4559,405601,408502,60,33600,79,"""2""",33960,34020
4559,408502,209903,240,33600,79,"""2""",34020,34260
4559,209903,300903,60,33600,79,"""2""",34260,34320
4559,300903,301402,180,33600,79,"""2""",34320,34500
4559,301402,301301,60,33600,79,"""2""",34500,34560
4559,301301,300102,180,33600,79,"""2""",34560,34740
4559,300102,300200,120,33600,79,"""2""",34740,34860
4559,112101,117001,180,37200,79,"""2""",37200,37380
4559,117001,404201,60,37200,79,"""2""",37380,37440
4559,404201,407101,60,37200,79,"""2""",37440,37500
4559,407101,405601,60,37200,79,"""2""",37500,37560
4559,405601,408502,60,37200,79,"""2""",37560,37620
4559,408502,209903,240,37200,79,"""2""",37620,37860
4559,209903,300903,60,37200,79,"""2""",37860,37920
4559,300903,301402,180,37200,79,"""2""",37920,38100
4559,301402,301301,60,37200,79,"""2""",38100,38160
4559,301301,300102,180,37200,79,"""2""",38160,38340
4559,300102,300200,120,37200,79,"""2""",38340,38460
4559,112101,117001,180,40800,79,"""2""",40800,40980
4559,117001,404201,60,40800,79,"""2""",40980,41040
4559,404201,407101,60,40800,79,"""2""",41040,41100
4559,407101,405601,60,40800,79,"""2""",41100,41160
4559,405601,408502,60,40800,79,"""2""",41160,41220
4559,408502,209903,240,40800,79,"""2""",41220,41460
4559,209903,300903,60,40800,79,"""2""",41460,41520
4559,300903,301402,180,40800,79,"""2""",41520,41700
4559,301402,301301,60,40800,79,"""2""",41700,41760
4559,301301,300102,180,40800,79,"""2""",41760,41940
4559,300102,300200,120,40800,79,"""2""",41940,42060
4559,112101,117001,180,44400,79,"""2""",44400,44580
4559,117001,404201,60,44400,79,"""2""",44580,44640
4559,404201,407101,60,44400,79,"""2""",44640,44700
4559,407101,405601,60,44400,79,"""2""",44700,44760
4559,405601,408502,60,44400,79,"""2""",44760,44820
4559,408502,209903,240,44400,79,"""2""",44820,45060
4559,209903,300903,60,44400,79,"""2""",45060,45120
4559,300903,301402,180,44400,79,"""2""",45120,45300
4559,301402,301301,60,44400,79,"""2""",45300,45360
4559,301301,300102,180,44400,79,"""2""",45360,45540
4559,300102,300200,120,44400,79,"""2""",45540,45660
4559,112101,117001,180,48000,79,"""2""",48000,48180
4559,117001,404201,60,48000,79,"""2""",48180,48240
4559,404201,407101,60,48000,79,"""2""",48240,48300
4559,407101,405601,60,48000,79,"""2""",48300,48360
4559,405601,408502,60,48000,79,"""2""",48360,48420
4559,408502,209903,240,48000,79,"""2""",48420,48660
4559,209903,300903,60,48000,79,"""2""",48660,48720
4559,300903,301402,180,48000,79,"""2""",48720,48900
4559,301402,301301,60,48000,79,"""2""",48900,48960
4559,301301,300102,180,48000,79,"""2""",48960,49140
4559,300102,300200,120,48000,79,"""2""",49140,49260
4559,112101,117001,180,51600,79,"""2""",51600,51780
4559,117001,404201,60,51600,79,"""2""",51780,51840
4559,404201,407101,60,51600,79,"""2""",51840,51900
4559,407101,405601,60,51600,79,"""2""",51900,51960
4559,405601,408502,60,51600,79,"""2""",51960,52020
4559,408502,209903,240,51600,79,"""2""",52020,52260
4559,209903,300903,60,51600,79,"""2""",52260,52320
4559,300903,301402,180,51600,79,"""2""",52320,52500
4559,301402,301301,60,51600,79,"""2""",52500,52560
4559,301301,300102,180,51600,79,"""2""",52560,52740
4559,300102,300200,120,51600,79,"""2""",52740,52860
4559,112101,117001,180,55200,79,"""2""",55200,55380
4559,117001,404201,60,55200,79,"""2""",55380,55440
4559,404201,407101,60,55200,79,"""2""",55440,55500
4559,407101,405601,60,55200,79,"""2""",55500,55560
4559,405601,408502,60,55200,79,"""2""",55560,55620
4559,408502,209903,240,55200,79,"""2""",55620,55860
4559,209903,300903,60,55200,79,"""2""",55860,55920
4559,300903,301402,180,55200,79,"""2""",55920,56100
4559,301402,301301,60,55200,79,"""2""",56100,56160
4559,301301,300102,180,55200,79,"""2""",56160,56340
4559,300102,300200,120,55200,79,"""2""",56340,56460
4559,112101,117001,180,58800,79,"""2""",58800,58980
4559,117001,404201,60,58800,79,"""2""",58980,59040
4559,404201,407101,60,58800,79,"""2""",59040,59100
4559,407101,405601,60,58800,79,"""2""",59100,59160
4559,405601,408502,60,58800,79,"""2""",59160,59220
4559,408502,209903,240,58800,79,"""2""",59220,59460
4559,209903,300903,60,58800,79,"""2""",59460,59520
4559,300903,301402,180,58800,79,"""2""",59520,59700
4559,301402,301301,60,58800,79,"""2""",59700,59760
4559,301301,300102,180,58800,79,"""2""",59760,59940
4559,300102,300200,120,58800,79,"""2""",59940,60060
4560,112101,117001,120,20400,79,"""2""",20400,20520
4560,117001,404201,60,20400,79,"""2""",20520,20580
4560,404201,407101,60,20400,79,"""2""",20580,20640
4560,407101,405601,60,20400,79,"""2""",20640,20700
4560,405601,408502,60,20400,79,"""2""",20700,20760
4560,408502,209903,240,20400,79,"""2""",20760,21000
4560,209903,300903,60,20400,79,"""2""",21000,21060
4560,300903,301402,180,20400,79,"""2""",21060,21240
4560,301402,301301,60,20400,79,"""2""",21240,21300
4560,301301,300102,180,20400,79,"""2""",21300,21480
4560,300102,300200,120,20400,79,"""2""",21480,21600
4709,204602,200600,0,25440,77,"""41""",25440,25440
4709,200600,208902,120,25440,77,"""41""",25440,25560
4709,208902,61604,60,25440,77,"""41""",25560,25620
4709,61604,203501,60,25440,77,"""41""",25620,25680
4709,203501,203401,60,25440,77,"""41""",25680,25740
4709,203401,204001,60,25440,77,"""41""",25740,25800
4709,204001,34601,60,25440,77,"""41""",25800,25860
4709,34601,202200,120,25440,77,"""41""",25860,25980
4709,204602,200600,0,26640,77,"""41""",26640,26640
4709,200600,208902,120,26640,77,"""41""",26640,26760
4709,208902,61604,60,26640,77,"""41""",26760,26820
4709,61604,203501,60,26640,77,"""41""",26820,26880
4709,203501,203401,60,26640,77,"""41""",26880,26940
4709,203401,204001,60,26640,77,"""41""",26940,27000
4709,204001,34601,60,26640,77,"""41""",27000,27060
4709,34601,202200,120,26640,77,"""41""",27060,27180
4709,204602,200600,0,29040,77,"""41""",29040,29040
4709,200600,208902,120,29040,77,"""41""",29040,29160
4709,208902,61604,60,29040,77,"""41""",29160,29220
4709,61604,203501,60,29040,77,"""41""",29220,29280
4709,203501,203401,60,29040,77,"""41""",29280,29340
4709,203401,204001,60,29040,77,"""41""",29340,29400
4709,204001,34601,60,29040,77,"""41""",29400,29460
4709,34601,202200,120,29040,77,"""41""",29460,29580
4709,204602,200600,0,30240,77,"""41""",30240,30240
4709,200600,208902,120,30240,77,"""41""",30240,30360
4709,208902,61604,60,30240,77,"""41""",30360,30420
4709,61604,203501,60,30240,77,"""41""",30420,30480
4709,203501,203401,60,30240,77,"""41""",30480,30540
4709,203401,204001,60,30240,77,"""41""",30540,30600
4709,204001,34601,60,30240,77,"""41""",30600,30660
4709,34601,202200,120,30240,77,"""41""",30660,30780
4709,204602,200600,0,39840,77,"""41""",39840,39840
4709,200600,208902,120,39840,77,"""41""",39840,39960
4709,208902,61604,60,39840,77,"""41""",39960,40020
4709,61604,203501,60,39840,77,"""41""",40020,40080
4709,203501,203401,60,39840,77,"""41""",40080,40140
4709,203401,204001,60,39840,77,"""41""",40140,40200
4709,204001,34601,60,39840,77,"""41""",40200,40260
4709,34601,202200,120,39840,77,"""41""",40260,40380
4709,204602,200600,0,42840,77,"""41""",42840,42840
4709,200600,208902,120,42840,77,"""41""",42840,42960
4709,208902,61604,60,42840,77,"""41""",42960,43020
4709,61604,203501,60,42840,77,"""41""",43020,43080
4709,203501,203401,60,42840,77,"""41""",43080,43140
4709,203401,204001,60,42840,77,"""41""",43140,43200
4709,204001,34601,60,42840,77,"""41""",43200,43260
4709,34601,202200,120,42840,77,"""41""",43260,43380
4709,204602,200600,0,44040,77,"""41""",44040,44040
4709,200600,208902,120,44040,77,"""41""",44040,44160
4709,208902,61604,60,44040,77,"""41""",44160,44220
4709,61604,203501,60,44040,77,"""41""",44220,44280
4709,203501,203401,60,44040,77,"""41""",44280,44340
4709,203401,204001,60,44040,77,"""41""",44340,44400
4709,204001,34601,60,44040,77,"""41""",44400,44460
4709,34601,202200,120,44040,77,"""41""",44460,44580
4709,204602,200600,0,45240,77,"""41""",45240,45240
4709,200600,208902,120,45240,77,"""41""",45240,45360
4709,208902,61604,60,45240,77,"""41""",45360,45420
4709,61604,203501,60,45240,77,"""41""",45420,45480
4709,203501,203401,60,45240,77,"""41""",45480,45540
4709,203401,204001,60,45240,77,"""41""",45540,45600
4709,204001,34601,60,45240,77,"""41""",45600,45660
4709,34601,202200,120,45240,77,"""41""",45660,45780
4709,204602,200600,0,46440,77,"""41""",46440,46440
4709,200600,208902,120,46440,77,"""41""",46440,46560
4709,208902,61604,60,46440,77,"""41""",46560,46620
4709,61604,203501,60,46440,77,"""41""",46620,46680
4709,203501,203401,60,46440,77,"""41""",46680,46740
4709,203401,204001,60,46440,77,"""41""",46740,46800
4709,204001,34601,60,46440,77,"""41""",46800,46860
4709,34601,202200,120,46440,77,"""41""",46860,46980
4709,204602,200600,0,47640,77,"""41""",47640,47640
4709,200600,208902,120,47640,77,"""41""",47640,47760
4709,208902,61604,60,47640,77,"""41""",47760,47820
4709,61604,203501,60,47640,77,"""41""",47820,47880
4709,203501,203401,60,47640,77,"""41""",47880,47940
4709,203401,204001,60,47640,77,"""41""",47940,48000
4709,204001,34601,60,47640,77,"""41""",48000,48060
4709,34601,202200,120,47640,77,"""41""",48060,48180
4709,204602,200600,0,48840,77,"""41""",48840,48840
4709,200600,208902,120,48840,77,"""41""",48840,48960
4709,208902,61604,60,48840,77,"""41""",48960,49020
4709,61604,203501,60,48840,77,"""41""",49020,49080
4709,203501,203401,60,48840,77,"""41""",49080,49140
4709,203401,204001,60,48840,77,"""41""",49140,49200
4709,204001,34601,60,48840,77,"""41""",49200,49260
4709,34601,202200,120,48840,77,"""41""",49260,49380
4709,204602,200600,0,50040,77,"""41""",50040,50040
4709,200600,208902,120,50040,77,"""41""",50040,50160
4709,208902,61604,60,50040,77,"""41""",50160,50220
4709,61604,203501,60,50040,77,"""41""",50220,50280
4709,203501,203401,60,50040,77,"""41""",50280,50340
4709,203401,204001,60,50040,77,"""41""",50340,50400
4709,204001,34601,60,50040,77,"""41""",50400,50460
4709,34601,202200,120,50040,77,"""41""",50460,50580
4709,204602,200600,0,51240,77,"""41""",51240,51240
4709,200600,208902,120,51240,77,"""41""",51240,51360
4709,208902,61604,60,51240,77,"""41""",51360,51420
4709,61604,203501,60,51240,77,"""41""",51420,51480
4709,203501,203401,60,51240,77,"""41""",51480,51540
4709,203401,204001,60,51240,77,"""41""",51540,51600
4709,204001,34601,60,51240,77,"""41""",51600,51660
4709,34601,202200,120,51240,77,"""41""",51660,51780
4709,204602,200600,0,54240,77,"""41""",54240,54240
4709,200600,208902,120,54240,77,"""41""",54240,54360
4709,208902,61604,60,54240,77,"""41""",54360,54420
4709,61604,203501,60,54240,77,"""41""",54420,54480
4709,203501,203401,60,54240,77,"""41""",54480,54540
4709,203401,204001,60,54240,77,"""41""",54540,54600
4709,204001,34601,60,54240,77,"""41""",54600,54660
4709,34601,202200,120,54240,77,"""41""",54660,54780
4709,204602,200600,0,55440,77,"""41""",55440,55440
4709,200600,208902,120,55440,77,"""41""",55440,55560
4709,208902,61604,60,55440,77,"""41""",55560,55620
4709,61604,203501,60,55440,77,"""41""",55620,55680
4709,203501,203401,60,55440,77,"""41""",55680,55740
4709,203401,204001,60,55440,77,"""41""",55740,55800
4709,204001,34601,60,55440,77,"""41""",55800,55860
4709,34601,202200,120,55440,77,"""41""",55860,55980
4709,204602,200600,0,56640,77,"""41""",56640,56640
4709,200600,208902,120,56640,77,"""41""",56640,56760
4709,208902,61604,60,56640,77,"""41""",56760,56820
4709,61604,203501,60,56640,77,"""41""",56820,56880
4709,203501,203401,60,56640,77,"""41""",56880,56940
4709,203401,204001,60,56640,77,"""41""",56940,57000
4709,204001,34601,60,56640,77,"""41""",57000,57060
4709,34601,202200,120,56640,77,"""41""",57060,57180
4709,204602,200600,0,57840,77,"""41""",57840,57840
4709,200600,208902,120,57840,77,"""41""",57840,57960
4709,208902,61604,60,57840,77,"""41""",57960,58020
4709,61604,203501,60,57840,77,"""41""",58020,58080
4709,203501,203401,60,57840,77,"""41""",58080,58140
4709,203401,204001,60,57840,77,"""41""",58140,58200
4709,204001,34601,60,57840,77,"""41""",58200,58260
4709,34601,202200,120,57840,77,"""41""",58260,58380
4709,204602,200600,0,59040,77,"""41""",59040,59040
4709,200600,208902,120,59040,77,"""41""",59040,59160
4709,208902,61604,60,59040,77,"""41""",59160,59220
4709,61604,203501,60,59040,77,"""41""",59220,59280
4709,203501,203401,60,59040,77,"""41""",59280,59340
4709,203401,204001,60,59040,77,"""41""",59340,59400
4709,204001,34601,60,59040,77,"""41""",59400,59460
4709,34601,202200,120,59040,77,"""41""",59460,59580
4709,204602,200600,0,60240,77,"""41""",60240,60240
4709,200600,208902,120,60240,77,"""41""",60240,60360
4709,208902,61604,60,60240,77,"""41""",60360,60420
4709,61604,203501,60,60240,77,"""41""",60420,60480
4709,203501,203401,60,60240,77,"""41""",60480,60540
4709,203401,204001,60,60240,77,"""41""",60540,60600
4709,204001,34601,60,60240,77,"""41""",60600,60660
4709,34601,202200,120,60240,77,"""41""",60660,60780
4709,204602,200600,0,61440,77,"""41""",61440,61440
4709,200600,208902,120,61440,77,"""41""",61440,61560
4709,208902,61604,60,61440,77,"""41""",61560,61620
4709,61604,203501,60,61440,77,"""41""",61620,61680
4709,203501,203401,60,61440,77,"""41""",61680,61740
4709,203401,204001,60,61440,77,"""41""",61740,61800
4709,204001,34601,60,61440,77,"""41""",61800,61860
4709,34601,202200,120,61440,77,"""41""",61860,61980
4709,204602,200600,0,62640,77,"""41""",62640,62640
4709,200600,208902,120,62640,77,"""41""",62640,62760
4709,208902,61604,60,62640,77,"""41""",62760,62820
4709,61604,203501,60,62640,77,"""41""",62820,62880
4709,203501,203401,60,62640,77,"""41""",62880,62940
4709,203401,204001,60,62640,77,"""41""",62940,63000
4709,204001,34601,60,62640,77,"""41""",63000,63060
4709,34601,202200,120,62640,77,"""41""",63060,63180
4709,204602,200600,0,76740,77,"""41""",76740,76740
4709,200600,208902,120,76740,77,"""41""",76740,76860
4709,208902,61604,60,76740,77,"""41""",76860,76920
4709,61604,203501,60,76740,77,"""41""",76920,76980
4709,203501,203401,60,76740,77,"""41""",76980,77040
4709,203401,204001,60,76740,77,"""41""",77040,77100
4709,204001,34601,60,76740,77,"""41""",77100,77160
4709,34601,202200,120,76740,77,"""41""",77160,77280
4709,204602,200600,0,78540,77,"""41""",78540,78540
4709,200600,208902,120,78540,77,"""41""",78540,78660
4709,208902,61604,60,78540,77,"""41""",78660,78720
4709,61604,203501,60,78540,77,"""41""",78720,78780
4709,203501,203401,60,78540,77,"""41""",78780,78840
4709,203401,204001,60,78540,77,"""41""",78840,78900
4709,204001,34601,60,78540,77,"""41""",78900,78960
4709,34601,202200,120,78540,77,"""41""",78960,79080
4710,202200,34602,120,26340,77,"""34""",26340,26460
4710,34602,204002,60,26340,77,"""34""",26460,26520
4710,204002,203402,60,26340,77,"""34""",26520,26580
4710,203402,203502,60,26340,77,"""34""",26580,26640
4710,203502,61603,60,26340,77,"""34""",26640,26700
4710,61603,208901,60,26340,77,"""34""",26700,26760
4710,208901,208700,240,26340,77,"""34""",26760,27000
4710,208700,200302,60,26340,77,"""34""",27000,27060
4710,200302,205702,60,26340,77,"""34""",27060,27120
4710,205702,204602,120,26340,77,"""34""",27120,27240
4710,204602,200600,0,26340,77,"""34""",27240,27240
4710,200600,204200,60,26340,77,"""34""",27240,27300
4710,204200,204500,60,26340,77,"""34""",27300,27360
4710,204500,200500,120,26340,77,"""34""",27360,27480
4710,200500,205300,420,26340,77,"""34""",27480,27900
4710,205300,202502,60,26340,77,"""34""",27900,27960
4710,202502,203900,240,26340,77,"""34""",27960,28200
4710,203900,201503,60,26340,77,"""34""",28200,28260
4710,201503,208103,120,26340,77,"""34""",28260,28380
4710,208103,119004,120,26340,77,"""34""",28380,28500
4710,119004,117002,60,26340,77,"""34""",28500,28560
4710,117002,105201,180,26340,77,"""34""",28560,28740
4710,105201,109009,120,26340,77,"""34""",28740,28860
4799,408703,404002,60,26640,7,"""7""",26640,26700
4799,404002,405502,60,26640,7,"""7""",26700,26760
4799,405502,409102,60,26640,7,"""7""",26760,26820
4799,409102,400902,60,26640,7,"""7""",26820,26880
4799,400902,404502,60,26640,7,"""7""",26880,26940
4799,404502,406401,60,26640,7,"""7""",26940,27000
4799,406401,405103,60,26640,7,"""7""",27000,27060
4799,405103,407602,60,26640,7,"""7""",27060,27120
4799,407602,409003,120,26640,7,"""7""",27120,27240
4799,409003,403803,60,26640,7,"""7""",27240,27300
4799,403803,101103,120,26640,7,"""7""",27300,27420
4799,101103,115100,60,26640,7,"""7""",27420,27480
4799,115100,109015,120,26640,7,"""7""",27480,27600
4799,109015,112104,120,26640,7,"""7""",27600,27720
4799,112104,403101,120,26640,7,"""7""",27720,27840
4799,403101,409401,60,26640,7,"""7""",27840,27900
4799,409401,400103,120,26640,7,"""7""",27900,28020
4819,400200,33702,240,32220,10,"""39""",32220,32460
4819,33702,402204,60,32220,10,"""39""",32460,32520
4819,402204,402900,60,32220,10,"""39""",32520,32580
4819,402900,405300,120,32220,10,"""39""",32580,32700
4819,405300,402800,60,32220,10,"""39""",32700,32760
4819,402800,405100,60,32220,10,"""39""",32760,32820
4819,405100,405902,60,32220,10,"""39""",32820,32880
4819,405902,406500,60,32220,10,"""39""",32880,32940
4819,406500,400601,120,32220,10,"""39""",32940,33060
4819,400601,404300,60,32220,10,"""39""",33060,33120
4819,404300,407401,60,32220,10,"""39""",33120,33180
4819,407401,404103,120,32220,10,"""39""",33180,33300
4819,404103,403104,120,32220,10,"""39""",33300,33420
4819,403104,112101,180,32220,10,"""39""",33420,33600
4819,112101,103001,180,32220,10,"""39""",33600,33780
4819,103001,106501,60,32220,10,"""39""",33780,33840
4819,106501,119006,180,32220,10,"""39""",33840,34020
4819,119006,302501,120,32220,10,"""39""",34020,34140
4819,302501,303001,60,32220,10,"""39""",34140,34200
4819,303001,302201,120,32220,10,"""39""",34200,34320
4819,302201,302001,60,32220,10,"""39""",34320,34380
4819,302001,302100,120,32220,10,"""39""",34380,34500
4819,400200,33702,240,33420,10,"""39""",33420,33660
4819,33702,402204,60,33420,10,"""39""",33660,33720
4819,402204,402900,60,33420,10,"""39""",33720,33780
4819,402900,405300,120,33420,10,"""39""",33780,33900
4819,405300,402800,60,33420,10,"""39""",33900,33960
4819,402800,405100,60,33420,10,"""39""",33960,34020
4819,405100,405902,60,33420,10,"""39""",34020,34080
4819,405902,406500,60,33420,10,"""39""",34080,34140
4819,406500,400601,120,33420,10,"""39""",34140,34260
4819,400601,404300,60,33420,10,"""39""",34260,34320
4819,404300,407401,60,33420,10,"""39""",34320,34380
4819,407401,404103,120,33420,10,"""39""",34380,34500
4819,404103,403104,120,33420,10,"""39""",34500,34620
4819,403104,112101,180,33420,10,"""39""",34620,34800
4819,112101,103001,180,33420,10,"""39""",34800,34980
4819,103001,106501,60,33420,10,"""39""",34980,35040
4819,106501,119006,180,33420,10,"""39""",35040,35220
4819,119006,302501,120,33420,10,"""39""",35220,35340
4819,302501,303001,60,33420,10,"""39""",35340,35400
4819,303001,302201,120,33420,10,"""39""",35400,35520
4819,302201,302001,60,33420,10,"""39""",35520,35580
4819,302001,302100,120,33420,10,"""39""",35580,35700
4819,400200,33702,240,34620,10,"""39""",34620,34860
4819,33702,402204,60,34620,10,"""39""",34860,34920
4819,402204,402900,60,34620,10,"""39""",34920,34980
4819,402900,405300,120,34620,10,"""39""",34980,35100
4819,405300,402800,60,34620,10,"""39""",35100,35160
4819,402800,405100,60,34620,10,"""39""",35160,35220
4819,405100,405902,60,34620,10,"""39""",35220,35280
4819,405902,406500,60,34620,10,"""39""",35280,35340
4819,406500,400601,120,34620,10,"""39""",35340,35460
4819,400601,404300,60,34620,10,"""39""",35460,35520
4819,404300,407401,60,34620,10,"""39""",35520,35580
4819,407401,404103,120,34620,10,"""39""",35580,35700
4819,404103,403104,120,34620,10,"""39""",35700,35820
4819,403104,112101,180,34620,10,"""39""",35820,36000
4819,112101,103001,180,34620,10,"""39""",36000,36180
4819,103001,106501,60,34620,10,"""39""",36180,36240
4819,106501,119006,180,34620,10,"""39""",36240,36420
4819,119006,302501,120,34620,10,"""39""",36420,36540
4819,302501,303001,60,34620,10,"""39""",36540,36600
4819,303001,302201,120,34620,10,"""39""",36600,36720
4819,302201,302001,60,34620,10,"""39""",36720,36780
4819,302001,302100,120,34620,10,"""39""",36780,36900
4819,400200,33702,240,35820,10,"""39""",35820,36060
4819,33702,402204,60,35820,10,"""39""",36060,36120
4819,402204,402900,60,35820,10,"""39""",36120,36180
4819,402900,405300,120,35820,10,"""39""",36180,36300
4819,405300,402800,60,35820,10,"""39""",36300,36360
4819,402800,405100,60,35820,10,"""39""",36360,36420
4819,405100,405902,60,35820,10,"""39""",36420,36480
4819,405902,406500,60,35820,10,"""39""",36480,36540
4819,406500,400601,120,35820,10,"""39""",36540,36660
4819,400601,404300,60,35820,10,"""39""",36660,36720
4819,404300,407401,60,35820,10,"""39""",36720,36780
4819,407401,404103,120,35820,10,"""39""",36780,36900
4819,404103,403104,120,35820,10,"""39""",36900,37020
4819,403104,112101,180,35820,10,"""39""",37020,37200
4819,112101,103001,180,35820,10,"""39""",37200,37380
4819,103001,106501,60,35820,10,"""39""",37380,37440
4819,106501,119006,180,35820,10,"""39""",37440,37620
4819,119006,302501,120,35820,10,"""39""",37620,37740
4819,302501,303001,60,35820,10,"""39""",37740,37800
4819,303001,302201,120,35820,10,"""39""",37800,37920
4819,302201,302001,60,35820,10,"""39""",37920,37980
4819,302001,302100,120,35820,10,"""39""",37980,38100
4819,400200,33702,240,37020,10,"""39""",37020,37260
4819,33702,402204,60,37020,10,"""39""",37260,37320
4819,402204,402900,60,37020,10,"""39""",37320,37380
4819,402900,405300,120,37020,10,"""39""",37380,37500
4819,405300,402800,60,37020,10,"""39""",37500,37560
4819,402800,405100,60,37020,10,"""39""",37560,37620
4819,405100,405902,60,37020,10,"""39""",37620,37680
4819,405902,406500,60,37020,10,"""39""",37680,37740
4819,406500,400601,120,37020,10,"""39""",37740,37860
4819,400601,404300,60,37020,10,"""39""",37860,37920
4819,404300,407401,60,37020,10,"""39""",37920,37980
4819,407401,404103,120,37020,10,"""39""",37980,38100
4819,404103,403104,120,37020,10,"""39""",38100,38220
4819,403104,112101,180,37020,10,"""39""",38220,38400
4819,112101,103001,180,37020,10,"""39""",38400,38580
4819,103001,106501,60,37020,10,"""39""",38580,38640
4819,106501,119006,180,37020,10,"""39""",38640,38820
4819,119006,302501,120,37020,10,"""39""",38820,38940
4819,302501,303001,60,37020,10,"""39""",38940,39000
4819,303001,302201,120,37020,10,"""39""",39000,39120
4819,302201,302001,60,37020,10,"""39""",39120,39180
4819,302001,302100,120,37020,10,"""39""",39180,39300
4819,400200,33702,240,38220,10,"""39""",38220,38460
4819,33702,402204,60,38220,10,"""39""",38460,38520
4819,402204,402900,60,38220,10,"""39""",38520,38580
4819,402900,405300,120,38220,10,"""39""",38580,38700
4819,405300,402800,60,38220,10,"""39""",38700,38760
4819,402800,405100,60,38220,10,"""39""",38760,38820
4819,405100,405902,60,38220,10,"""39""",38820,38880
4819,405902,406500,60,38220,10,"""39""",38880,38940
4819,406500,400601,120,38220,10,"""39""",38940,39060
4819,400601,404300,60,38220,10,"""39""",39060,39120
4819,404300,407401,60,38220,10,"""39""",39120,39180
4819,407401,404103,120,38220,10,"""39""",39180,39300
4819,404103,403104,120,38220,10,"""39""",39300,39420
4819,403104,112101,180,38220,10,"""39""",39420,39600
4819,112101,103001,180,38220,10,"""39""",39600,39780
4819,103001,106501,60,38220,10,"""39""",39780,39840
4819,106501,119006,180,38220,10,"""39""",39840,40020
4819,119006,302501,120,38220,10,"""39""",40020,40140
4819,302501,303001,60,38220,10,"""39""",40140,40200
4819,303001,302201,120,38220,10,"""39""",40200,40320
4819,302201,302001,60,38220,10,"""39""",40320,40380
4819,302001,302100,120,38220,10,"""39""",40380,40500
4819,400200,33702,240,39420,10,"""39""",39420,39660
4819,33702,402204,60,39420,10,"""39""",39660,39720
4819,402204,402900,60,39420,10,"""39""",39720,39780
4819,402900,405300,120,39420,10,"""39""",39780,39900
4819,405300,402800,60,39420,10,"""39""",39900,39960
4819,402800,405100,60,39420,10,"""39""",39960,40020
4819,405100,405902,60,39420,10,"""39""",40020,40080
4819,405902,406500,60,39420,10,"""39""",40080,40140
4819,406500,400601,120,39420,10,"""39""",40140,40260
4819,400601,404300,60,39420,10,"""39""",40260,40320
4819,404300,407401,60,39420,10,"""39""",40320,40380
4819,407401,404103,120,39420,10,"""39""",40380,40500
4819,404103,403104,120,39420,10,"""39""",40500,40620
4819,403104,112101,180,39420,10,"""39""",40620,40800
4819,112101,103001,180,39420,10,"""39""",40800,40980
4819,103001,106501,60,39420,10,"""39""",40980,41040
4819,106501,119006,180,39420,10,"""39""",41040,41220
4819,119006,302501,120,39420,10,"""39""",41220,41340
4819,302501,303001,60,39420,10,"""39""",41340,41400
4819,303001,302201,120,39420,10,"""39""",41400,41520
4819,302201,302001,60,39420,10,"""39""",41520,41580
4819,302001,302100,120,39420,10,"""39""",41580,41700
4819,400200,33702,240,40620,10,"""39""",40620,40860
4819,33702,402204,60,40620,10,"""39""",40860,40920
4819,402204,402900,60,40620,10,"""39""",40920,40980
4819,402900,405300,120,40620,10,"""39""",40980,41100
4819,405300,402800,60,40620,10,"""39""",41100,41160
4819,402800,405100,60,40620,10,"""39""",41160,41220
4819,405100,405902,60,40620,10,"""39""",41220,41280
4819,405902,406500,60,40620,10,"""39""",41280,41340
4819,406500,400601,120,40620,10,"""39""",41340,41460
4819,400601,404300,60,40620,10,"""39""",41460,41520
4819,404300,407401,60,40620,10,"""39""",41520,41580
4819,407401,404103,120,40620,10,"""39""",41580,41700
4819,404103,403104,120,40620,10,"""39""",41700,41820
4819,403104,112101,180,40620,10,"""39""",41820,42000
4819,112101,103001,180,40620,10,"""39""",42000,42180
4819,103001,106501,60,40620,10,"""39""",42180,42240
4819,106501,119006,180,40620,10,"""39""",42240,42420
4819,119006,302501,120,40620,10,"""39""",42420,42540
4819,302501,303001,60,40620,10,"""39""",42540,42600
4819,303001,302201,120,40620,10,"""39""",42600,42720
4819,302201,302001,60,40620,10,"""39""",42720,42780
4819,302001,302100,120,40620,10,"""39""",42780,42900
4819,400200,33702,240,41820,10,"""39""",41820,42060
4819,33702,402204,60,41820,10,"""39""",42060,42120
4819,402204,402900,60,41820,10,"""39""",42120,42180
4819,402900,405300,120,41820,10,"""39""",42180,42300
4819,405300,402800,60,41820,10,"""39""",42300,42360
4819,402800,405100,60,41820,10,"""39""",42360,42420
4819,405100,405902,60,41820,10,"""39""",42420,42480
4819,405902,406500,60,41820,10,"""39""",42480,42540
4819,406500,400601,120,41820,10,"""39""",42540,42660
4819,400601,404300,60,41820,10,"""39""",42660,42720
4819,404300,407401,60,41820,10,"""39""",42720,42780
4819,407401,404103,120,41820,10,"""39""",42780,42900
4819,404103,403104,120,41820,10,"""39""",42900,43020
4819,403104,112101,180,41820,10,"""39""",43020,43200
4819,112101,103001,180,41820,10,"""39""",43200,43380
4819,103001,106501,60,41820,10,"""39""",43380,43440
4819,106501,119006,180,41820,10,"""39""",43440,43620
4819,119006,302501,120,41820,10,"""39""",43620,43740
4819,302501,303001,60,41820,10,"""39""",43740,43800
4819,303001,302201,120,41820,10,"""39""",43800,43920
4819,302201,302001,60,41820,10,"""39""",43920,43980
4819,302001,302100,120,41820,10,"""39""",43980,44100
4819,400200,33702,240,43020,10,"""39""",43020,43260
4819,33702,402204,60,43020,10,"""39""",43260,43320
4819,402204,402900,60,43020,10,"""39""",43320,43380
4819,402900,405300,120,43020,10,"""39""",43380,43500
4819,405300,402800,60,43020,10,"""39""",43500,43560
4819,402800,405100,60,43020,10,"""39""",43560,43620
4819,405100,405902,60,43020,10,"""39""",43620,43680
4819,405902,406500,60,43020,10,"""39""",43680,43740
4819,406500,400601,120,43020,10,"""39""",43740,43860
4819,400601,404300,60,43020,10,"""39""",43860,43920
4819,404300,407401,60,43020,10,"""39""",43920,43980
4819,407401,404103,120,43020,10,"""39""",43980,44100
4819,404103,403104,120,43020,10,"""39""",44100,44220
4819,403104,112101,180,43020,10,"""39""",44220,44400
4819,112101,103001,180,43020,10,"""39""",44400,44580
4819,103001,106501,60,43020,10,"""39""",44580,44640
4819,106501,119006,180,43020,10,"""39""",44640,44820
4819,119006,302501,120,43020,10,"""39""",44820,44940
4819,302501,303001,60,43020,10,"""39""",44940,45000
4819,303001,302201,120,43020,10,"""39""",45000,45120
4819,302201,302001,60,43020,10,"""39""",45120,45180
4819,302001,302100,120,43020,10,"""39""",45180,45300
4819,400200,33702,240,44220,10,"""39""",44220,44460
4819,33702,402204,60,44220,10,"""39""",44460,44520
4819,402204,402900,60,44220,10,"""39""",44520,44580
4819,402900,405300,120,44220,10,"""39""",44580,44700
4819,405300,402800,60,44220,10,"""39""",44700,44760
4819,402800,405100,60,44220,10,"""39""",44760,44820
4819,405100,405902,60,44220,10,"""39""",44820,44880
4819,405902,406500,60,44220,10,"""39""",44880,44940
4819,406500,400601,120,44220,10,"""39""",44940,45060
4819,400601,404300,60,44220,10,"""39""",45060,45120
4819,404300,407401,60,44220,10,"""39""",45120,45180
4819,407401,404103,120,44220,10,"""39""",45180,45300
4819,404103,403104,120,44220,10,"""39""",45300,45420
4819,403104,112101,180,44220,10,"""39""",45420,45600
4819,112101,103001,180,44220,10,"""39""",45600,45780
4819,103001,106501,60,44220,10,"""39""",45780,45840
4819,106501,119006,180,44220,10,"""39""",45840,46020
4819,119006,302501,120,44220,10,"""39""",46020,46140
4819,302501,303001,60,44220,10,"""39""",46140,46200
4819,303001,302201,120,44220,10,"""39""",46200,46320
4819,302201,302001,60,44220,10,"""39""",46320,46380
4819,302001,302100,120,44220,10,"""39""",46380,46500
4819,400200,33702,240,45420,10,"""39""",45420,45660
4819,33702,402204,60,45420,10,"""39""",45660,45720
4819,402204,402900,60,45420,10,"""39""",45720,45780
4819,402900,405300,120,45420,10,"""39""",45780,45900
4819,405300,402800,60,45420,10,"""39""",45900,45960
4819,402800,405100,60,45420,10,"""39""",45960,46020
4819,405100,405902,60,45420,10,"""39""",46020,46080
4819,405902,406500,60,45420,10,"""39""",46080,46140
4819,406500,400601,120,45420,10,"""39""",46140,46260
4819,400601,404300,60,45420,10,"""39""",46260,46320
4819,404300,407401,60,45420,10,"""39""",46320,46380
4819,407401,404103,120,45420,10,"""39""",46380,46500
4819,404103,403104,120,45420,10,"""39""",46500,46620
4819,403104,112101,180,45420,10,"""39""",46620,46800
4819,112101,103001,180,45420,10,"""39""",46800,46980
4819,103001,106501,60,45420,10,"""39""",46980,47040
4819,106501,119006,180,45420,10,"""39""",47040,47220
4819,119006,302501,120,45420,10,"""39""",47220,47340
4819,302501,303001,60,45420,10,"""39""",47340,47400
4819,303001,302201,120,45420,10,"""39""",47400,47520
4819,302201,302001,60,45420,10,"""39""",47520,47580
4819,302001,302100,120,45420,10,"""39""",47580,47700
4819,400200,33702,240,46620,10,"""39""",46620,46860
4819,33702,402204,60,46620,10,"""39""",46860,46920
4819,402204,402900,60,46620,10,"""39""",46920,46980
4819,402900,405300,120,46620,10,"""39""",46980,47100
4819,405300,402800,60,46620,10,"""39""",47100,47160
4819,402800,405100,60,46620,10,"""39""",47160,47220
4819,405100,405902,60,46620,10,"""39""",47220,47280
4819,405902,406500,60,46620,10,"""39""",47280,47340
4819,406500,400601,120,46620,10,"""39""",47340,47460
4819,400601,404300,60,46620,10,"""39""",47460,47520
4819,404300,407401,60,46620,10,"""39""",47520,47580
4819,407401,404103,120,46620,10,"""39""",47580,47700
4819,404103,403104,120,46620,10,"""39""",47700,47820
4819,403104,112101,180,46620,10,"""39""",47820,48000
4819,112101,103001,180,46620,10,"""39""",48000,48180
4819,103001,106501,60,46620,10,"""39""",48180,48240
4819,106501,119006,180,46620,10,"""39""",48240,48420
4819,119006,302501,120,46620,10,"""39""",48420,48540
4819,302501,303001,60,46620,10,"""39""",48540,48600
4819,303001,302201,120,46620,10,"""39""",48600,48720
4819,302201,302001,60,46620,10,"""39""",48720,48780
4819,302001,302100,120,46620,10,"""39""",48780,48900
4819,400200,33702,240,47820,10,"""39""",47820,48060
4819,33702,402204,60,47820,10,"""39""",48060,48120
4819,402204,402900,60,47820,10,"""39""",48120,48180
4819,402900,405300,120,47820,10,"""39""",48180,48300
4819,405300,402800,60,47820,10,"""39""",48300,48360
4819,402800,405100,60,47820,10,"""39""",48360,48420
4819,405100,405902,60,47820,10,"""39""",48420,48480
4819,405902,406500,60,47820,10,"""39""",48480,48540
4819,406500,400601,120,47820,10,"""39""",48540,48660
4819,400601,404300,60,47820,10,"""39""",48660,48720
4819,404300,407401,60,47820,10,"""39""",48720,48780
4819,407401,404103,120,47820,10,"""39""",48780,48900
4819,404103,403104,120,47820,10,"""39""",48900,49020
4819,403104,112101,180,47820,10,"""39""",49020,49200
4819,112101,103001,180,47820,10,"""39""",49200,49380
4819,103001,106501,60,47820,10,"""39""",49380,49440
4819,106501,119006,180,47820,10,"""39""",49440,49620
4819,119006,302501,120,47820,10,"""39""",49620,49740
4819,302501,303001,60,47820,10,"""39""",49740,49800
4819,303001,302201,120,47820,10,"""39""",49800,49920
4819,302201,302001,60,47820,10,"""39""",49920,49980
4819,302001,302100,120,47820,10,"""39""",49980,50100
4819,400200,33702,240,49020,10,"""39""",49020,49260
4819,33702,402204,60,49020,10,"""39""",49260,49320
4819,402204,402900,60,49020,10,"""39""",49320,49380
4819,402900,405300,120,49020,10,"""39""",49380,49500
4819,405300,402800,60,49020,10,"""39""",49500,49560
4819,402800,405100,60,49020,10,"""39""",49560,49620
4819,405100,405902,60,49020,10,"""39""",49620,49680
4819,405902,406500,60,49020,10,"""39""",49680,49740
4819,406500,400601,120,49020,10,"""39""",49740,49860
4819,400601,404300,60,49020,10,"""39""",49860,49920
4819,404300,407401,60,49020,10,"""39""",49920,49980
4819,407401,404103,120,49020,10,"""39""",49980,50100
4819,404103,403104,120,49020,10,"""39""",50100,50220
4819,403104,112101,180,49020,10,"""39""",50220,50400
4819,112101,103001,180,49020,10,"""39""",50400,50580
4819,103001,106501,60,49020,10,"""39""",50580,50640
4819,106501,119006,180,49020,10,"""39""",50640,50820
4819,119006,302501,120,49020,10,"""39""",50820,50940
4819,302501,303001,60,49020,10,"""39""",50940,51000
4819,303001,302201,120,49020,10,"""39""",51000,51120
4819,302201,302001,60,49020,10,"""39""",51120,51180
4819,302001,302100,120,49020,10,"""39""",51180,51300
4819,400200,33702,240,50220,10,"""39""",50220,50460
4819,33702,402204,60,50220,10,"""39""",50460,50520
4819,402204,402900,60,50220,10,"""39""",50520,50580
4819,402900,405300,120,50220,10,"""39""",50580,50700
4819,405300,402800,60,50220,10,"""39""",50700,50760
4819,402800,405100,60,50220,10,"""39""",50760,50820
4819,405100,405902,60,50220,10,"""39""",50820,50880
4819,405902,406500,60,50220,10,"""39""",50880,50940
4819,406500,400601,120,50220,10,"""39""",50940,51060
4819,400601,404300,60,50220,10,"""39""",51060,51120
4819,404300,407401,60,50220,10,"""39""",51120,51180
4819,407401,404103,120,50220,10,"""39""",51180,51300
4819,404103,403104,120,50220,10,"""39""",51300,51420
4819,403104,112101,180,50220,10,"""39""",51420,51600
4819,112101,103001,180,50220,10,"""39""",51600,51780
4819,103001,106501,60,50220,10,"""39""",51780,51840
4819,106501,119006,180,50220,10,"""39""",51840,52020
4819,119006,302501,120,50220,10,"""39""",52020,52140
4819,302501,303001,60,50220,10,"""39""",52140,52200
4819,303001,302201,120,50220,10,"""39""",52200,52320
4819,302201,302001,60,50220,10,"""39""",52320,52380
4819,302001,302100,120,50220,10,"""39""",52380,52500
4819,400200,33702,240,51420,10,"""39""",51420,51660
4819,33702,402204,60,51420,10,"""39""",51660,51720
4819,402204,402900,60,51420,10,"""39""",51720,51780
4819,402900,405300,120,51420,10,"""39""",51780,51900
4819,405300,402800,60,51420,10,"""39""",51900,51960
4819,402800,405100,60,51420,10,"""39""",51960,52020
4819,405100,405902,60,51420,10,"""39""",52020,52080
4819,405902,406500,60,51420,10,"""39""",52080,52140
4819,406500,400601,120,51420,10,"""39""",52140,52260
4819,400601,404300,60,51420,10,"""39""",52260,52320
4819,404300,407401,60,51420,10,"""39""",52320,52380
4819,407401,404103,120,51420,10,"""39""",52380,52500
4819,404103,403104,120,51420,10,"""39""",52500,52620
4819,403104,112101,180,51420,10,"""39""",52620,52800
4819,112101,103001,180,51420,10,"""39""",52800,52980
4819,103001,106501,60,51420,10,"""39""",52980,53040
4819,106501,119006,180,51420,10,"""39""",53040,53220
4819,119006,302501,120,51420,10,"""39""",53220,53340
4819,302501,303001,60,51420,10,"""39""",53340,53400
4819,303001,302201,120,51420,10,"""39""",53400,53520
4819,302201,302001,60,51420,10,"""39""",53520,53580
4819,302001,302100,120,51420,10,"""39""",53580,53700
4819,400200,33702,240,52620,10,"""39""",52620,52860
4819,33702,402204,60,52620,10,"""39""",52860,52920
4819,402204,402900,60,52620,10,"""39""",52920,52980
4819,402900,405300,120,52620,10,"""39""",52980,53100
4819,405300,402800,60,52620,10,"""39""",53100,53160
4819,402800,405100,60,52620,10,"""39""",53160,53220
4819,405100,405902,60,52620,10,"""39""",53220,53280
4819,405902,406500,60,52620,10,"""39""",53280,53340
4819,406500,400601,120,52620,10,"""39""",53340,53460
4819,400601,404300,60,52620,10,"""39""",53460,53520
4819,404300,407401,60,52620,10,"""39""",53520,53580
4819,407401,404103,120,52620,10,"""39""",53580,53700
4819,404103,403104,120,52620,10,"""39""",53700,53820
4819,403104,112101,180,52620,10,"""39""",53820,54000
4819,112101,103001,180,52620,10,"""39""",54000,54180
4819,103001,106501,60,52620,10,"""39""",54180,54240
4819,106501,119006,180,52620,10,"""39""",54240,54420
4819,119006,302501,120,52620,10,"""39""",54420,54540
4819,302501,303001,60,52620,10,"""39""",54540,54600
4819,303001,302201,120,52620,10,"""39""",54600,54720
4819,302201,302001,60,52620,10,"""39""",54720,54780
4819,302001,302100,120,52620,10,"""39""",54780,54900
4819,400200,33702,240,53820,10,"""39""",53820,54060
4819,33702,402204,60,53820,10,"""39""",54060,54120
4819,402204,402900,60,53820,10,"""39""",54120,54180
4819,402900,405300,120,53820,10,"""39""",54180,54300
4819,405300,402800,60,53820,10,"""39""",54300,54360
4819,402800,405100,60,53820,10,"""39""",54360,54420
4819,405100,405902,60,53820,10,"""39""",54420,54480
4819,405902,406500,60,53820,10,"""39""",54480,54540
4819,406500,400601,120,53820,10,"""39""",54540,54660
4819,400601,404300,60,53820,10,"""39""",54660,54720
4819,404300,407401,60,53820,10,"""39""",54720,54780
4819,407401,404103,120,53820,10,"""39""",54780,54900
4819,404103,403104,120,53820,10,"""39""",54900,55020
4819,403104,112101,180,53820,10,"""39""",55020,55200
4819,112101,103001,180,53820,10,"""39""",55200,55380
4819,103001,106501,60,53820,10,"""39""",55380,55440
4819,106501,119006,180,53820,10,"""39""",55440,55620
4819,119006,302501,120,53820,10,"""39""",55620,55740
4819,302501,303001,60,53820,10,"""39""",55740,55800
4819,303001,302201,120,53820,10,"""39""",55800,55920
4819,302201,302001,60,53820,10,"""39""",55920,55980
4819,302001,302100,120,53820,10,"""39""",55980,56100
4819,400200,33702,240,55020,10,"""39""",55020,55260
4819,33702,402204,60,55020,10,"""39""",55260,55320
4819,402204,402900,60,55020,10,"""39""",55320,55380
4819,402900,405300,120,55020,10,"""39""",55380,55500
4819,405300,402800,60,55020,10,"""39""",55500,55560
4819,402800,405100,60,55020,10,"""39""",55560,55620
4819,405100,405902,60,55020,10,"""39""",55620,55680
4819,405902,406500,60,55020,10,"""39""",55680,55740
4819,406500,400601,120,55020,10,"""39""",55740,55860
4819,400601,404300,60,55020,10,"""39""",55860,55920
4819,404300,407401,60,55020,10,"""39""",55920,55980
4819,407401,404103,120,55020,10,"""39""",55980,56100
4819,404103,403104,120,55020,10,"""39""",56100,56220
4819,403104,112101,180,55020,10,"""39""",56220,56400
4819,112101,103001,180,55020,10,"""39""",56400,56580
4819,103001,106501,60,55020,10,"""39""",56580,56640
4819,106501,119006,180,55020,10,"""39""",56640,56820
4819,119006,302501,120,55020,10,"""39""",56820,56940
4819,302501,303001,60,55020,10,"""39""",56940,57000
4819,303001,302201,120,55020,10,"""39""",57000,57120
4819,302201,302001,60,55020,10,"""39""",57120,57180
4819,302001,302100,120,55020,10,"""39""",57180,57300
4819,400200,33702,240,56220,10,"""39""",56220,56460
4819,33702,402204,60,56220,10,"""39""",56460,56520
4819,402204,402900,60,56220,10,"""39""",56520,56580
4819,402900,405300,120,56220,10,"""39""",56580,56700
4819,405300,402800,60,56220,10,"""39""",56700,56760
4819,402800,405100,60,56220,10,"""39""",56760,56820
4819,405100,405902,60,56220,10,"""39""",56820,56880
4819,405902,406500,60,56220,10,"""39""",56880,56940
4819,406500,400601,120,56220,10,"""39""",56940,57060
4819,400601,404300,60,56220,10,"""39""",57060,57120
4819,404300,407401,60,56220,10,"""39""",57120,57180
4819,407401,404103,120,56220,10,"""39""",57180,57300
4819,404103,403104,120,56220,10,"""39""",57300,57420
4819,403104,112101,180,56220,10,"""39""",57420,57600
4819,112101,103001,180,56220,10,"""39""",57600,57780
4819,103001,106501,60,56220,10,"""39""",57780,57840
4819,106501,119006,180,56220,10,"""39""",57840,58020
4819,119006,302501,120,56220,10,"""39""",58020,58140
4819,302501,303001,60,56220,10,"""39""",58140,58200
4819,303001,302201,120,56220,10,"""39""",58200,58320
4819,302201,302001,60,56220,10,"""39""",58320,58380
4819,302001,302100,120,56220,10,"""39""",58380,58500
4819,400200,33702,240,57420,10,"""39""",57420,57660
4819,33702,402204,60,57420,10,"""39""",57660,57720
4819,402204,402900,60,57420,10,"""39""",57720,57780
4819,402900,405300,120,57420,10,"""39""",57780,57900
4819,405300,402800,60,57420,10,"""39""",57900,57960
4819,402800,405100,60,57420,10,"""39""",57960,58020
4819,405100,405902,60,57420,10,"""39""",58020,58080
4819,405902,406500,60,57420,10,"""39""",58080,58140
4819,406500,400601,120,57420,10,"""39""",58140,58260
4819,400601,404300,60,57420,10,"""39""",58260,58320
4819,404300,407401,60,57420,10,"""39""",58320,58380
4819,407401,404103,120,57420,10,"""39""",58380,58500
4819,404103,403104,120,57420,10,"""39""",58500,58620
4819,403104,112101,180,57420,10,"""39""",58620,58800
4819,112101,103001,180,57420,10,"""39""",58800,58980
4819,103001,106501,60,57420,10,"""39""",58980,59040
4819,106501,119006,180,57420,10,"""39""",59040,59220
4819,119006,302501,120,57420,10,"""39""",59220,59340
4819,302501,303001,60,57420,10,"""39""",59340,59400
4819,303001,302201,120,57420,10,"""39""",59400,59520
4819,302201,302001,60,57420,10,"""39""",59520,59580
4819,302001,302100,120,57420,10,"""39""",59580,59700
4819,400200,33702,240,58620,10,"""39""",58620,58860
4819,33702,402204,60,58620,10,"""39""",58860,58920
4819,402204,402900,60,58620,10,"""39""",58920,58980
4819,402900,405300,120,58620,10,"""39""",58980,59100
4819,405300,402800,60,58620,10,"""39""",59100,59160
4819,402800,405100,60,58620,10,"""39""",59160,59220
4819,405100,405902,60,58620,10,"""39""",59220,59280
4819,405902,406500,60,58620,10,"""39""",59280,59340
4819,406500,400601,120,58620,10,"""39""",59340,59460
4819,400601,404300,60,58620,10,"""39""",59460,59520
4819,404300,407401,60,58620,10,"""39""",59520,59580
4819,407401,404103,120,58620,10,"""39""",59580,59700
4819,404103,403104,120,58620,10,"""39""",59700,59820
4819,403104,112101,180,58620,10,"""39""",59820,60000
4819,112101,103001,180,58620,10,"""39""",60000,60180
4819,103001,106501,60,58620,10,"""39""",60180,60240
4819,106501,119006,180,58620,10,"""39""",60240,60420
4819,119006,302501,120,58620,10,"""39""",60420,60540
4819,302501,303001,60,58620,10,"""39""",60540,60600
4819,303001,302201,120,58620,10,"""39""",60600,60720
4819,302201,302001,60,58620,10,"""39""",60720,60780
4819,302001,302100,120,58620,10,"""39""",60780,60900
4819,400200,33702,240,59820,10,"""39""",59820,60060
4819,33702,402204,60,59820,10,"""39""",60060,60120
4819,402204,402900,60,59820,10,"""39""",60120,60180
4819,402900,405300,120,59820,10,"""39""",60180,60300
4819,405300,402800,60,59820,10,"""39""",60300,60360
4819,402800,405100,60,59820,10,"""39""",60360,60420
4819,405100,405902,60,59820,10,"""39""",60420,60480
4819,405902,406500,60,59820,10,"""39""",60480,60540
4819,406500,400601,120,59820,10,"""39""",60540,60660
4819,400601,404300,60,59820,10,"""39""",60660,60720
4819,404300,407401,60,59820,10,"""39""",60720,60780
4819,407401,404103,120,59820,10,"""39""",60780,60900
4819,404103,403104,120,59820,10,"""39""",60900,61020
4819,403104,112101,180,59820,10,"""39""",61020,61200
4819,112101,103001,180,59820,10,"""39""",61200,61380
4819,103001,106501,60,59820,10,"""39""",61380,61440
4819,106501,119006,180,59820,10,"""39""",61440,61620
4819,119006,302501,120,59820,10,"""39""",61620,61740
4819,302501,303001,60,59820,10,"""39""",61740,61800
4819,303001,302201,120,59820,10,"""39""",61800,61920
4819,302201,302001,60,59820,10,"""39""",61920,61980
4819,302001,302100,120,59820,10,"""39""",61980,62100
4819,400200,33702,240,61020,10,"""39""",61020,61260
4819,33702,402204,60,61020,10,"""39""",61260,61320
4819,402204,402900,60,61020,10,"""39""",61320,61380
4819,402900,405300,120,61020,10,"""39""",61380,61500
4819,405300,402800,60,61020,10,"""39""",61500,61560
4819,402800,405100,60,61020,10,"""39""",61560,61620
4819,405100,405902,60,61020,10,"""39""",61620,61680
4819,405902,406500,60,61020,10,"""39""",61680,61740
4819,406500,400601,120,61020,10,"""39""",61740,61860
4819,400601,404300,60,61020,10,"""39""",61860,61920
4819,404300,407401,60,61020,10,"""39""",61920,61980
4819,407401,404103,120,61020,10,"""39""",61980,62100
4819,404103,403104,120,61020,10,"""39""",62100,62220
4819,403104,112101,180,61020,10,"""39""",62220,62400
4819,112101,103001,180,61020,10,"""39""",62400,62580
4819,103001,106501,60,61020,10,"""39""",62580,62640
4819,106501,119006,180,61020,10,"""39""",62640,62820
4819,119006,302501,120,61020,10,"""39""",62820,62940
4819,302501,303001,60,61020,10,"""39""",62940,63000
4819,303001,302201,120,61020,10,"""39""",63000,63120
4819,302201,302001,60,61020,10,"""39""",63120,63180
4819,302001,302100,120,61020,10,"""39""",63180,63300
4819,400200,33702,240,62220,10,"""39""",62220,62460
4819,33702,402204,60,62220,10,"""39""",62460,62520
4819,402204,402900,60,62220,10,"""39""",62520,62580
4819,402900,405300,120,62220,10,"""39""",62580,62700
4819,405300,402800,60,62220,10,"""39""",62700,62760
4819,402800,405100,60,62220,10,"""39""",62760,62820
4819,405100,405902,60,62220,10,"""39""",62820,62880
4819,405902,406500,60,62220,10,"""39""",62880,62940
4819,406500,400601,120,62220,10,"""39""",62940,63060
4819,400601,404300,60,62220,10,"""39""",63060,63120
4819,404300,407401,60,62220,10,"""39""",63120,63180
4819,407401,404103,120,62220,10,"""39""",63180,63300
4819,404103,403104,120,62220,10,"""39""",63300,63420
4819,403104,112101,180,62220,10,"""39""",63420,63600
4819,112101,103001,180,62220,10,"""39""",63600,63780
4819,103001,106501,60,62220,10,"""39""",63780,63840
4819,106501,119006,180,62220,10,"""39""",63840,64020
4819,119006,302501,120,62220,10,"""39""",64020,64140
4819,302501,303001,60,62220,10,"""39""",64140,64200
4819,303001,302201,120,62220,10,"""39""",64200,64320
4819,302201,302001,60,62220,10,"""39""",64320,64380
4819,302001,302100,120,62220,10,"""39""",64380,64500
4819,400200,33702,240,63420,10,"""39""",63420,63660
4819,33702,402204,60,63420,10,"""39""",63660,63720
4819,402204,402900,60,63420,10,"""39""",63720,63780
4819,402900,405300,120,63420,10,"""39""",63780,63900
4819,405300,402800,60,63420,10,"""39""",63900,63960
4819,402800,405100,60,63420,10,"""39""",63960,64020
4819,405100,405902,60,63420,10,"""39""",64020,64080
4819,405902,406500,60,63420,10,"""39""",64080,64140
4819,406500,400601,120,63420,10,"""39""",64140,64260
4819,400601,404300,60,63420,10,"""39""",64260,64320
4819,404300,407401,60,63420,10,"""39""",64320,64380
4819,407401,404103,120,63420,10,"""39""",64380,64500
4819,404103,403104,120,63420,10,"""39""",64500,64620
4819,403104,112101,180,63420,10,"""39""",64620,64800
4819,112101,103001,180,63420,10,"""39""",64800,64980
4819,103001,106501,60,63420,10,"""39""",64980,65040
4819,106501,119006,180,63420,10,"""39""",65040,65220
4819,119006,302501,120,63420,10,"""39""",65220,65340
4819,302501,303001,60,63420,10,"""39""",65340,65400
4819,303001,302201,120,63420,10,"""39""",65400,65520
4819,302201,302001,60,63420,10,"""39""",65520,65580
4819,302001,302100,120,63420,10,"""39""",65580,65700
4830,202200,34602,120,62100,77,"""2""",62100,62220
4830,34602,204002,60,62100,77,"""2""",62220,62280
4830,204002,203402,60,62100,77,"""2""",62280,62340
4830,203402,203502,60,62100,77,"""2""",62340,62400
4830,203502,61603,60,62100,77,"""2""",62400,62460
4830,61603,208901,60,62100,77,"""2""",62460,62520
4830,208901,204602,120,62100,77,"""2""",62520,62640
4830,204602,200600,0,62100,77,"""2""",62640,62640
4830,200600,204200,60,62100,77,"""2""",62640,62700
4830,204200,204500,60,62100,77,"""2""",62700,62760
4830,204500,200500,120,62100,77,"""2""",62760,62880
4830,200500,205603,60,62100,77,"""2""",62880,62940
4830,205603,203604,120,62100,77,"""2""",62940,63060
4830,203604,201903,60,62100,77,"""2""",63060,63120
4830,201903,203900,120,62100,77,"""2""",63120,63240
4830,203900,201503,60,62100,77,"""2""",63240,63300
4830,201503,208103,120,62100,77,"""2""",63300,63420
4830,208103,119004,120,62100,77,"""2""",63420,63540
4830,119004,117002,60,62100,77,"""2""",63540,63600
4830,117002,105201,180,62100,77,"""2""",63600,63780
4830,105201,109018,120,62100,77,"""2""",63780,63900
5023,408000,34202,180,72060,62,"""1""",72060,72240
5023,34202,407701,60,72060,62,"""1""",72240,72300
5023,407701,400601,60,72060,62,"""1""",72300,72360
5023,400601,407200,60,72060,62,"""1""",72360,72420
5023,407200,101102,120,72060,62,"""1""",72420,72540
5023,101102,102001,120,72060,62,"""1""",72540,72660
5023,102001,101001,120,72060,62,"""1""",72660,72780
5023,408000,34202,180,73260,62,"""1""",73260,73440
5023,34202,407701,60,73260,62,"""1""",73440,73500
5023,407701,400601,60,73260,62,"""1""",73500,73560
5023,400601,407200,60,73260,62,"""1""",73560,73620
5023,407200,101102,120,73260,62,"""1""",73620,73740
5023,101102,102001,120,73260,62,"""1""",73740,73860
5023,102001,101001,120,73260,62,"""1""",73860,73980
5166,500403,103801,240,57600,73,"""9""",57600,57840
5166,103801,101103,660,57600,73,"""9""",57840,58500
5166,101103,109006,240,57600,73,"""9""",58500,58740
5166,500403,103801,240,57900,73,"""9""",57900,58140
5166,103801,101103,660,57900,73,"""9""",58140,58800
5166,101103,109006,240,57900,73,"""9""",58800,59040
5167,109006,500403,480,27300,73,"""10""",27300,27780
5167,500403,103801,240,27300,73,"""10""",27780,28020
5352,112105,103003,180,20040,1,"""4""",20040,20220
5352,103003,118002,120,20040,1,"""4""",20220,20340
5352,118002,106002,60,20040,1,"""4""",20340,20400
5352,106002,118102,60,20040,1,"""4""",20400,20460
5352,118102,101004,120,20040,1,"""4""",20460,20580
5352,101004,502802,120,20040,1,"""4""",20580,20700
5352,502802,500904,60,20040,1,"""4""",20700,20760
5352,500904,501602,60,20040,1,"""4""",20760,20820
5352,501602,501802,60,20040,1,"""4""",20820,20880
5352,501802,502000,60,20040,1,"""4""",20880,20940
5352,502000,501704,60,20040,1,"""4""",20940,21000
5352,501704,502502,60,20040,1,"""4""",21000,21060
5352,502502,501500,60,20040,1,"""4""",21060,21120
5352,501500,500500,60,20040,1,"""4""",21120,21180
5352,500500,500300,60,20040,1,"""4""",21180,21240
5352,500300,500200,60,20040,1,"""4""",21240,21300
5352,500200,502300,180,20040,1,"""4""",21300,21480
5372,404701,403601,0,21540,2,"""1""",21540,21540
5372,403601,402601,120,21540,2,"""1""",21540,21660
5372,402601,403701,60,21540,2,"""1""",21660,21720
5372,403701,404600,60,21540,2,"""1""",21720,21780
5372,404600,403700,60,21540,2,"""1""",21780,21840
5372,403700,403501,0,21540,2,"""1""",21840,21840
5372,403501,408402,60,21540,2,"""1""",21840,21900
5372,408402,407701,60,21540,2,"""1""",21900,21960
5372,407701,400601,120,21540,2,"""1""",21960,22080
5372,400601,407200,60,21540,2,"""1""",22080,22140
5372,407200,101102,120,21540,2,"""1""",22140,22260
5372,101102,102001,120,21540,2,"""1""",22260,22380
5372,102001,101001,120,21540,2,"""1""",22380,22500
5372,101001,118101,60,21540,2,"""1""",22500,22560
5372,118101,106001,60,21540,2,"""1""",22560,22620
5372,106001,118001,120,21540,2,"""1""",22620,22740
5372,118001,103004,180,21540,2,"""1""",22740,22920
5372,103004,112102,180,21540,2,"""1""",22920,23100
5372,112102,117001,180,21540,2,"""1""",23100,23280
5372,117001,404201,60,21540,2,"""1""",23280,23340
5372,404201,407101,60,21540,2,"""1""",23340,23400
5372,407101,405601,60,21540,2,"""1""",23400,23460
5372,405601,408502,60,21540,2,"""1""",23460,23520
5372,408502,400703,60,21540,2,"""1""",23520,23580
5372,400703,400800,60,21540,2,"""1""",23580,23640
5372,400800,408901,60,21540,2,"""1""",23640,23700
5372,408901,407501,120,21540,2,"""1""",23700,23820
5372,407501,407500,60,21540,2,"""1""",23820,23880
5372,404701,403601,0,22740,2,"""1""",22740,22740
5372,403601,402601,120,22740,2,"""1""",22740,22860
5372,402601,403701,60,22740,2,"""1""",22860,22920
5372,403701,404600,60,22740,2,"""1""",22920,22980
5372,404600,403700,60,22740,2,"""1""",22980,23040
5372,403700,403501,0,22740,2,"""1""",23040,23040
5372,403501,408402,60,22740,2,"""1""",23040,23100
5372,408402,407701,60,22740,2,"""1""",23100,23160
5372,407701,400601,120,22740,2,"""1""",23160,23280
5372,400601,407200,60,22740,2,"""1""",23280,23340
5372,407200,101102,120,22740,2,"""1""",23340,23460
5372,101102,102001,120,22740,2,"""1""",23460,23580
5372,102001,101001,120,22740,2,"""1""",23580,23700
5372,101001,118101,60,22740,2,"""1""",23700,23760
5372,118101,106001,60,22740,2,"""1""",23760,23820
5372,106001,118001,120,22740,2,"""1""",23820,23940
5372,118001,103004,180,22740,2,"""1""",23940,24120
5372,103004,112102,180,22740,2,"""1""",24120,24300
5372,112102,117001,180,22740,2,"""1""",24300,24480
5372,117001,404201,60,22740,2,"""1""",24480,24540
5372,404201,407101,60,22740,2,"""1""",24540,24600
5372,407101,405601,60,22740,2,"""1""",24600,24660
5372,405601,408502,60,22740,2,"""1""",24660,24720
5372,408502,400703,60,22740,2,"""1""",24720,24780
5372,400703,400800,60,22740,2,"""1""",24780,24840
5372,400800,408901,60,22740,2,"""1""",24840,24900
5372,408901,407501,120,22740,2,"""1""",24900,25020
5372,407501,407500,60,22740,2,"""1""",25020,25080
5372,404701,403601,0,23940,2,"""1""",23940,23940
5372,403601,402601,120,23940,2,"""1""",23940,24060
5372,402601,403701,60,23940,2,"""1""",24060,24120
5372,403701,404600,60,23940,2,"""1""",24120,24180
5372,404600,403700,60,23940,2,"""1""",24180,24240
5372,403700,403501,0,23940,2,"""1""",24240,24240
5372,403501,408402,60,23940,2,"""1""",24240,24300
5372,408402,407701,60,23940,2,"""1""",24300,24360
5372,407701,400601,120,23940,2,"""1""",24360,24480
5372,400601,407200,60,23940,2,"""1""",24480,24540
5372,407200,101102,120,23940,2,"""1""",24540,24660
5372,101102,102001,120,23940,2,"""1""",24660,24780
5372,102001,101001,120,23940,2,"""1""",24780,24900
5372,101001,118101,60,23940,2,"""1""",24900,24960
5372,118101,106001,60,23940,2,"""1""",24960,25020
5372,106001,118001,120,23940,2,"""1""",25020,25140
5372,118001,103004,180,23940,2,"""1""",25140,25320
5372,103004,112102,180,23940,2,"""1""",25320,25500
5372,112102,117001,180,23940,2,"""1""",25500,25680
5372,117001,404201,60,23940,2,"""1""",25680,25740
5372,404201,407101,60,23940,2,"""1""",25740,25800
5372,407101,405601,60,23940,2,"""1""",25800,25860
5372,405601,408502,60,23940,2,"""1""",25860,25920
5372,408502,400703,60,23940,2,"""1""",25920,25980
5372,400703,400800,60,23940,2,"""1""",25980,26040
5372,400800,408901,60,23940,2,"""1""",26040,26100
5372,408901,407501,120,23940,2,"""1""",26100,26220
5372,407501,407500,60,23940,2,"""1""",26220,26280
5372,404701,403601,0,25140,2,"""1""",25140,25140
5372,403601,402601,120,25140,2,"""1""",25140,25260
5372,402601,403701,60,25140,2,"""1""",25260,25320
5372,403701,404600,60,25140,2,"""1""",25320,25380
5372,404600,403700,60,25140,2,"""1""",25380,25440
5372,403700,403501,0,25140,2,"""1""",25440,25440
5372,403501,408402,60,25140,2,"""1""",25440,25500
5372,408402,407701,60,25140,2,"""1""",25500,25560
5372,407701,400601,120,25140,2,"""1""",25560,25680
5372,400601,407200,60,25140,2,"""1""",25680,25740
5372,407200,101102,120,25140,2,"""1""",25740,25860
5372,101102,102001,120,25140,2,"""1""",25860,25980
5372,102001,101001,120,25140,2,"""1""",25980,26100
5372,101001,118101,60,25140,2,"""1""",26100,26160
5372,118101,106001,60,25140,2,"""1""",26160,26220
5372,106001,118001,120,25140,2,"""1""",26220,26340
5372,118001,103004,180,25140,2,"""1""",26340,26520
5372,103004,112102,180,25140,2,"""1""",26520,26700
5372,112102,117001,180,25140,2,"""1""",26700,26880
5372,117001,404201,60,25140,2,"""1""",26880,26940
5372,404201,407101,60,25140,2,"""1""",26940,27000
5372,407101,405601,60,25140,2,"""1""",27000,27060
5372,405601,408502,60,25140,2,"""1""",27060,27120
5372,408502,400703,60,25140,2,"""1""",27120,27180
5372,400703,400800,60,25140,2,"""1""",27180,27240
5372,400800,408901,60,25140,2,"""1""",27240,27300
5372,408901,407501,120,25140,2,"""1""",27300,27420
5372,407501,407500,60,25140,2,"""1""",27420,27480
5372,404701,403601,0,26340,2,"""1""",26340,26340
5372,403601,402601,120,26340,2,"""1""",26340,26460
5372,402601,403701,60,26340,2,"""1""",26460,26520
5372,403701,404600,60,26340,2,"""1""",26520,26580
5372,404600,403700,60,26340,2,"""1""",26580,26640
5372,403700,403501,0,26340,2,"""1""",26640,26640
5372,403501,408402,60,26340,2,"""1""",26640,26700
5372,408402,407701,60,26340,2,"""1""",26700,26760
5372,407701,400601,120,26340,2,"""1""",26760,26880
5372,400601,407200,60,26340,2,"""1""",26880,26940
5372,407200,101102,120,26340,2,"""1""",26940,27060
5372,101102,102001,120,26340,2,"""1""",27060,27180
5372,102001,101001,120,26340,2,"""1""",27180,27300
5372,101001,118101,60,26340,2,"""1""",27300,27360
5372,118101,106001,60,26340,2,"""1""",27360,27420
5372,106001,118001,120,26340,2,"""1""",27420,27540
5372,118001,103004,180,26340,2,"""1""",27540,27720
5372,103004,112102,180,26340,2,"""1""",27720,27900
5372,112102,117001,180,26340,2,"""1""",27900,28080
5372,117001,404201,60,26340,2,"""1""",28080,28140
5372,404201,407101,60,26340,2,"""1""",28140,28200
5372,407101,405601,60,26340,2,"""1""",28200,28260
5372,405601,408502,60,26340,2,"""1""",28260,28320
5372,408502,400703,60,26340,2,"""1""",28320,28380
5372,400703,400800,60,26340,2,"""1""",28380,28440
5372,400800,408901,60,26340,2,"""1""",28440,28500
5372,408901,407501,120,26340,2,"""1""",28500,28620
5372,407501,407500,60,26340,2,"""1""",28620,28680
5372,404701,403601,0,27540,2,"""1""",27540,27540
5372,403601,402601,120,27540,2,"""1""",27540,27660
5372,402601,403701,60,27540,2,"""1""",27660,27720
5372,403701,404600,60,27540,2,"""1""",27720,27780
5372,404600,403700,60,27540,2,"""1""",27780,27840
5372,403700,403501,0,27540,2,"""1""",27840,27840
5372,403501,408402,60,27540,2,"""1""",27840,27900
5372,408402,407701,60,27540,2,"""1""",27900,27960
5372,407701,400601,120,27540,2,"""1""",27960,28080
5372,400601,407200,60,27540,2,"""1""",28080,28140
5372,407200,101102,120,27540,2,"""1""",28140,28260
5372,101102,102001,120,27540,2,"""1""",28260,28380
5372,102001,101001,120,27540,2,"""1""",28380,28500
5372,101001,118101,60,27540,2,"""1""",28500,28560
5372,118101,106001,60,27540,2,"""1""",28560,28620
5372,106001,118001,120,27540,2,"""1""",28620,28740
5372,118001,103004,180,27540,2,"""1""",28740,28920
5372,103004,112102,180,27540,2,"""1""",28920,29100
5372,112102,117001,180,27540,2,"""1""",29100,29280
5372,117001,404201,60,27540,2,"""1""",29280,29340
5372,404201,407101,60,27540,2,"""1""",29340,29400
5372,407101,405601,60,27540,2,"""1""",29400,29460
5372,405601,408502,60,27540,2,"""1""",29460,29520
5372,408502,400703,60,27540,2,"""1""",29520,29580
5372,400703,400800,60,27540,2,"""1""",29580,29640
5372,400800,408901,60,27540,2,"""1""",29640,29700
5372,408901,407501,120,27540,2,"""1""",29700,29820
5372,407501,407500,60,27540,2,"""1""",29820,29880
5372,404701,403601,0,28740,2,"""1""",28740,28740
5372,403601,402601,120,28740,2,"""1""",28740,28860
5372,402601,403701,60,28740,2,"""1""",28860,28920
5372,403701,404600,60,28740,2,"""1""",28920,28980
5372,404600,403700,60,28740,2,"""1""",28980,29040
5372,403700,403501,0,28740,2,"""1""",29040,29040
5372,403501,408402,60,28740,2,"""1""",29040,29100
5372,408402,407701,60,28740,2,"""1""",29100,29160
5372,407701,400601,120,28740,2,"""1""",29160,29280
5372,400601,407200,60,28740,2,"""1""",29280,29340
5372,407200,101102,120,28740,2,"""1""",29340,29460
5372,101102,102001,120,28740,2,"""1""",29460,29580
5372,102001,101001,120,28740,2,"""1""",29580,29700
5372,101001,118101,60,28740,2,"""1""",29700,29760
5372,118101,106001,60,28740,2,"""1""",29760,29820
5372,106001,118001,120,28740,2,"""1""",29820,29940
5372,118001,103004,180,28740,2,"""1""",29940,30120
5372,103004,112102,180,28740,2,"""1""",30120,30300
5372,112102,117001,180,28740,2,"""1""",30300,30480
5372,117001,404201,60,28740,2,"""1""",30480,30540
5372,404201,407101,60,28740,2,"""1""",30540,30600
5372,407101,405601,60,28740,2,"""1""",30600,30660
5372,405601,408502,60,28740,2,"""1""",30660,30720
5372,408502,400703,60,28740,2,"""1""",30720,30780
5372,400703,400800,60,28740,2,"""1""",30780,30840
5372,400800,408901,60,28740,2,"""1""",30840,30900
5372,408901,407501,120,28740,2,"""1""",30900,31020
5372,407501,407500,60,28740,2,"""1""",31020,31080
5372,404701,403601,0,29940,2,"""1""",29940,29940
5372,403601,402601,120,29940,2,"""1""",29940,30060
5372,402601,403701,60,29940,2,"""1""",30060,30120
5372,403701,404600,60,29940,2,"""1""",30120,30180
5372,404600,403700,60,29940,2,"""1""",30180,30240
5372,403700,403501,0,29940,2,"""1""",30240,30240
5372,403501,408402,60,29940,2,"""1""",30240,30300
5372,408402,407701,60,29940,2,"""1""",30300,30360
5372,407701,400601,120,29940,2,"""1""",30360,30480
5372,400601,407200,60,29940,2,"""1""",30480,30540
5372,407200,101102,120,29940,2,"""1""",30540,30660
5372,101102,102001,120,29940,2,"""1""",30660,30780
5372,102001,101001,120,29940,2,"""1""",30780,30900
5372,101001,118101,60,29940,2,"""1""",30900,30960
5372,118101,106001,60,29940,2,"""1""",30960,31020
5372,106001,118001,120,29940,2,"""1""",31020,31140
5372,118001,103004,180,29940,2,"""1""",31140,31320
5372,103004,112102,180,29940,2,"""1""",31320,31500
5372,112102,117001,180,29940,2,"""1""",31500,31680
5372,117001,404201,60,29940,2,"""1""",31680,31740
5372,404201,407101,60,29940,2,"""1""",31740,31800
5372,407101,405601,60,29940,2,"""1""",31800,31860
5372,405601,408502,60,29940,2,"""1""",31860,31920
5372,408502,400703,60,29940,2,"""1""",31920,31980
5372,400703,400800,60,29940,2,"""1""",31980,32040
5372,400800,408901,60,29940,2,"""1""",32040,32100
5372,408901,407501,120,29940,2,"""1""",32100,32220
5372,407501,407500,60,29940,2,"""1""",32220,32280
5372,404701,403601,0,31140,2,"""1""",31140,31140
5372,403601,402601,120,31140,2,"""1""",31140,31260
5372,402601,403701,60,31140,2,"""1""",31260,31320
5372,403701,404600,60,31140,2,"""1""",31320,31380
5372,404600,403700,60,31140,2,"""1""",31380,31440
5372,403700,403501,0,31140,2,"""1""",31440,31440
5372,403501,408402,60,31140,2,"""1""",31440,31500
5372,408402,407701,60,31140,2,"""1""",31500,31560
5372,407701,400601,120,31140,2,"""1""",31560,31680
5372,400601,407200,60,31140,2,"""1""",31680,31740
5372,407200,101102,120,31140,2,"""1""",31740,31860
5372,101102,102001,120,31140,2,"""1""",31860,31980
5372,102001,101001,120,31140,2,"""1""",31980,32100
5372,101001,118101,60,31140,2,"""1""",32100,32160
5372,118101,106001,60,31140,2,"""1""",32160,32220
5372,106001,118001,120,31140,2,"""1""",32220,32340
5372,118001,103004,180,31140,2,"""1""",32340,32520
5372,103004,112102,180,31140,2,"""1""",32520,32700
5372,112102,117001,180,31140,2,"""1""",32700,32880
5372,117001,404201,60,31140,2,"""1""",32880,32940
5372,404201,407101,60,31140,2,"""1""",32940,33000
5372,407101,405601,60,31140,2,"""1""",33000,33060
5372,405601,408502,60,31140,2,"""1""",33060,33120
5372,408502,400703,60,31140,2,"""1""",33120,33180
5372,400703,400800,60,31140,2,"""1""",33180,33240
5372,400800,408901,60,31140,2,"""1""",33240,33300
5372,408901,407501,120,31140,2,"""1""",33300,33420
5372,407501,407500,60,31140,2,"""1""",33420,33480
5372,404701,403601,0,32340,2,"""1""",32340,32340
5372,403601,402601,120,32340,2,"""1""",32340,32460
5372,402601,403701,60,32340,2,"""1""",32460,32520
5372,403701,404600,60,32340,2,"""1""",32520,32580
5372,404600,403700,60,32340,2,"""1""",32580,32640
5372,403700,403501,0,32340,2,"""1""",32640,32640
5372,403501,408402,60,32340,2,"""1""",32640,32700
5372,408402,407701,60,32340,2,"""1""",32700,32760
5372,407701,400601,120,32340,2,"""1""",32760,32880
5372,400601,407200,60,32340,2,"""1""",32880,32940
5372,407200,101102,120,32340,2,"""1""",32940,33060
5372,101102,102001,120,32340,2,"""1""",33060,33180
5372,102001,101001,120,32340,2,"""1""",33180,33300
5372,101001,118101,60,32340,2,"""1""",33300,33360
5372,118101,106001,60,32340,2,"""1""",33360,33420
5372,106001,118001,120,32340,2,"""1""",33420,33540
5372,118001,103004,180,32340,2,"""1""",33540,33720
5372,103004,112102,180,32340,2,"""1""",33720,33900
5372,112102,117001,180,32340,2,"""1""",33900,34080
5372,117001,404201,60,32340,2,"""1""",34080,34140
5372,404201,407101,60,32340,2,"""1""",34140,34200
5372,407101,405601,60,32340,2,"""1""",34200,34260
5372,405601,408502,60,32340,2,"""1""",34260,34320
5372,408502,400703,60,32340,2,"""1""",34320,34380
5372,400703,400800,60,32340,2,"""1""",34380,34440
5372,400800,408901,60,32340,2,"""1""",34440,34500
5372,408901,407501,120,32340,2,"""1""",34500,34620
5372,407501,407500,60,32340,2,"""1""",34620,34680
5372,404701,403601,0,33540,2,"""1""",33540,33540
5372,403601,402601,120,33540,2,"""1""",33540,33660
5372,402601,403701,60,33540,2,"""1""",33660,33720
5372,403701,404600,60,33540,2,"""1""",33720,33780
5372,404600,403700,60,33540,2,"""1""",33780,33840
5372,403700,403501,0,33540,2,"""1""",33840,33840
5372,403501,408402,60,33540,2,"""1""",33840,33900
5372,408402,407701,60,33540,2,"""1""",33900,33960
5372,407701,400601,120,33540,2,"""1""",33960,34080
5372,400601,407200,60,33540,2,"""1""",34080,34140
5372,407200,101102,120,33540,2,"""1""",34140,34260
5372,101102,102001,120,33540,2,"""1""",34260,34380
5372,102001,101001,120,33540,2,"""1""",34380,34500
5372,101001,118101,60,33540,2,"""1""",34500,34560
5372,118101,106001,60,33540,2,"""1""",34560,34620
5372,106001,118001,120,33540,2,"""1""",34620,34740
5372,118001,103004,180,33540,2,"""1""",34740,34920
5372,103004,112102,180,33540,2,"""1""",34920,35100
5372,112102,117001,180,33540,2,"""1""",35100,35280
5372,117001,404201,60,33540,2,"""1""",35280,35340
5372,404201,407101,60,33540,2,"""1""",35340,35400
5372,407101,405601,60,33540,2,"""1""",35400,35460
5372,405601,408502,60,33540,2,"""1""",35460,35520
5372,408502,400703,60,33540,2,"""1""",35520,35580
5372,400703,400800,60,33540,2,"""1""",35580,35640
5372,400800,408901,60,33540,2,"""1""",35640,35700
5372,408901,407501,120,33540,2,"""1""",35700,35820
5372,407501,407500,60,33540,2,"""1""",35820,35880
5372,404701,403601,0,34740,2,"""1""",34740,34740
5372,403601,402601,120,34740,2,"""1""",34740,34860
5372,402601,403701,60,34740,2,"""1""",34860,34920
5372,403701,404600,60,34740,2,"""1""",34920,34980
5372,404600,403700,60,34740,2,"""1""",34980,35040
5372,403700,403501,0,34740,2,"""1""",35040,35040
5372,403501,408402,60,34740,2,"""1""",35040,35100
5372,408402,407701,60,34740,2,"""1""",35100,35160
5372,407701,400601,120,34740,2,"""1""",35160,35280
5372,400601,407200,60,34740,2,"""1""",35280,35340
5372,407200,101102,120,34740,2,"""1""",35340,35460
5372,101102,102001,120,34740,2,"""1""",35460,35580
5372,102001,101001,120,34740,2,"""1""",35580,35700
5372,101001,118101,60,34740,2,"""1""",35700,35760
5372,118101,106001,60,34740,2,"""1""",35760,35820
5372,106001,118001,120,34740,2,"""1""",35820,35940
5372,118001,103004,180,34740,2,"""1""",35940,36120
5372,103004,112102,180,34740,2,"""1""",36120,36300
5372,112102,117001,180,34740,2,"""1""",36300,36480
5372,117001,404201,60,34740,2,"""1""",36480,36540
5372,404201,407101,60,34740,2,"""1""",36540,36600
5372,407101,405601,60,34740,2,"""1""",36600,36660
5372,405601,408502,60,34740,2,"""1""",36660,36720
5372,408502,400703,60,34740,2,"""1""",36720,36780
5372,400703,400800,60,34740,2,"""1""",36780,36840
5372,400800,408901,60,34740,2,"""1""",36840,36900
5372,408901,407501,120,34740,2,"""1""",36900,37020
5372,407501,407500,60,34740,2,"""1""",37020,37080
5372,404701,403601,0,35940,2,"""1""",35940,35940
5372,403601,402601,120,35940,2,"""1""",35940,36060
5372,402601,403701,60,35940,2,"""1""",36060,36120
5372,403701,404600,60,35940,2,"""1""",36120,36180
5372,404600,403700,60,35940,2,"""1""",36180,36240
5372,403700,403501,0,35940,2,"""1""",36240,36240
5372,403501,408402,60,35940,2,"""1""",36240,36300
5372,408402,407701,60,35940,2,"""1""",36300,36360
5372,407701,400601,120,35940,2,"""1""",36360,36480
5372,400601,407200,60,35940,2,"""1""",36480,36540
5372,407200,101102,120,35940,2,"""1""",36540,36660
5372,101102,102001,120,35940,2,"""1""",36660,36780
5372,102001,101001,120,35940,2,"""1""",36780,36900
5372,101001,118101,60,35940,2,"""1""",36900,36960
5372,118101,106001,60,35940,2,"""1""",36960,37020
5372,106001,118001,120,35940,2,"""1""",37020,37140
5372,118001,103004,180,35940,2,"""1""",37140,37320
5372,103004,112102,180,35940,2,"""1""",37320,37500
5372,112102,117001,180,35940,2,"""1""",37500,37680
5372,117001,404201,60,35940,2,"""1""",37680,37740
5372,404201,407101,60,35940,2,"""1""",37740,37800
5372,407101,405601,60,35940,2,"""1""",37800,37860
5372,405601,408502,60,35940,2,"""1""",37860,37920
5372,408502,400703,60,35940,2,"""1""",37920,37980
5372,400703,400800,60,35940,2,"""1""",37980,38040
5372,400800,408901,60,35940,2,"""1""",38040,38100
5372,408901,407501,120,35940,2,"""1""",38100,38220
5372,407501,407500,60,35940,2,"""1""",38220,38280
5372,404701,403601,0,37140,2,"""1""",37140,37140
5372,403601,402601,120,37140,2,"""1""",37140,37260
5372,402601,403701,60,37140,2,"""1""",37260,37320
5372,403701,404600,60,37140,2,"""1""",37320,37380
5372,404600,403700,60,37140,2,"""1""",37380,37440
5372,403700,403501,0,37140,2,"""1""",37440,37440
5372,403501,408402,60,37140,2,"""1""",37440,37500
5372,408402,407701,60,37140,2,"""1""",37500,37560
5372,407701,400601,120,37140,2,"""1""",37560,37680
5372,400601,407200,60,37140,2,"""1""",37680,37740
5372,407200,101102,120,37140,2,"""1""",37740,37860
5372,101102,102001,120,37140,2,"""1""",37860,37980
5372,102001,101001,120,37140,2,"""1""",37980,38100
5372,101001,118101,60,37140,2,"""1""",38100,38160
5372,118101,106001,60,37140,2,"""1""",38160,38220
5372,106001,118001,120,37140,2,"""1""",38220,38340
5372,118001,103004,180,37140,2,"""1""",38340,38520
5372,103004,112102,180,37140,2,"""1""",38520,38700
5372,112102,117001,180,37140,2,"""1""",38700,38880
5372,117001,404201,60,37140,2,"""1""",38880,38940
5372,404201,407101,60,37140,2,"""1""",38940,39000
5372,407101,405601,60,37140,2,"""1""",39000,39060
5372,405601,408502,60,37140,2,"""1""",39060,39120
5372,408502,400703,60,37140,2,"""1""",39120,39180
5372,400703,400800,60,37140,2,"""1""",39180,39240
5372,400800,408901,60,37140,2,"""1""",39240,39300
5372,408901,407501,120,37140,2,"""1""",39300,39420
5372,407501,407500,60,37140,2,"""1""",39420,39480
5372,404701,403601,0,38340,2,"""1""",38340,38340
5372,403601,402601,120,38340,2,"""1""",38340,38460
5372,402601,403701,60,38340,2,"""1""",38460,38520
5372,403701,404600,60,38340,2,"""1""",38520,38580
5372,404600,403700,60,38340,2,"""1""",38580,38640
5372,403700,403501,0,38340,2,"""1""",38640,38640
5372,403501,408402,60,38340,2,"""1""",38640,38700
5372,408402,407701,60,38340,2,"""1""",38700,38760
5372,407701,400601,120,38340,2,"""1""",38760,38880
5372,400601,407200,60,38340,2,"""1""",38880,38940
5372,407200,101102,120,38340,2,"""1""",38940,39060
5372,101102,102001,120,38340,2,"""1""",39060,39180
5372,102001,101001,120,38340,2,"""1""",39180,39300
5372,101001,118101,60,38340,2,"""1""",39300,39360
5372,118101,106001,60,38340,2,"""1""",39360,39420
5372,106001,118001,120,38340,2,"""1""",39420,39540
5372,118001,103004,180,38340,2,"""1""",39540,39720
5372,103004,112102,180,38340,2,"""1""",39720,39900
5372,112102,117001,180,38340,2,"""1""",39900,40080
5372,117001,404201,60,38340,2,"""1""",40080,40140
5372,404201,407101,60,38340,2,"""1""",40140,40200
5372,407101,405601,60,38340,2,"""1""",40200,40260
5372,405601,408502,60,38340,2,"""1""",40260,40320
5372,408502,400703,60,38340,2,"""1""",40320,40380
5372,400703,400800,60,38340,2,"""1""",40380,40440
5372,400800,408901,60,38340,2,"""1""",40440,40500
5372,408901,407501,120,38340,2,"""1""",40500,40620
5372,407501,407500,60,38340,2,"""1""",40620,40680
5372,404701,403601,0,39540,2,"""1""",39540,39540
5372,403601,402601,120,39540,2,"""1""",39540,39660
5372,402601,403701,60,39540,2,"""1""",39660,39720
5372,403701,404600,60,39540,2,"""1""",39720,39780
5372,404600,403700,60,39540,2,"""1""",39780,39840
5372,403700,403501,0,39540,2,"""1""",39840,39840
5372,403501,408402,60,39540,2,"""1""",39840,39900
5372,408402,407701,60,39540,2,"""1""",39900,39960
5372,407701,400601,120,39540,2,"""1""",39960,40080
5372,400601,407200,60,39540,2,"""1""",40080,40140
5372,407200,101102,120,39540,2,"""1""",40140,40260
5372,101102,102001,120,39540,2,"""1""",40260,40380
5372,102001,101001,120,39540,2,"""1""",40380,40500
5372,101001,118101,60,39540,2,"""1""",40500,40560
5372,118101,106001,60,39540,2,"""1""",40560,40620
5372,106001,118001,120,39540,2,"""1""",40620,40740
5372,118001,103004,180,39540,2,"""1""",40740,40920
5372,103004,112102,180,39540,2,"""1""",40920,41100
5372,112102,117001,180,39540,2,"""1""",41100,41280
5372,117001,404201,60,39540,2,"""1""",41280,41340
5372,404201,407101,60,39540,2,"""1""",41340,41400
5372,407101,405601,60,39540,2,"""1""",41400,41460
5372,405601,408502,60,39540,2,"""1""",41460,41520
5372,408502,400703,60,39540,2,"""1""",41520,41580
5372,400703,400800,60,39540,2,"""1""",41580,41640
5372,400800,408901,60,39540,2,"""1""",41640,41700
5372,408901,407501,120,39540,2,"""1""",41700,41820
5372,407501,407500,60,39540,2,"""1""",41820,41880
5372,404701,403601,0,40740,2,"""1""",40740,40740
5372,403601,402601,120,40740,2,"""1""",40740,40860
5372,402601,403701,60,40740,2,"""1""",40860,40920
5372,403701,404600,60,40740,2,"""1""",40920,40980
5372,404600,403700,60,40740,2,"""1""",40980,41040
5372,403700,403501,0,40740,2,"""1""",41040,41040
5372,403501,408402,60,40740,2,"""1""",41040,41100
5372,408402,407701,60,40740,2,"""1""",41100,41160
5372,407701,400601,120,40740,2,"""1""",41160,41280
5372,400601,407200,60,40740,2,"""1""",41280,41340
5372,407200,101102,120,40740,2,"""1""",41340,41460
5372,101102,102001,120,40740,2,"""1""",41460,41580
5372,102001,101001,120,40740,2,"""1""",41580,41700
5372,101001,118101,60,40740,2,"""1""",41700,41760
5372,118101,106001,60,40740,2,"""1""",41760,41820
5372,106001,118001,120,40740,2,"""1""",41820,41940
5372,118001,103004,180,40740,2,"""1""",41940,42120
5372,103004,112102,180,40740,2,"""1""",42120,42300
5372,112102,117001,180,40740,2,"""1""",42300,42480
5372,117001,404201,60,40740,2,"""1""",42480,42540
5372,404201,407101,60,40740,2,"""1""",42540,42600
5372,407101,405601,60,40740,2,"""1""",42600,42660
5372,405601,408502,60,40740,2,"""1""",42660,42720
5372,408502,400703,60,40740,2,"""1""",42720,42780
5372,400703,400800,60,40740,2,"""1""",42780,42840
5372,400800,408901,60,40740,2,"""1""",42840,42900
5372,408901,407501,120,40740,2,"""1""",42900,43020
5372,407501,407500,60,40740,2,"""1""",43020,43080
5372,404701,403601,0,41940,2,"""1""",41940,41940
5372,403601,402601,120,41940,2,"""1""",41940,42060
5372,402601,403701,60,41940,2,"""1""",42060,42120
5372,403701,404600,60,41940,2,"""1""",42120,42180
5372,404600,403700,60,41940,2,"""1""",42180,42240
5372,403700,403501,0,41940,2,"""1""",42240,42240
5372,403501,408402,60,41940,2,"""1""",42240,42300
5372,408402,407701,60,41940,2,"""1""",42300,42360
5372,407701,400601,120,41940,2,"""1""",42360,42480
5372,400601,407200,60,41940,2,"""1""",42480,42540
5372,407200,101102,120,41940,2,"""1""",42540,42660
5372,101102,102001,120,41940,2,"""1""",42660,42780
5372,102001,101001,120,41940,2,"""1""",42780,42900
5372,101001,118101,60,41940,2,"""1""",42900,42960
5372,118101,106001,60,41940,2,"""1""",42960,43020
5372,106001,118001,120,41940,2,"""1""",43020,43140
5372,118001,103004,180,41940,2,"""1""",43140,43320
5372,103004,112102,180,41940,2,"""1""",43320,43500
5372,112102,117001,180,41940,2,"""1""",43500,43680
5372,117001,404201,60,41940,2,"""1""",43680,43740
5372,404201,407101,60,41940,2,"""1""",43740,43800
5372,407101,405601,60,41940,2,"""1""",43800,43860
5372,405601,408502,60,41940,2,"""1""",43860,43920
5372,408502,400703,60,41940,2,"""1""",43920,43980
5372,400703,400800,60,41940,2,"""1""",43980,44040
5372,400800,408901,60,41940,2,"""1""",44040,44100
5372,408901,407501,120,41940,2,"""1""",44100,44220
5372,407501,407500,60,41940,2,"""1""",44220,44280
5372,404701,403601,0,43140,2,"""1""",43140,43140
5372,403601,402601,120,43140,2,"""1""",43140,43260
5372,402601,403701,60,43140,2,"""1""",43260,43320
5372,403701,404600,60,43140,2,"""1""",43320,43380
5372,404600,403700,60,43140,2,"""1""",43380,43440
5372,403700,403501,0,43140,2,"""1""",43440,43440
5372,403501,408402,60,43140,2,"""1""",43440,43500
5372,408402,407701,60,43140,2,"""1""",43500,43560
5372,407701,400601,120,43140,2,"""1""",43560,43680
5372,400601,407200,60,43140,2,"""1""",43680,43740
5372,407200,101102,120,43140,2,"""1""",43740,43860
5372,101102,102001,120,43140,2,"""1""",43860,43980
5372,102001,101001,120,43140,2,"""1""",43980,44100
5372,101001,118101,60,43140,2,"""1""",44100,44160
5372,118101,106001,60,43140,2,"""1""",44160,44220
5372,106001,118001,120,43140,2,"""1""",44220,44340
5372,118001,103004,180,43140,2,"""1""",44340,44520
5372,103004,112102,180,43140,2,"""1""",44520,44700
5372,112102,117001,180,43140,2,"""1""",44700,44880
5372,117001,404201,60,43140,2,"""1""",44880,44940
5372,404201,407101,60,43140,2,"""1""",44940,45000
5372,407101,405601,60,43140,2,"""1""",45000,45060
5372,405601,408502,60,43140,2,"""1""",45060,45120
5372,408502,400703,60,43140,2,"""1""",45120,45180
5372,400703,400800,60,43140,2,"""1""",45180,45240
5372,400800,408901,60,43140,2,"""1""",45240,45300
5372,408901,407501,120,43140,2,"""1""",45300,45420
5372,407501,407500,60,43140,2,"""1""",45420,45480
5372,404701,403601,0,44340,2,"""1""",44340,44340
5372,403601,402601,120,44340,2,"""1""",44340,44460
5372,402601,403701,60,44340,2,"""1""",44460,44520
5372,403701,404600,60,44340,2,"""1""",44520,44580
5372,404600,403700,60,44340,2,"""1""",44580,44640
5372,403700,403501,0,44340,2,"""1""",44640,44640
5372,403501,408402,60,44340,2,"""1""",44640,44700
5372,408402,407701,60,44340,2,"""1""",44700,44760
5372,407701,400601,120,44340,2,"""1""",44760,44880
5372,400601,407200,60,44340,2,"""1""",44880,44940
5372,407200,101102,120,44340,2,"""1""",44940,45060
5372,101102,102001,120,44340,2,"""1""",45060,45180
5372,102001,101001,120,44340,2,"""1""",45180,45300
5372,101001,118101,60,44340,2,"""1""",45300,45360
5372,118101,106001,60,44340,2,"""1""",45360,45420
5372,106001,118001,120,44340,2,"""1""",45420,45540
5372,118001,103004,180,44340,2,"""1""",45540,45720
5372,103004,112102,180,44340,2,"""1""",45720,45900
5372,112102,117001,180,44340,2,"""1""",45900,46080
5372,117001,404201,60,44340,2,"""1""",46080,46140
5372,404201,407101,60,44340,2,"""1""",46140,46200
5372,407101,405601,60,44340,2,"""1""",46200,46260
5372,405601,408502,60,44340,2,"""1""",46260,46320
5372,408502,400703,60,44340,2,"""1""",46320,46380
5372,400703,400800,60,44340,2,"""1""",46380,46440
5372,400800,408901,60,44340,2,"""1""",46440,46500
5372,408901,407501,120,44340,2,"""1""",46500,46620
5372,407501,407500,60,44340,2,"""1""",46620,46680
5372,404701,403601,0,45540,2,"""1""",45540,45540
5372,403601,402601,120,45540,2,"""1""",45540,45660
5372,402601,403701,60,45540,2,"""1""",45660,45720
5372,403701,404600,60,45540,2,"""1""",45720,45780
5372,404600,403700,60,45540,2,"""1""",45780,45840
5372,403700,403501,0,45540,2,"""1""",45840,45840
5372,403501,408402,60,45540,2,"""1""",45840,45900
5372,408402,407701,60,45540,2,"""1""",45900,45960
5372,407701,400601,120,45540,2,"""1""",45960,46080
5372,400601,407200,60,45540,2,"""1""",46080,46140
5372,407200,101102,120,45540,2,"""1""",46140,46260
5372,101102,102001,120,45540,2,"""1""",46260,46380
5372,102001,101001,120,45540,2,"""1""",46380,46500
5372,101001,118101,60,45540,2,"""1""",46500,46560
5372,118101,106001,60,45540,2,"""1""",46560,46620
5372,106001,118001,120,45540,2,"""1""",46620,46740
5372,118001,103004,180,45540,2,"""1""",46740,46920
5372,103004,112102,180,45540,2,"""1""",46920,47100
5372,112102,117001,180,45540,2,"""1""",47100,47280
5372,117001,404201,60,45540,2,"""1""",47280,47340
5372,404201,407101,60,45540,2,"""1""",47340,47400
5372,407101,405601,60,45540,2,"""1""",47400,47460
5372,405601,408502,60,45540,2,"""1""",47460,47520
5372,408502,400703,60,45540,2,"""1""",47520,47580
5372,400703,400800,60,45540,2,"""1""",47580,47640
5372,400800,408901,60,45540,2,"""1""",47640,47700
5372,408901,407501,120,45540,2,"""1""",47700,47820
5372,407501,407500,60,45540,2,"""1""",47820,47880
5372,404701,403601,0,46740,2,"""1""",46740,46740
5372,403601,402601,120,46740,2,"""1""",46740,46860
5372,402601,403701,60,46740,2,"""1""",46860,46920
5372,403701,404600,60,46740,2,"""1""",46920,46980
5372,404600,403700,60,46740,2,"""1""",46980,47040
5372,403700,403501,0,46740,2,"""1""",47040,47040
5372,403501,408402,60,46740,2,"""1""",47040,47100
5372,408402,407701,60,46740,2,"""1""",47100,47160
5372,407701,400601,120,46740,2,"""1""",47160,47280
5372,400601,407200,60,46740,2,"""1""",47280,47340
5372,407200,101102,120,46740,2,"""1""",47340,47460
5372,101102,102001,120,46740,2,"""1""",47460,47580
5372,102001,101001,120,46740,2,"""1""",47580,47700
5372,101001,118101,60,46740,2,"""1""",47700,47760
5372,118101,106001,60,46740,2,"""1""",47760,47820
5372,106001,118001,120,46740,2,"""1""",47820,47940
5372,118001,103004,180,46740,2,"""1""",47940,48120
5372,103004,112102,180,46740,2,"""1""",48120,48300
5372,112102,117001,180,46740,2,"""1""",48300,48480
5372,117001,404201,60,46740,2,"""1""",48480,48540
5372,404201,407101,60,46740,2,"""1""",48540,48600
5372,407101,405601,60,46740,2,"""1""",48600,48660
5372,405601,408502,60,46740,2,"""1""",48660,48720
5372,408502,400703,60,46740,2,"""1""",48720,48780
5372,400703,400800,60,46740,2,"""1""",48780,48840
5372,400800,408901,60,46740,2,"""1""",48840,48900
5372,408901,407501,120,46740,2,"""1""",48900,49020
5372,407501,407500,60,46740,2,"""1""",49020,49080
5372,404701,403601,0,47940,2,"""1""",47940,47940
5372,403601,402601,120,47940,2,"""1""",47940,48060
5372,402601,403701,60,47940,2,"""1""",48060,48120
5372,403701,404600,60,47940,2,"""1""",48120,48180
5372,404600,403700,60,47940,2,"""1""",48180,48240
5372,403700,403501,0,47940,2,"""1""",48240,48240
5372,403501,408402,60,47940,2,"""1""",48240,48300
5372,408402,407701,60,47940,2,"""1""",48300,48360
5372,407701,400601,120,47940,2,"""1""",48360,48480
5372,400601,407200,60,47940,2,"""1""",48480,48540
5372,407200,101102,120,47940,2,"""1""",48540,48660
5372,101102,102001,120,47940,2,"""1""",48660,48780
5372,102001,101001,120,47940,2,"""1""",48780,48900
5372,101001,118101,60,47940,2,"""1""",48900,48960
5372,118101,106001,60,47940,2,"""1""",48960,49020
5372,106001,118001,120,47940,2,"""1""",49020,49140
5372,118001,103004,180,47940,2,"""1""",49140,49320
5372,103004,112102,180,47940,2,"""1""",49320,49500
5372,112102,117001,180,47940,2,"""1""",49500,49680
5372,117001,404201,60,47940,2,"""1""",49680,49740
5372,404201,407101,60,47940,2,"""1""",49740,49800
5372,407101,405601,60,47940,2,"""1""",49800,49860
5372,405601,408502,60,47940,2,"""1""",49860,49920
5372,408502,400703,60,47940,2,"""1""",49920,49980
5372,400703,400800,60,47940,2,"""1""",49980,50040
5372,400800,408901,60,47940,2,"""1""",50040,50100
5372,408901,407501,120,47940,2,"""1""",50100,50220
5372,407501,407500,60,47940,2,"""1""",50220,50280
5372,404701,403601,0,49140,2,"""1""",49140,49140
5372,403601,402601,120,49140,2,"""1""",49140,49260
5372,402601,403701,60,49140,2,"""1""",49260,49320
5372,403701,404600,60,49140,2,"""1""",49320,49380
5372,404600,403700,60,49140,2,"""1""",49380,49440
5372,403700,403501,0,49140,2,"""1""",49440,49440
5372,403501,408402,60,49140,2,"""1""",49440,49500
5372,408402,407701,60,49140,2,"""1""",49500,49560
5372,407701,400601,120,49140,2,"""1""",49560,49680
5372,400601,407200,60,49140,2,"""1""",49680,49740
5372,407200,101102,120,49140,2,"""1""",49740,49860
5372,101102,102001,120,49140,2,"""1""",49860,49980
5372,102001,101001,120,49140,2,"""1""",49980,50100
5372,101001,118101,60,49140,2,"""1""",50100,50160
5372,118101,106001,60,49140,2,"""1""",50160,50220
5372,106001,118001,120,49140,2,"""1""",50220,50340
5372,118001,103004,180,49140,2,"""1""",50340,50520
5372,103004,112102,180,49140,2,"""1""",50520,50700
5372,112102,117001,180,49140,2,"""1""",50700,50880
5372,117001,404201,60,49140,2,"""1""",50880,50940
5372,404201,407101,60,49140,2,"""1""",50940,51000
5372,407101,405601,60,49140,2,"""1""",51000,51060
5372,405601,408502,60,49140,2,"""1""",51060,51120
5372,408502,400703,60,49140,2,"""1""",51120,51180
5372,400703,400800,60,49140,2,"""1""",51180,51240
5372,400800,408901,60,49140,2,"""1""",51240,51300
5372,408901,407501,120,49140,2,"""1""",51300,51420
5372,407501,407500,60,49140,2,"""1""",51420,51480
5372,404701,403601,0,50340,2,"""1""",50340,50340
5372,403601,402601,120,50340,2,"""1""",50340,50460
5372,402601,403701,60,50340,2,"""1""",50460,50520
5372,403701,404600,60,50340,2,"""1""",50520,50580
5372,404600,403700,60,50340,2,"""1""",50580,50640
5372,403700,403501,0,50340,2,"""1""",50640,50640
5372,403501,408402,60,50340,2,"""1""",50640,50700
5372,408402,407701,60,50340,2,"""1""",50700,50760
5372,407701,400601,120,50340,2,"""1""",50760,50880
5372,400601,407200,60,50340,2,"""1""",50880,50940
5372,407200,101102,120,50340,2,"""1""",50940,51060
5372,101102,102001,120,50340,2,"""1""",51060,51180
5372,102001,101001,120,50340,2,"""1""",51180,51300
5372,101001,118101,60,50340,2,"""1""",51300,51360
5372,118101,106001,60,50340,2,"""1""",51360,51420
5372,106001,118001,120,50340,2,"""1""",51420,51540
5372,118001,103004,180,50340,2,"""1""",51540,51720
5372,103004,112102,180,50340,2,"""1""",51720,51900
5372,112102,117001,180,50340,2,"""1""",51900,52080
5372,117001,404201,60,50340,2,"""1""",52080,52140
5372,404201,407101,60,50340,2,"""1""",52140,52200
5372,407101,405601,60,50340,2,"""1""",52200,52260
5372,405601,408502,60,50340,2,"""1""",52260,52320
5372,408502,400703,60,50340,2,"""1""",52320,52380
5372,400703,400800,60,50340,2,"""1""",52380,52440
5372,400800,408901,60,50340,2,"""1""",52440,52500
5372,408901,407501,120,50340,2,"""1""",52500,52620
5372,407501,407500,60,50340,2,"""1""",52620,52680
5372,404701,403601,0,51540,2,"""1""",51540,51540
5372,403601,402601,120,51540,2,"""1""",51540,51660
5372,402601,403701,60,51540,2,"""1""",51660,51720
5372,403701,404600,60,51540,2,"""1""",51720,51780
5372,404600,403700,60,51540,2,"""1""",51780,51840
5372,403700,403501,0,51540,2,"""1""",51840,51840
5372,403501,408402,60,51540,2,"""1""",51840,51900
5372,408402,407701,60,51540,2,"""1""",51900,51960
5372,407701,400601,120,51540,2,"""1""",51960,52080
5372,400601,407200,60,51540,2,"""1""",52080,52140
5372,407200,101102,120,51540,2,"""1""",52140,52260
5372,101102,102001,120,51540,2,"""1""",52260,52380
5372,102001,101001,120,51540,2,"""1""",52380,52500
5372,101001,118101,60,51540,2,"""1""",52500,52560
5372,118101,106001,60,51540,2,"""1""",52560,52620
5372,106001,118001,120,51540,2,"""1""",52620,52740
5372,118001,103004,180,51540,2,"""1""",52740,52920
5372,103004,112102,180,51540,2,"""1""",52920,53100
5372,112102,117001,180,51540,2,"""1""",53100,53280
5372,117001,404201,60,51540,2,"""1""",53280,53340
5372,404201,407101,60,51540,2,"""1""",53340,53400
5372,407101,405601,60,51540,2,"""1""",53400,53460
5372,405601,408502,60,51540,2,"""1""",53460,53520
5372,408502,400703,60,51540,2,"""1""",53520,53580
5372,400703,400800,60,51540,2,"""1""",53580,53640
5372,400800,408901,60,51540,2,"""1""",53640,53700
5372,408901,407501,120,51540,2,"""1""",53700,53820
5372,407501,407500,60,51540,2,"""1""",53820,53880
5372,404701,403601,0,52740,2,"""1""",52740,52740
5372,403601,402601,120,52740,2,"""1""",52740,52860
5372,402601,403701,60,52740,2,"""1""",52860,52920
5372,403701,404600,60,52740,2,"""1""",52920,52980
5372,404600,403700,60,52740,2,"""1""",52980,53040
5372,403700,403501,0,52740,2,"""1""",53040,53040
5372,403501,408402,60,52740,2,"""1""",53040,53100
5372,408402,407701,60,52740,2,"""1""",53100,53160
5372,407701,400601,120,52740,2,"""1""",53160,53280
5372,400601,407200,60,52740,2,"""1""",53280,53340
5372,407200,101102,120,52740,2,"""1""",53340,53460
5372,101102,102001,120,52740,2,"""1""",53460,53580
5372,102001,101001,120,52740,2,"""1""",53580,53700
5372,101001,118101,60,52740,2,"""1""",53700,53760
5372,118101,106001,60,52740,2,"""1""",53760,53820
5372,106001,118001,120,52740,2,"""1""",53820,53940
5372,118001,103004,180,52740,2,"""1""",53940,54120
5372,103004,112102,180,52740,2,"""1""",54120,54300
5372,112102,117001,180,52740,2,"""1""",54300,54480
5372,117001,404201,60,52740,2,"""1""",54480,54540
5372,404201,407101,60,52740,2,"""1""",54540,54600
5372,407101,405601,60,52740,2,"""1""",54600,54660
5372,405601,408502,60,52740,2,"""1""",54660,54720
5372,408502,400703,60,52740,2,"""1""",54720,54780
5372,400703,400800,60,52740,2,"""1""",54780,54840
5372,400800,408901,60,52740,2,"""1""",54840,54900
5372,408901,407501,120,52740,2,"""1""",54900,55020
5372,407501,407500,60,52740,2,"""1""",55020,55080
5372,404701,403601,0,53940,2,"""1""",53940,53940
5372,403601,402601,120,53940,2,"""1""",53940,54060
5372,402601,403701,60,53940,2,"""1""",54060,54120
5372,403701,404600,60,53940,2,"""1""",54120,54180
5372,404600,403700,60,53940,2,"""1""",54180,54240
5372,403700,403501,0,53940,2,"""1""",54240,54240
5372,403501,408402,60,53940,2,"""1""",54240,54300
5372,408402,407701,60,53940,2,"""1""",54300,54360
5372,407701,400601,120,53940,2,"""1""",54360,54480
5372,400601,407200,60,53940,2,"""1""",54480,54540
5372,407200,101102,120,53940,2,"""1""",54540,54660
5372,101102,102001,120,53940,2,"""1""",54660,54780
5372,102001,101001,120,53940,2,"""1""",54780,54900
5372,101001,118101,60,53940,2,"""1""",54900,54960
5372,118101,106001,60,53940,2,"""1""",54960,55020
5372,106001,118001,120,53940,2,"""1""",55020,55140
5372,118001,103004,180,53940,2,"""1""",55140,55320
5372,103004,112102,180,53940,2,"""1""",55320,55500
5372,112102,117001,180,53940,2,"""1""",55500,55680
5372,117001,404201,60,53940,2,"""1""",55680,55740
5372,404201,407101,60,53940,2,"""1""",55740,55800
5372,407101,405601,60,53940,2,"""1""",55800,55860
5372,405601,408502,60,53940,2,"""1""",55860,55920
5372,408502,400703,60,53940,2,"""1""",55920,55980
5372,400703,400800,60,53940,2,"""1""",55980,56040
5372,400800,408901,60,53940,2,"""1""",56040,56100
5372,408901,407501,120,53940,2,"""1""",56100,56220
5372,407501,407500,60,53940,2,"""1""",56220,56280
5372,404701,403601,0,55140,2,"""1""",55140,55140
5372,403601,402601,120,55140,2,"""1""",55140,55260
5372,402601,403701,60,55140,2,"""1""",55260,55320
5372,403701,404600,60,55140,2,"""1""",55320,55380
5372,404600,403700,60,55140,2,"""1""",55380,55440
5372,403700,403501,0,55140,2,"""1""",55440,55440
5372,403501,408402,60,55140,2,"""1""",55440,55500
5372,408402,407701,60,55140,2,"""1""",55500,55560
5372,407701,400601,120,55140,2,"""1""",55560,55680
5372,400601,407200,60,55140,2,"""1""",55680,55740
5372,407200,101102,120,55140,2,"""1""",55740,55860
5372,101102,102001,120,55140,2,"""1""",55860,55980
5372,102001,101001,120,55140,2,"""1""",55980,56100
5372,101001,118101,60,55140,2,"""1""",56100,56160
5372,118101,106001,60,55140,2,"""1""",56160,56220
5372,106001,118001,120,55140,2,"""1""",56220,56340
5372,118001,103004,180,55140,2,"""1""",56340,56520
5372,103004,112102,180,55140,2,"""1""",56520,56700
5372,112102,117001,180,55140,2,"""1""",56700,56880
5372,117001,404201,60,55140,2,"""1""",56880,56940
5372,404201,407101,60,55140,2,"""1""",56940,57000
5372,407101,405601,60,55140,2,"""1""",57000,57060
5372,405601,408502,60,55140,2,"""1""",57060,57120
5372,408502,400703,60,55140,2,"""1""",57120,57180
5372,400703,400800,60,55140,2,"""1""",57180,57240
5372,400800,408901,60,55140,2,"""1""",57240,57300
5372,408901,407501,120,55140,2,"""1""",57300,57420
5372,407501,407500,60,55140,2,"""1""",57420,57480
5372,404701,403601,0,56340,2,"""1""",56340,56340
5372,403601,402601,120,56340,2,"""1""",56340,56460
5372,402601,403701,60,56340,2,"""1""",56460,56520
5372,403701,404600,60,56340,2,"""1""",56520,56580
5372,404600,403700,60,56340,2,"""1""",56580,56640
5372,403700,403501,0,56340,2,"""1""",56640,56640
5372,403501,408402,60,56340,2,"""1""",56640,56700
5372,408402,407701,60,56340,2,"""1""",56700,56760
5372,407701,400601,120,56340,2,"""1""",56760,56880
5372,400601,407200,60,56340,2,"""1""",56880,56940
5372,407200,101102,120,56340,2,"""1""",56940,57060
5372,101102,102001,120,56340,2,"""1""",57060,57180
5372,102001,101001,120,56340,2,"""1""",57180,57300
5372,101001,118101,60,56340,2,"""1""",57300,57360
5372,118101,106001,60,56340,2,"""1""",57360,57420
5372,106001,118001,120,56340,2,"""1""",57420,57540
5372,118001,103004,180,56340,2,"""1""",57540,57720
5372,103004,112102,180,56340,2,"""1""",57720,57900
5372,112102,117001,180,56340,2,"""1""",57900,58080
5372,117001,404201,60,56340,2,"""1""",58080,58140
5372,404201,407101,60,56340,2,"""1""",58140,58200
5372,407101,405601,60,56340,2,"""1""",58200,58260
5372,405601,408502,60,56340,2,"""1""",58260,58320
5372,408502,400703,60,56340,2,"""1""",58320,58380
5372,400703,400800,60,56340,2,"""1""",58380,58440
5372,400800,408901,60,56340,2,"""1""",58440,58500
5372,408901,407501,120,56340,2,"""1""",58500,58620
5372,407501,407500,60,56340,2,"""1""",58620,58680
5372,404701,403601,0,57540,2,"""1""",57540,57540
5372,403601,402601,120,57540,2,"""1""",57540,57660
5372,402601,403701,60,57540,2,"""1""",57660,57720
5372,403701,404600,60,57540,2,"""1""",57720,57780
5372,404600,403700,60,57540,2,"""1""",57780,57840
5372,403700,403501,0,57540,2,"""1""",57840,57840
5372,403501,408402,60,57540,2,"""1""",57840,57900
5372,408402,407701,60,57540,2,"""1""",57900,57960
5372,407701,400601,120,57540,2,"""1""",57960,58080
5372,400601,407200,60,57540,2,"""1""",58080,58140
5372,407200,101102,120,57540,2,"""1""",58140,58260
5372,101102,102001,120,57540,2,"""1""",58260,58380
5372,102001,101001,120,57540,2,"""1""",58380,58500
5372,101001,118101,60,57540,2,"""1""",58500,58560
5372,118101,106001,60,57540,2,"""1""",58560,58620
5372,106001,118001,120,57540,2,"""1""",58620,58740
5372,118001,103004,180,57540,2,"""1""",58740,58920
5372,103004,112102,180,57540,2,"""1""",58920,59100
5372,112102,117001,180,57540,2,"""1""",59100,59280
5372,117001,404201,60,57540,2,"""1""",59280,59340
5372,404201,407101,60,57540,2,"""1""",59340,59400
5372,407101,405601,60,57540,2,"""1""",59400,59460
5372,405601,408502,60,57540,2,"""1""",59460,59520
5372,408502,400703,60,57540,2,"""1""",59520,59580
5372,400703,400800,60,57540,2,"""1""",59580,59640
5372,400800,408901,60,57540,2,"""1""",59640,59700
5372,408901,407501,120,57540,2,"""1""",59700,59820
5372,407501,407500,60,57540,2,"""1""",59820,59880
5372,404701,403601,0,58740,2,"""1""",58740,58740
5372,403601,402601,120,58740,2,"""1""",58740,58860
5372,402601,403701,60,58740,2,"""1""",58860,58920
5372,403701,404600,60,58740,2,"""1""",58920,58980
5372,404600,403700,60,58740,2,"""1""",58980,59040
5372,403700,403501,0,58740,2,"""1""",59040,59040
5372,403501,408402,60,58740,2,"""1""",59040,59100
5372,408402,407701,60,58740,2,"""1""",59100,59160
5372,407701,400601,120,58740,2,"""1""",59160,59280
5372,400601,407200,60,58740,2,"""1""",59280,59340
5372,407200,101102,120,58740,2,"""1""",59340,59460
5372,101102,102001,120,58740,2,"""1""",59460,59580
5372,102001,101001,120,58740,2,"""1""",59580,59700
5372,101001,118101,60,58740,2,"""1""",59700,59760
5372,118101,106001,60,58740,2,"""1""",59760,59820
5372,106001,118001,120,58740,2,"""1""",59820,59940
5372,118001,103004,180,58740,2,"""1""",59940,60120
5372,103004,112102,180,58740,2,"""1""",60120,60300
5372,112102,117001,180,58740,2,"""1""",60300,60480
5372,117001,404201,60,58740,2,"""1""",60480,60540
5372,404201,407101,60,58740,2,"""1""",60540,60600
5372,407101,405601,60,58740,2,"""1""",60600,60660
5372,405601,408502,60,58740,2,"""1""",60660,60720
5372,408502,400703,60,58740,2,"""1""",60720,60780
5372,400703,400800,60,58740,2,"""1""",60780,60840
5372,400800,408901,60,58740,2,"""1""",60840,60900
5372,408901,407501,120,58740,2,"""1""",60900,61020
5372,407501,407500,60,58740,2,"""1""",61020,61080
5372,404701,403601,0,59940,2,"""1""",59940,59940
5372,403601,402601,120,59940,2,"""1""",59940,60060
5372,402601,403701,60,59940,2,"""1""",60060,60120
5372,403701,404600,60,59940,2,"""1""",60120,60180
5372,404600,403700,60,59940,2,"""1""",60180,60240
5372,403700,403501,0,59940,2,"""1""",60240,60240
5372,403501,408402,60,59940,2,"""1""",60240,60300
5372,408402,407701,60,59940,2,"""1""",60300,60360
5372,407701,400601,120,59940,2,"""1""",60360,60480
5372,400601,407200,60,59940,2,"""1""",60480,60540
5372,407200,101102,120,59940,2,"""1""",60540,60660
5372,101102,102001,120,59940,2,"""1""",60660,60780
5372,102001,101001,120,59940,2,"""1""",60780,60900
5372,101001,118101,60,59940,2,"""1""",60900,60960
5372,118101,106001,60,59940,2,"""1""",60960,61020
5372,106001,118001,120,59940,2,"""1""",61020,61140
5372,118001,103004,180,59940,2,"""1""",61140,61320
5372,103004,112102,180,59940,2,"""1""",61320,61500
5372,112102,117001,180,59940,2,"""1""",61500,61680
5372,117001,404201,60,59940,2,"""1""",61680,61740
5372,404201,407101,60,59940,2,"""1""",61740,61800
5372,407101,405601,60,59940,2,"""1""",61800,61860
5372,405601,408502,60,59940,2,"""1""",61860,61920
5372,408502,400703,60,59940,2,"""1""",61920,61980
5372,400703,400800,60,59940,2,"""1""",61980,62040
5372,400800,408901,60,59940,2,"""1""",62040,62100
5372,408901,407501,120,59940,2,"""1""",62100,62220
5372,407501,407500,60,59940,2,"""1""",62220,62280
5372,404701,403601,0,61140,2,"""1""",61140,61140
5372,403601,402601,120,61140,2,"""1""",61140,61260
5372,402601,403701,60,61140,2,"""1""",61260,61320
5372,403701,404600,60,61140,2,"""1""",61320,61380
5372,404600,403700,60,61140,2,"""1""",61380,61440
5372,403700,403501,0,61140,2,"""1""",61440,61440
5372,403501,408402,60,61140,2,"""1""",61440,61500
5372,408402,407701,60,61140,2,"""1""",61500,61560
5372,407701,400601,120,61140,2,"""1""",61560,61680
5372,400601,407200,60,61140,2,"""1""",61680,61740
5372,407200,101102,120,61140,2,"""1""",61740,61860
5372,101102,102001,120,61140,2,"""1""",61860,61980
5372,102001,101001,120,61140,2,"""1""",61980,62100
5372,101001,118101,60,61140,2,"""1""",62100,62160
5372,118101,106001,60,61140,2,"""1""",62160,62220
5372,106001,118001,120,61140,2,"""1""",62220,62340
5372,118001,103004,180,61140,2,"""1""",62340,62520
5372,103004,112102,180,61140,2,"""1""",62520,62700
5372,112102,117001,180,61140,2,"""1""",62700,62880
5372,117001,404201,60,61140,2,"""1""",62880,62940
5372,404201,407101,60,61140,2,"""1""",62940,63000
5372,407101,405601,60,61140,2,"""1""",63000,63060
5372,405601,408502,60,61140,2,"""1""",63060,63120
5372,408502,400703,60,61140,2,"""1""",63120,63180
5372,400703,400800,60,61140,2,"""1""",63180,63240
5372,400800,408901,60,61140,2,"""1""",63240,63300
5372,408901,407501,120,61140,2,"""1""",63300,63420
5372,407501,407500,60,61140,2,"""1""",63420,63480
5372,404701,403601,0,62340,2,"""1""",62340,62340
5372,403601,402601,120,62340,2,"""1""",62340,62460
5372,402601,403701,60,62340,2,"""1""",62460,62520
5372,403701,404600,60,62340,2,"""1""",62520,62580
5372,404600,403700,60,62340,2,"""1""",62580,62640
5372,403700,403501,0,62340,2,"""1""",62640,62640
5372,403501,408402,60,62340,2,"""1""",62640,62700
5372,408402,407701,60,62340,2,"""1""",62700,62760
5372,407701,400601,120,62340,2,"""1""",62760,62880
5372,400601,407200,60,62340,2,"""1""",62880,62940
5372,407200,101102,120,62340,2,"""1""",62940,63060
5372,101102,102001,120,62340,2,"""1""",63060,63180
5372,102001,101001,120,62340,2,"""1""",63180,63300
5372,101001,118101,60,62340,2,"""1""",63300,63360
5372,118101,106001,60,62340,2,"""1""",63360,63420
5372,106001,118001,120,62340,2,"""1""",63420,63540
5372,118001,103004,180,62340,2,"""1""",63540,63720
5372,103004,112102,180,62340,2,"""1""",63720,63900
5372,112102,117001,180,62340,2,"""1""",63900,64080
5372,117001,404201,60,62340,2,"""1""",64080,64140
5372,404201,407101,60,62340,2,"""1""",64140,64200
5372,407101,405601,60,62340,2,"""1""",64200,64260
5372,405601,408502,60,62340,2,"""1""",64260,64320
5372,408502,400703,60,62340,2,"""1""",64320,64380
5372,400703,400800,60,62340,2,"""1""",64380,64440
5372,400800,408901,60,62340,2,"""1""",64440,64500
5372,408901,407501,120,62340,2,"""1""",64500,64620
5372,407501,407500,60,62340,2,"""1""",64620,64680
5372,404701,403601,0,63540,2,"""1""",63540,63540
5372,403601,402601,120,63540,2,"""1""",63540,63660
5372,402601,403701,60,63540,2,"""1""",63660,63720
5372,403701,404600,60,63540,2,"""1""",63720,63780
5372,404600,403700,60,63540,2,"""1""",63780,63840
5372,403700,403501,0,63540,2,"""1""",63840,63840
5372,403501,408402,60,63540,2,"""1""",63840,63900
5372,408402,407701,60,63540,2,"""1""",63900,63960
5372,407701,400601,120,63540,2,"""1""",63960,64080
5372,400601,407200,60,63540,2,"""1""",64080,64140
5372,407200,101102,120,63540,2,"""1""",64140,64260
5372,101102,102001,120,63540,2,"""1""",64260,64380
5372,102001,101001,120,63540,2,"""1""",64380,64500
5372,101001,118101,60,63540,2,"""1""",64500,64560
5372,118101,106001,60,63540,2,"""1""",64560,64620
5372,106001,118001,120,63540,2,"""1""",64620,64740
5372,118001,103004,180,63540,2,"""1""",64740,64920
5372,103004,112102,180,63540,2,"""1""",64920,65100
5372,112102,117001,180,63540,2,"""1""",65100,65280
5372,117001,404201,60,63540,2,"""1""",65280,65340
5372,404201,407101,60,63540,2,"""1""",65340,65400
5372,407101,405601,60,63540,2,"""1""",65400,65460
5372,405601,408502,60,63540,2,"""1""",65460,65520
5372,408502,400703,60,63540,2,"""1""",65520,65580
5372,400703,400800,60,63540,2,"""1""",65580,65640
5372,400800,408901,60,63540,2,"""1""",65640,65700
5372,408901,407501,120,63540,2,"""1""",65700,65820
5372,407501,407500,60,63540,2,"""1""",65820,65880
5372,404701,403601,0,64740,2,"""1""",64740,64740
5372,403601,402601,120,64740,2,"""1""",64740,64860
5372,402601,403701,60,64740,2,"""1""",64860,64920
5372,403701,404600,60,64740,2,"""1""",64920,64980
5372,404600,403700,60,64740,2,"""1""",64980,65040
5372,403700,403501,0,64740,2,"""1""",65040,65040
5372,403501,408402,60,64740,2,"""1""",65040,65100
5372,408402,407701,60,64740,2,"""1""",65100,65160
5372,407701,400601,120,64740,2,"""1""",65160,65280
5372,400601,407200,60,64740,2,"""1""",65280,65340
5372,407200,101102,120,64740,2,"""1""",65340,65460
5372,101102,102001,120,64740,2,"""1""",65460,65580
5372,102001,101001,120,64740,2,"""1""",65580,65700
5372,101001,118101,60,64740,2,"""1""",65700,65760
5372,118101,106001,60,64740,2,"""1""",65760,65820
5372,106001,118001,120,64740,2,"""1""",65820,65940
5372,118001,103004,180,64740,2,"""1""",65940,66120
5372,103004,112102,180,64740,2,"""1""",66120,66300
5372,112102,117001,180,64740,2,"""1""",66300,66480
5372,117001,404201,60,64740,2,"""1""",66480,66540
5372,404201,407101,60,64740,2,"""1""",66540,66600
5372,407101,405601,60,64740,2,"""1""",66600,66660
5372,405601,408502,60,64740,2,"""1""",66660,66720
5372,408502,400703,60,64740,2,"""1""",66720,66780
5372,400703,400800,60,64740,2,"""1""",66780,66840
5372,400800,408901,60,64740,2,"""1""",66840,66900
5372,408901,407501,120,64740,2,"""1""",66900,67020
5372,407501,407500,60,64740,2,"""1""",67020,67080
5372,404701,403601,0,65940,2,"""1""",65940,65940
5372,403601,402601,120,65940,2,"""1""",65940,66060
5372,402601,403701,60,65940,2,"""1""",66060,66120
5372,403701,404600,60,65940,2,"""1""",66120,66180
5372,404600,403700,60,65940,2,"""1""",66180,66240
5372,403700,403501,0,65940,2,"""1""",66240,66240
5372,403501,408402,60,65940,2,"""1""",66240,66300
5372,408402,407701,60,65940,2,"""1""",66300,66360
5372,407701,400601,120,65940,2,"""1""",66360,66480
5372,400601,407200,60,65940,2,"""1""",66480,66540
5372,407200,101102,120,65940,2,"""1""",66540,66660
5372,101102,102001,120,65940,2,"""1""",66660,66780
5372,102001,101001,120,65940,2,"""1""",66780,66900
5372,101001,118101,60,65940,2,"""1""",66900,66960
5372,118101,106001,60,65940,2,"""1""",66960,67020
5372,106001,118001,120,65940,2,"""1""",67020,67140
5372,118001,103004,180,65940,2,"""1""",67140,67320
5372,103004,112102,180,65940,2,"""1""",67320,67500
5372,112102,117001,180,65940,2,"""1""",67500,67680
5372,117001,404201,60,65940,2,"""1""",67680,67740
5372,404201,407101,60,65940,2,"""1""",67740,67800
5372,407101,405601,60,65940,2,"""1""",67800,67860
5372,405601,408502,60,65940,2,"""1""",67860,67920
5372,408502,400703,60,65940,2,"""1""",67920,67980
5372,400703,400800,60,65940,2,"""1""",67980,68040
5372,400800,408901,60,65940,2,"""1""",68040,68100
5372,408901,407501,120,65940,2,"""1""",68100,68220
5372,407501,407500,60,65940,2,"""1""",68220,68280
5372,404701,403601,0,67140,2,"""1""",67140,67140
5372,403601,402601,120,67140,2,"""1""",67140,67260
5372,402601,403701,60,67140,2,"""1""",67260,67320
5372,403701,404600,60,67140,2,"""1""",67320,67380
5372,404600,403700,60,67140,2,"""1""",67380,67440
5372,403700,403501,0,67140,2,"""1""",67440,67440
5372,403501,408402,60,67140,2,"""1""",67440,67500
5372,408402,407701,60,67140,2,"""1""",67500,67560
5372,407701,400601,120,67140,2,"""1""",67560,67680
5372,400601,407200,60,67140,2,"""1""",67680,67740
5372,407200,101102,120,67140,2,"""1""",67740,67860
5372,101102,102001,120,67140,2,"""1""",67860,67980
5372,102001,101001,120,67140,2,"""1""",67980,68100
5372,101001,118101,60,67140,2,"""1""",68100,68160
5372,118101,106001,60,67140,2,"""1""",68160,68220
5372,106001,118001,120,67140,2,"""1""",68220,68340
5372,118001,103004,180,67140,2,"""1""",68340,68520
5372,103004,112102,180,67140,2,"""1""",68520,68700
5372,112102,117001,180,67140,2,"""1""",68700,68880
5372,117001,404201,60,67140,2,"""1""",68880,68940
5372,404201,407101,60,67140,2,"""1""",68940,69000
5372,407101,405601,60,67140,2,"""1""",69000,69060
5372,405601,408502,60,67140,2,"""1""",69060,69120
5372,408502,400703,60,67140,2,"""1""",69120,69180
5372,400703,400800,60,67140,2,"""1""",69180,69240
5372,400800,408901,60,67140,2,"""1""",69240,69300
5372,408901,407501,120,67140,2,"""1""",69300,69420
5372,407501,407500,60,67140,2,"""1""",69420,69480
5372,404701,403601,0,68580,2,"""1""",68580,68580
5372,403601,402601,120,68580,2,"""1""",68580,68700
5372,402601,403701,60,68580,2,"""1""",68700,68760
5372,403701,404600,60,68580,2,"""1""",68760,68820
5372,404600,403700,60,68580,2,"""1""",68820,68880
5372,403700,403501,0,68580,2,"""1""",68880,68880
5372,403501,408402,60,68580,2,"""1""",68880,68940
5372,408402,407701,60,68580,2,"""1""",68940,69000
5372,407701,400601,120,68580,2,"""1""",69000,69120
5372,400601,407200,60,68580,2,"""1""",69120,69180
5372,407200,101102,120,68580,2,"""1""",69180,69300
5372,101102,102001,120,68580,2,"""1""",69300,69420
5372,102001,101001,120,68580,2,"""1""",69420,69540
5372,101001,118101,60,68580,2,"""1""",69540,69600
5372,118101,106001,60,68580,2,"""1""",69600,69660
5372,106001,118001,120,68580,2,"""1""",69660,69780
5372,118001,103004,180,68580,2,"""1""",69780,69960
5372,103004,112102,180,68580,2,"""1""",69960,70140
5372,112102,117001,180,68580,2,"""1""",70140,70320
5372,117001,404201,60,68580,2,"""1""",70320,70380
5372,404201,407101,60,68580,2,"""1""",70380,70440
5372,407101,405601,60,68580,2,"""1""",70440,70500
5372,405601,408502,60,68580,2,"""1""",70500,70560
5372,408502,400703,60,68580,2,"""1""",70560,70620
5372,400703,400800,60,68580,2,"""1""",70620,70680
5372,400800,408901,60,68580,2,"""1""",70680,70740
5372,408901,407501,120,68580,2,"""1""",70740,70860
5372,407501,407500,60,68580,2,"""1""",70860,70920
5373,404701,403601,0,18480,2,"""1""",18480,18480
5373,403601,402601,60,18480,2,"""1""",18480,18540
5373,402601,403701,60,18480,2,"""1""",18540,18600
5373,403701,404600,60,18480,2,"""1""",18600,18660
5373,404600,403700,60,18480,2,"""1""",18660,18720
5373,403700,403501,0,18480,2,"""1""",18720,18720
5373,403501,408402,60,18480,2,"""1""",18720,18780
5373,408402,407701,60,18480,2,"""1""",18780,18840
5373,407701,400601,60,18480,2,"""1""",18840,18900
5373,400601,407200,60,18480,2,"""1""",18900,18960
5373,407200,101102,120,18480,2,"""1""",18960,19080
5373,101102,102001,60,18480,2,"""1""",19080,19140
5373,102001,101001,120,18480,2,"""1""",19140,19260
5373,101001,118101,60,18480,2,"""1""",19260,19320
5373,118101,106001,60,18480,2,"""1""",19320,19380
5373,106001,118001,60,18480,2,"""1""",19380,19440
5373,118001,103004,180,18480,2,"""1""",19440,19620
5373,103004,112102,180,18480,2,"""1""",19620,19800
5373,112102,117001,180,18480,2,"""1""",19800,19980
5373,117001,404201,60,18480,2,"""1""",19980,20040
5373,404201,407101,60,18480,2,"""1""",20040,20100
5373,407101,405601,60,18480,2,"""1""",20100,20160
5373,405601,408502,60,18480,2,"""1""",20160,20220
5373,408502,400703,60,18480,2,"""1""",20220,20280
5373,400703,400800,60,18480,2,"""1""",20280,20340
5373,400800,408901,60,18480,2,"""1""",20340,20400
5373,408901,407501,60,18480,2,"""1""",20400,20460
5373,407501,407500,60,18480,2,"""1""",20460,20520
5373,404701,403601,0,19680,2,"""1""",19680,19680
5373,403601,402601,60,19680,2,"""1""",19680,19740
5373,402601,403701,60,19680,2,"""1""",19740,19800
5373,403701,404600,60,19680,2,"""1""",19800,19860
5373,404600,403700,60,19680,2,"""1""",19860,19920
5373,403700,403501,0,19680,2,"""1""",19920,19920
5373,403501,408402,60,19680,2,"""1""",19920,19980
5373,408402,407701,60,19680,2,"""1""",19980,20040
5373,407701,400601,60,19680,2,"""1""",20040,20100
5373,400601,407200,60,19680,2,"""1""",20100,20160
5373,407200,101102,120,19680,2,"""1""",20160,20280
5373,101102,102001,60,19680,2,"""1""",20280,20340
5373,102001,101001,120,19680,2,"""1""",20340,20460
5373,101001,118101,60,19680,2,"""1""",20460,20520
5373,118101,106001,60,19680,2,"""1""",20520,20580
5373,106001,118001,60,19680,2,"""1""",20580,20640
5373,118001,103004,180,19680,2,"""1""",20640,20820
5373,103004,112102,180,19680,2,"""1""",20820,21000
5373,112102,117001,180,19680,2,"""1""",21000,21180
5373,117001,404201,60,19680,2,"""1""",21180,21240
5373,404201,407101,60,19680,2,"""1""",21240,21300
5373,407101,405601,60,19680,2,"""1""",21300,21360
5373,405601,408502,60,19680,2,"""1""",21360,21420
5373,408502,400703,60,19680,2,"""1""",21420,21480
5373,400703,400800,60,19680,2,"""1""",21480,21540
5373,400800,408901,60,19680,2,"""1""",21540,21600
5373,408901,407501,60,19680,2,"""1""",21600,21660
5373,407501,407500,60,19680,2,"""1""",21660,21720
5374,404603,409202,60,25620,2,"""11""",25620,25680
5374,409202,400502,120,25620,2,"""11""",25680,25800
5374,400502,408000,120,25620,2,"""11""",25800,25920
5374,408000,34202,180,25620,2,"""11""",25920,26100
5374,34202,407701,60,25620,2,"""11""",26100,26160
5374,407701,400601,120,25620,2,"""11""",26160,26280
5374,400601,407200,60,25620,2,"""11""",26280,26340
5374,407200,101102,120,25620,2,"""11""",26340,26460
5374,101102,102001,120,25620,2,"""11""",26460,26580
5374,102001,101001,120,25620,2,"""11""",26580,26700
5374,101001,118101,60,25620,2,"""11""",26700,26760
5374,118101,106001,60,25620,2,"""11""",26760,26820
5374,106001,118001,120,25620,2,"""11""",26820,26940
5374,118001,103004,180,25620,2,"""11""",26940,27120
5374,103004,112102,180,25620,2,"""11""",27120,27300
5374,112102,117001,180,25620,2,"""11""",27300,27480
5374,117001,404201,60,25620,2,"""11""",27480,27540
5374,404201,407101,60,25620,2,"""11""",27540,27600
5374,407101,405601,60,25620,2,"""11""",27600,27660
5374,405601,408502,60,25620,2,"""11""",27660,27720
5374,408502,400703,60,25620,2,"""11""",27720,27780
5374,400703,400800,60,25620,2,"""11""",27780,27840
5374,400800,408901,60,25620,2,"""11""",27840,27900
5374,408901,407501,120,25620,2,"""11""",27900,28020
5374,407501,407500,60,25620,2,"""11""",28020,28080
5374,404603,409202,60,26820,2,"""11""",26820,26880
5374,409202,400502,120,26820,2,"""11""",26880,27000
5374,400502,408000,120,26820,2,"""11""",27000,27120
5374,408000,34202,180,26820,2,"""11""",27120,27300
5374,34202,407701,60,26820,2,"""11""",27300,27360
5374,407701,400601,120,26820,2,"""11""",27360,27480
5374,400601,407200,60,26820,2,"""11""",27480,27540
5374,407200,101102,120,26820,2,"""11""",27540,27660
5374,101102,102001,120,26820,2,"""11""",27660,27780
5374,102001,101001,120,26820,2,"""11""",27780,27900
5374,101001,118101,60,26820,2,"""11""",27900,27960
5374,118101,106001,60,26820,2,"""11""",27960,28020
5374,106001,118001,120,26820,2,"""11""",28020,28140
5374,118001,103004,180,26820,2,"""11""",28140,28320
5374,103004,112102,180,26820,2,"""11""",28320,28500
5374,112102,117001,180,26820,2,"""11""",28500,28680
5374,117001,404201,60,26820,2,"""11""",28680,28740
5374,404201,407101,60,26820,2,"""11""",28740,28800
5374,407101,405601,60,26820,2,"""11""",28800,28860
5374,405601,408502,60,26820,2,"""11""",28860,28920
5374,408502,400703,60,26820,2,"""11""",28920,28980
5374,400703,400800,60,26820,2,"""11""",28980,29040
5374,400800,408901,60,26820,2,"""11""",29040,29100
5374,408901,407501,120,26820,2,"""11""",29100,29220
5374,407501,407500,60,26820,2,"""11""",29220,29280
5374,404603,409202,60,28020,2,"""11""",28020,28080
5374,409202,400502,120,28020,2,"""11""",28080,28200
5374,400502,408000,120,28020,2,"""11""",28200,28320
5374,408000,34202,180,28020,2,"""11""",28320,28500
5374,34202,407701,60,28020,2,"""11""",28500,28560
5374,407701,400601,120,28020,2,"""11""",28560,28680
5374,400601,407200,60,28020,2,"""11""",28680,28740
5374,407200,101102,120,28020,2,"""11""",28740,28860
5374,101102,102001,120,28020,2,"""11""",28860,28980
5374,102001,101001,120,28020,2,"""11""",28980,29100
5374,101001,118101,60,28020,2,"""11""",29100,29160
5374,118101,106001,60,28020,2,"""11""",29160,29220
5374,106001,118001,120,28020,2,"""11""",29220,29340
5374,118001,103004,180,28020,2,"""11""",29340,29520
5374,103004,112102,180,28020,2,"""11""",29520,29700
5374,112102,117001,180,28020,2,"""11""",29700,29880
5374,117001,404201,60,28020,2,"""11""",29880,29940
5374,404201,407101,60,28020,2,"""11""",29940,30000
5374,407101,405601,60,28020,2,"""11""",30000,30060
5374,405601,408502,60,28020,2,"""11""",30060,30120
5374,408502,400703,60,28020,2,"""11""",30120,30180
5374,400703,400800,60,28020,2,"""11""",30180,30240
5374,400800,408901,60,28020,2,"""11""",30240,30300
5374,408901,407501,120,28020,2,"""11""",30300,30420
5374,407501,407500,60,28020,2,"""11""",30420,30480
5374,404603,409202,60,29220,2,"""11""",29220,29280
5374,409202,400502,120,29220,2,"""11""",29280,29400
5374,400502,408000,120,29220,2,"""11""",29400,29520
5374,408000,34202,180,29220,2,"""11""",29520,29700
5374,34202,407701,60,29220,2,"""11""",29700,29760
5374,407701,400601,120,29220,2,"""11""",29760,29880
5374,400601,407200,60,29220,2,"""11""",29880,29940
5374,407200,101102,120,29220,2,"""11""",29940,30060
5374,101102,102001,120,29220,2,"""11""",30060,30180
5374,102001,101001,120,29220,2,"""11""",30180,30300
5374,101001,118101,60,29220,2,"""11""",30300,30360
5374,118101,106001,60,29220,2,"""11""",30360,30420
5374,106001,118001,120,29220,2,"""11""",30420,30540
5374,118001,103004,180,29220,2,"""11""",30540,30720
5374,103004,112102,180,29220,2,"""11""",30720,30900
5374,112102,117001,180,29220,2,"""11""",30900,31080
5374,117001,404201,60,29220,2,"""11""",31080,31140
5374,404201,407101,60,29220,2,"""11""",31140,31200
5374,407101,405601,60,29220,2,"""11""",31200,31260
5374,405601,408502,60,29220,2,"""11""",31260,31320
5374,408502,400703,60,29220,2,"""11""",31320,31380
5374,400703,400800,60,29220,2,"""11""",31380,31440
5374,400800,408901,60,29220,2,"""11""",31440,31500
5374,408901,407501,120,29220,2,"""11""",31500,31620
5374,407501,407500,60,29220,2,"""11""",31620,31680
5374,404603,409202,60,30420,2,"""11""",30420,30480
5374,409202,400502,120,30420,2,"""11""",30480,30600
5374,400502,408000,120,30420,2,"""11""",30600,30720
5374,408000,34202,180,30420,2,"""11""",30720,30900
5374,34202,407701,60,30420,2,"""11""",30900,30960
5374,407701,400601,120,30420,2,"""11""",30960,31080
5374,400601,407200,60,30420,2,"""11""",31080,31140
5374,407200,101102,120,30420,2,"""11""",31140,31260
5374,101102,102001,120,30420,2,"""11""",31260,31380
5374,102001,101001,120,30420,2,"""11""",31380,31500
5374,101001,118101,60,30420,2,"""11""",31500,31560
5374,118101,106001,60,30420,2,"""11""",31560,31620
5374,106001,118001,120,30420,2,"""11""",31620,31740
5374,118001,103004,180,30420,2,"""11""",31740,31920
5374,103004,112102,180,30420,2,"""11""",31920,32100
5374,112102,117001,180,30420,2,"""11""",32100,32280
5374,117001,404201,60,30420,2,"""11""",32280,32340
5374,404201,407101,60,30420,2,"""11""",32340,32400
5374,407101,405601,60,30420,2,"""11""",32400,32460
5374,405601,408502,60,30420,2,"""11""",32460,32520
5374,408502,400703,60,30420,2,"""11""",32520,32580
5374,400703,400800,60,30420,2,"""11""",32580,32640
5374,400800,408901,60,30420,2,"""11""",32640,32700
5374,408901,407501,120,30420,2,"""11""",32700,32820
5374,407501,407500,60,30420,2,"""11""",32820,32880
5374,404603,409202,60,31620,2,"""11""",31620,31680
5374,409202,400502,120,31620,2,"""11""",31680,31800
5374,400502,408000,120,31620,2,"""11""",31800,31920
5374,408000,34202,180,31620,2,"""11""",31920,32100
5374,34202,407701,60,31620,2,"""11""",32100,32160
5374,407701,400601,120,31620,2,"""11""",32160,32280
5374,400601,407200,60,31620,2,"""11""",32280,32340
5374,407200,101102,120,31620,2,"""11""",32340,32460
5374,101102,102001,120,31620,2,"""11""",32460,32580
5374,102001,101001,120,31620,2,"""11""",32580,32700
5374,101001,118101,60,31620,2,"""11""",32700,32760
5374,118101,106001,60,31620,2,"""11""",32760,32820
5374,106001,118001,120,31620,2,"""11""",32820,32940
5374,118001,103004,180,31620,2,"""11""",32940,33120
5374,103004,112102,180,31620,2,"""11""",33120,33300
5374,112102,117001,180,31620,2,"""11""",33300,33480
5374,117001,404201,60,31620,2,"""11""",33480,33540
5374,404201,407101,60,31620,2,"""11""",33540,33600
5374,407101,405601,60,31620,2,"""11""",33600,33660
5374,405601,408502,60,31620,2,"""11""",33660,33720
5374,408502,400703,60,31620,2,"""11""",33720,33780
5374,400703,400800,60,31620,2,"""11""",33780,33840
5374,400800,408901,60,31620,2,"""11""",33840,33900
5374,408901,407501,120,31620,2,"""11""",33900,34020
5374,407501,407500,60,31620,2,"""11""",34020,34080
5374,404603,409202,60,32820,2,"""11""",32820,32880
5374,409202,400502,120,32820,2,"""11""",32880,33000
5374,400502,408000,120,32820,2,"""11""",33000,33120
5374,408000,34202,180,32820,2,"""11""",33120,33300
5374,34202,407701,60,32820,2,"""11""",33300,33360
5374,407701,400601,120,32820,2,"""11""",33360,33480
5374,400601,407200,60,32820,2,"""11""",33480,33540
5374,407200,101102,120,32820,2,"""11""",33540,33660
5374,101102,102001,120,32820,2,"""11""",33660,33780
5374,102001,101001,120,32820,2,"""11""",33780,33900
5374,101001,118101,60,32820,2,"""11""",33900,33960
5374,118101,106001,60,32820,2,"""11""",33960,34020
5374,106001,118001,120,32820,2,"""11""",34020,34140
5374,118001,103004,180,32820,2,"""11""",34140,34320
5374,103004,112102,180,32820,2,"""11""",34320,34500
5374,112102,117001,180,32820,2,"""11""",34500,34680
5374,117001,404201,60,32820,2,"""11""",34680,34740
5374,404201,407101,60,32820,2,"""11""",34740,34800
5374,407101,405601,60,32820,2,"""11""",34800,34860
5374,405601,408502,60,32820,2,"""11""",34860,34920
5374,408502,400703,60,32820,2,"""11""",34920,34980
5374,400703,400800,60,32820,2,"""11""",34980,35040
5374,400800,408901,60,32820,2,"""11""",35040,35100
5374,408901,407501,120,32820,2,"""11""",35100,35220
5374,407501,407500,60,32820,2,"""11""",35220,35280
5374,404603,409202,60,34020,2,"""11""",34020,34080
5374,409202,400502,120,34020,2,"""11""",34080,34200
5374,400502,408000,120,34020,2,"""11""",34200,34320
5374,408000,34202,180,34020,2,"""11""",34320,34500
5374,34202,407701,60,34020,2,"""11""",34500,34560
5374,407701,400601,120,34020,2,"""11""",34560,34680
5374,400601,407200,60,34020,2,"""11""",34680,34740
5374,407200,101102,120,34020,2,"""11""",34740,34860
5374,101102,102001,120,34020,2,"""11""",34860,34980
5374,102001,101001,120,34020,2,"""11""",34980,35100
5374,101001,118101,60,34020,2,"""11""",35100,35160
5374,118101,106001,60,34020,2,"""11""",35160,35220
5374,106001,118001,120,34020,2,"""11""",35220,35340
5374,118001,103004,180,34020,2,"""11""",35340,35520
5374,103004,112102,180,34020,2,"""11""",35520,35700
5374,112102,117001,180,34020,2,"""11""",35700,35880
5374,117001,404201,60,34020,2,"""11""",35880,35940
5374,404201,407101,60,34020,2,"""11""",35940,36000
5374,407101,405601,60,34020,2,"""11""",36000,36060
5374,405601,408502,60,34020,2,"""11""",36060,36120
5374,408502,400703,60,34020,2,"""11""",36120,36180
5374,400703,400800,60,34020,2,"""11""",36180,36240
5374,400800,408901,60,34020,2,"""11""",36240,36300
5374,408901,407501,120,34020,2,"""11""",36300,36420
5374,407501,407500,60,34020,2,"""11""",36420,36480
5374,404603,409202,60,35220,2,"""11""",35220,35280
5374,409202,400502,120,35220,2,"""11""",35280,35400
5374,400502,408000,120,35220,2,"""11""",35400,35520
5374,408000,34202,180,35220,2,"""11""",35520,35700
5374,34202,407701,60,35220,2,"""11""",35700,35760
5374,407701,400601,120,35220,2,"""11""",35760,35880
5374,400601,407200,60,35220,2,"""11""",35880,35940
5374,407200,101102,120,35220,2,"""11""",35940,36060
5374,101102,102001,120,35220,2,"""11""",36060,36180
5374,102001,101001,120,35220,2,"""11""",36180,36300
5374,101001,118101,60,35220,2,"""11""",36300,36360
5374,118101,106001,60,35220,2,"""11""",36360,36420
5374,106001,118001,120,35220,2,"""11""",36420,36540
5374,118001,103004,180,35220,2,"""11""",36540,36720
5374,103004,112102,180,35220,2,"""11""",36720,36900
5374,112102,117001,180,35220,2,"""11""",36900,37080
5374,117001,404201,60,35220,2,"""11""",37080,37140
5374,404201,407101,60,35220,2,"""11""",37140,37200
5374,407101,405601,60,35220,2,"""11""",37200,37260
5374,405601,408502,60,35220,2,"""11""",37260,37320
5374,408502,400703,60,35220,2,"""11""",37320,37380
5374,400703,400800,60,35220,2,"""11""",37380,37440
5374,400800,408901,60,35220,2,"""11""",37440,37500
5374,408901,407501,120,35220,2,"""11""",37500,37620
5374,407501,407500,60,35220,2,"""11""",37620,37680
5374,404603,409202,60,36420,2,"""11""",36420,36480
5374,409202,400502,120,36420,2,"""11""",36480,36600
5374,400502,408000,120,36420,2,"""11""",36600,36720
5374,408000,34202,180,36420,2,"""11""",36720,36900
5374,34202,407701,60,36420,2,"""11""",36900,36960
5374,407701,400601,120,36420,2,"""11""",36960,37080
5374,400601,407200,60,36420,2,"""11""",37080,37140
5374,407200,101102,120,36420,2,"""11""",37140,37260
5374,101102,102001,120,36420,2,"""11""",37260,37380
5374,102001,101001,120,36420,2,"""11""",37380,37500
5374,101001,118101,60,36420,2,"""11""",37500,37560
5374,118101,106001,60,36420,2,"""11""",37560,37620
5374,106001,118001,120,36420,2,"""11""",37620,37740
5374,118001,103004,180,36420,2,"""11""",37740,37920
5374,103004,112102,180,36420,2,"""11""",37920,38100
5374,112102,117001,180,36420,2,"""11""",38100,38280
5374,117001,404201,60,36420,2,"""11""",38280,38340
5374,404201,407101,60,36420,2,"""11""",38340,38400
5374,407101,405601,60,36420,2,"""11""",38400,38460
5374,405601,408502,60,36420,2,"""11""",38460,38520
5374,408502,400703,60,36420,2,"""11""",38520,38580
5374,400703,400800,60,36420,2,"""11""",38580,38640
5374,400800,408901,60,36420,2,"""11""",38640,38700
5374,408901,407501,120,36420,2,"""11""",38700,38820
5374,407501,407500,60,36420,2,"""11""",38820,38880
5374,404603,409202,60,37620,2,"""11""",37620,37680
5374,409202,400502,120,37620,2,"""11""",37680,37800
5374,400502,408000,120,37620,2,"""11""",37800,37920
5374,408000,34202,180,37620,2,"""11""",37920,38100
5374,34202,407701,60,37620,2,"""11""",38100,38160
5374,407701,400601,120,37620,2,"""11""",38160,38280
5374,400601,407200,60,37620,2,"""11""",38280,38340
5374,407200,101102,120,37620,2,"""11""",38340,38460
5374,101102,102001,120,37620,2,"""11""",38460,38580
5374,102001,101001,120,37620,2,"""11""",38580,38700
5374,101001,118101,60,37620,2,"""11""",38700,38760
5374,118101,106001,60,37620,2,"""11""",38760,38820
5374,106001,118001,120,37620,2,"""11""",38820,38940
5374,118001,103004,180,37620,2,"""11""",38940,39120
5374,103004,112102,180,37620,2,"""11""",39120,39300
5374,112102,117001,180,37620,2,"""11""",39300,39480
5374,117001,404201,60,37620,2,"""11""",39480,39540
5374,404201,407101,60,37620,2,"""11""",39540,39600
5374,407101,405601,60,37620,2,"""11""",39600,39660
5374,405601,408502,60,37620,2,"""11""",39660,39720
5374,408502,400703,60,37620,2,"""11""",39720,39780
5374,400703,400800,60,37620,2,"""11""",39780,39840
5374,400800,408901,60,37620,2,"""11""",39840,39900
5374,408901,407501,120,37620,2,"""11""",39900,40020
5374,407501,407500,60,37620,2,"""11""",40020,40080
5374,404603,409202,60,38820,2,"""11""",38820,38880
5374,409202,400502,120,38820,2,"""11""",38880,39000
5374,400502,408000,120,38820,2,"""11""",39000,39120
5374,408000,34202,180,38820,2,"""11""",39120,39300
5374,34202,407701,60,38820,2,"""11""",39300,39360
5374,407701,400601,120,38820,2,"""11""",39360,39480
5374,400601,407200,60,38820,2,"""11""",39480,39540
5374,407200,101102,120,38820,2,"""11""",39540,39660
5374,101102,102001,120,38820,2,"""11""",39660,39780
5374,102001,101001,120,38820,2,"""11""",39780,39900
5374,101001,118101,60,38820,2,"""11""",39900,39960
5374,118101,106001,60,38820,2,"""11""",39960,40020
5374,106001,118001,120,38820,2,"""11""",40020,40140
5374,118001,103004,180,38820,2,"""11""",40140,40320
5374,103004,112102,180,38820,2,"""11""",40320,40500
5374,112102,117001,180,38820,2,"""11""",40500,40680
5374,117001,404201,60,38820,2,"""11""",40680,40740
5374,404201,407101,60,38820,2,"""11""",40740,40800
5374,407101,405601,60,38820,2,"""11""",40800,40860
5374,405601,408502,60,38820,2,"""11""",40860,40920
5374,408502,400703,60,38820,2,"""11""",40920,40980
5374,400703,400800,60,38820,2,"""11""",40980,41040
5374,400800,408901,60,38820,2,"""11""",41040,41100
5374,408901,407501,120,38820,2,"""11""",41100,41220
5374,407501,407500,60,38820,2,"""11""",41220,41280
5374,404603,409202,60,40020,2,"""11""",40020,40080
5374,409202,400502,120,40020,2,"""11""",40080,40200
5374,400502,408000,120,40020,2,"""11""",40200,40320
5374,408000,34202,180,40020,2,"""11""",40320,40500
5374,34202,407701,60,40020,2,"""11""",40500,40560
5374,407701,400601,120,40020,2,"""11""",40560,40680
5374,400601,407200,60,40020,2,"""11""",40680,40740
5374,407200,101102,120,40020,2,"""11""",40740,40860
5374,101102,102001,120,40020,2,"""11""",40860,40980
5374,102001,101001,120,40020,2,"""11""",40980,41100
5374,101001,118101,60,40020,2,"""11""",41100,41160
5374,118101,106001,60,40020,2,"""11""",41160,41220
5374,106001,118001,120,40020,2,"""11""",41220,41340
5374,118001,103004,180,40020,2,"""11""",41340,41520
5374,103004,112102,180,40020,2,"""11""",41520,41700
5374,112102,117001,180,40020,2,"""11""",41700,41880
5374,117001,404201,60,40020,2,"""11""",41880,41940
5374,404201,407101,60,40020,2,"""11""",41940,42000
5374,407101,405601,60,40020,2,"""11""",42000,42060
5374,405601,408502,60,40020,2,"""11""",42060,42120
5374,408502,400703,60,40020,2,"""11""",42120,42180
5374,400703,400800,60,40020,2,"""11""",42180,42240
5374,400800,408901,60,40020,2,"""11""",42240,42300
5374,408901,407501,120,40020,2,"""11""",42300,42420
5374,407501,407500,60,40020,2,"""11""",42420,42480
5374,404603,409202,60,41220,2,"""11""",41220,41280
5374,409202,400502,120,41220,2,"""11""",41280,41400
5374,400502,408000,120,41220,2,"""11""",41400,41520
5374,408000,34202,180,41220,2,"""11""",41520,41700
5374,34202,407701,60,41220,2,"""11""",41700,41760
5374,407701,400601,120,41220,2,"""11""",41760,41880
5374,400601,407200,60,41220,2,"""11""",41880,41940
5374,407200,101102,120,41220,2,"""11""",41940,42060
5374,101102,102001,120,41220,2,"""11""",42060,42180
5374,102001,101001,120,41220,2,"""11""",42180,42300
5374,101001,118101,60,41220,2,"""11""",42300,42360
5374,118101,106001,60,41220,2,"""11""",42360,42420
5374,106001,118001,120,41220,2,"""11""",42420,42540
5374,118001,103004,180,41220,2,"""11""",42540,42720
5374,103004,112102,180,41220,2,"""11""",42720,42900
5374,112102,117001,180,41220,2,"""11""",42900,43080
5374,117001,404201,60,41220,2,"""11""",43080,43140
5374,404201,407101,60,41220,2,"""11""",43140,43200
5374,407101,405601,60,41220,2,"""11""",43200,43260
5374,405601,408502,60,41220,2,"""11""",43260,43320
5374,408502,400703,60,41220,2,"""11""",43320,43380
5374,400703,400800,60,41220,2,"""11""",43380,43440
5374,400800,408901,60,41220,2,"""11""",43440,43500
5374,408901,407501,120,41220,2,"""11""",43500,43620
5374,407501,407500,60,41220,2,"""11""",43620,43680
5374,404603,409202,60,42420,2,"""11""",42420,42480
5374,409202,400502,120,42420,2,"""11""",42480,42600
5374,400502,408000,120,42420,2,"""11""",42600,42720
5374,408000,34202,180,42420,2,"""11""",42720,42900
5374,34202,407701,60,42420,2,"""11""",42900,42960
5374,407701,400601,120,42420,2,"""11""",42960,43080
5374,400601,407200,60,42420,2,"""11""",43080,43140
5374,407200,101102,120,42420,2,"""11""",43140,43260
5374,101102,102001,120,42420,2,"""11""",43260,43380
5374,102001,101001,120,42420,2,"""11""",43380,43500
5374,101001,118101,60,42420,2,"""11""",43500,43560
5374,118101,106001,60,42420,2,"""11""",43560,43620
5374,106001,118001,120,42420,2,"""11""",43620,43740
5374,118001,103004,180,42420,2,"""11""",43740,43920
5374,103004,112102,180,42420,2,"""11""",43920,44100
5374,112102,117001,180,42420,2,"""11""",44100,44280
5374,117001,404201,60,42420,2,"""11""",44280,44340
5374,404201,407101,60,42420,2,"""11""",44340,44400
5374,407101,405601,60,42420,2,"""11""",44400,44460
5374,405601,408502,60,42420,2,"""11""",44460,44520
5374,408502,400703,60,42420,2,"""11""",44520,44580
5374,400703,400800,60,42420,2,"""11""",44580,44640
5374,400800,408901,60,42420,2,"""11""",44640,44700
5374,408901,407501,120,42420,2,"""11""",44700,44820
5374,407501,407500,60,42420,2,"""11""",44820,44880
5374,404603,409202,60,43620,2,"""11""",43620,43680
5374,409202,400502,120,43620,2,"""11""",43680,43800
5374,400502,408000,120,43620,2,"""11""",43800,43920
5374,408000,34202,180,43620,2,"""11""",43920,44100
5374,34202,407701,60,43620,2,"""11""",44100,44160
5374,407701,400601,120,43620,2,"""11""",44160,44280
5374,400601,407200,60,43620,2,"""11""",44280,44340
5374,407200,101102,120,43620,2,"""11""",44340,44460
5374,101102,102001,120,43620,2,"""11""",44460,44580
5374,102001,101001,120,43620,2,"""11""",44580,44700
5374,101001,118101,60,43620,2,"""11""",44700,44760
5374,118101,106001,60,43620,2,"""11""",44760,44820
5374,106001,118001,120,43620,2,"""11""",44820,44940
5374,118001,103004,180,43620,2,"""11""",44940,45120
5374,103004,112102,180,43620,2,"""11""",45120,45300
5374,112102,117001,180,43620,2,"""11""",45300,45480
5374,117001,404201,60,43620,2,"""11""",45480,45540
5374,404201,407101,60,43620,2,"""11""",45540,45600
5374,407101,405601,60,43620,2,"""11""",45600,45660
5374,405601,408502,60,43620,2,"""11""",45660,45720
5374,408502,400703,60,43620,2,"""11""",45720,45780
5374,400703,400800,60,43620,2,"""11""",45780,45840
5374,400800,408901,60,43620,2,"""11""",45840,45900
5374,408901,407501,120,43620,2,"""11""",45900,46020
5374,407501,407500,60,43620,2,"""11""",46020,46080
5374,404603,409202,60,44820,2,"""11""",44820,44880
5374,409202,400502,120,44820,2,"""11""",44880,45000
5374,400502,408000,120,44820,2,"""11""",45000,45120
5374,408000,34202,180,44820,2,"""11""",45120,45300
5374,34202,407701,60,44820,2,"""11""",45300,45360
5374,407701,400601,120,44820,2,"""11""",45360,45480
5374,400601,407200,60,44820,2,"""11""",45480,45540
5374,407200,101102,120,44820,2,"""11""",45540,45660
5374,101102,102001,120,44820,2,"""11""",45660,45780
5374,102001,101001,120,44820,2,"""11""",45780,45900
5374,101001,118101,60,44820,2,"""11""",45900,45960
5374,118101,106001,60,44820,2,"""11""",45960,46020
5374,106001,118001,120,44820,2,"""11""",46020,46140
5374,118001,103004,180,44820,2,"""11""",46140,46320
5374,103004,112102,180,44820,2,"""11""",46320,46500
5374,112102,117001,180,44820,2,"""11""",46500,46680
5374,117001,404201,60,44820,2,"""11""",46680,46740
5374,404201,407101,60,44820,2,"""11""",46740,46800
5374,407101,405601,60,44820,2,"""11""",46800,46860
5374,405601,408502,60,44820,2,"""11""",46860,46920
5374,408502,400703,60,44820,2,"""11""",46920,46980
5374,400703,400800,60,44820,2,"""11""",46980,47040
5374,400800,408901,60,44820,2,"""11""",47040,47100
5374,408901,407501,120,44820,2,"""11""",47100,47220
5374,407501,407500,60,44820,2,"""11""",47220,47280
5374,404603,409202,60,46020,2,"""11""",46020,46080
5374,409202,400502,120,46020,2,"""11""",46080,46200
5374,400502,408000,120,46020,2,"""11""",46200,46320
5374,408000,34202,180,46020,2,"""11""",46320,46500
5374,34202,407701,60,46020,2,"""11""",46500,46560
5374,407701,400601,120,46020,2,"""11""",46560,46680
5374,400601,407200,60,46020,2,"""11""",46680,46740
5374,407200,101102,120,46020,2,"""11""",46740,46860
5374,101102,102001,120,46020,2,"""11""",46860,46980
5374,102001,101001,120,46020,2,"""11""",46980,47100
5374,101001,118101,60,46020,2,"""11""",47100,47160
5374,118101,106001,60,46020,2,"""11""",47160,47220
5374,106001,118001,120,46020,2,"""11""",47220,47340
5374,118001,103004,180,46020,2,"""11""",47340,47520
5374,103004,112102,180,46020,2,"""11""",47520,47700
5374,112102,117001,180,46020,2,"""11""",47700,47880
5374,117001,404201,60,46020,2,"""11""",47880,47940
5374,404201,407101,60,46020,2,"""11""",47940,48000
5374,407101,405601,60,46020,2,"""11""",48000,48060
5374,405601,408502,60,46020,2,"""11""",48060,48120
5374,408502,400703,60,46020,2,"""11""",48120,48180
5374,400703,400800,60,46020,2,"""11""",48180,48240
5374,400800,408901,60,46020,2,"""11""",48240,48300
5374,408901,407501,120,46020,2,"""11""",48300,48420
5374,407501,407500,60,46020,2,"""11""",48420,48480
5374,404603,409202,60,47220,2,"""11""",47220,47280
5374,409202,400502,120,47220,2,"""11""",47280,47400
5374,400502,408000,120,47220,2,"""11""",47400,47520
5374,408000,34202,180,47220,2,"""11""",47520,47700
5374,34202,407701,60,47220,2,"""11""",47700,47760
5374,407701,400601,120,47220,2,"""11""",47760,47880
5374,400601,407200,60,47220,2,"""11""",47880,47940
5374,407200,101102,120,47220,2,"""11""",47940,48060
5374,101102,102001,120,47220,2,"""11""",48060,48180
5374,102001,101001,120,47220,2,"""11""",48180,48300
5374,101001,118101,60,47220,2,"""11""",48300,48360
5374,118101,106001,60,47220,2,"""11""",48360,48420
5374,106001,118001,120,47220,2,"""11""",48420,48540
5374,118001,103004,180,47220,2,"""11""",48540,48720
5374,103004,112102,180,47220,2,"""11""",48720,48900
5374,112102,117001,180,47220,2,"""11""",48900,49080
5374,117001,404201,60,47220,2,"""11""",49080,49140
5374,404201,407101,60,47220,2,"""11""",49140,49200
5374,407101,405601,60,47220,2,"""11""",49200,49260
5374,405601,408502,60,47220,2,"""11""",49260,49320
5374,408502,400703,60,47220,2,"""11""",49320,49380
5374,400703,400800,60,47220,2,"""11""",49380,49440
5374,400800,408901,60,47220,2,"""11""",49440,49500
5374,408901,407501,120,47220,2,"""11""",49500,49620
5374,407501,407500,60,47220,2,"""11""",49620,49680
5374,404603,409202,60,48420,2,"""11""",48420,48480
5374,409202,400502,120,48420,2,"""11""",48480,48600
5374,400502,408000,120,48420,2,"""11""",48600,48720
5374,408000,34202,180,48420,2,"""11""",48720,48900
5374,34202,407701,60,48420,2,"""11""",48900,48960
5374,407701,400601,120,48420,2,"""11""",48960,49080
5374,400601,407200,60,48420,2,"""11""",49080,49140
5374,407200,101102,120,48420,2,"""11""",49140,49260
5374,101102,102001,120,48420,2,"""11""",49260,49380
5374,102001,101001,120,48420,2,"""11""",49380,49500
5374,101001,118101,60,48420,2,"""11""",49500,49560
5374,118101,106001,60,48420,2,"""11""",49560,49620
5374,106001,118001,120,48420,2,"""11""",49620,49740
5374,118001,103004,180,48420,2,"""11""",49740,49920
5374,103004,112102,180,48420,2,"""11""",49920,50100
5374,112102,117001,180,48420,2,"""11""",50100,50280
5374,117001,404201,60,48420,2,"""11""",50280,50340
5374,404201,407101,60,48420,2,"""11""",50340,50400
5374,407101,405601,60,48420,2,"""11""",50400,50460
5374,405601,408502,60,48420,2,"""11""",50460,50520
5374,408502,400703,60,48420,2,"""11""",50520,50580
5374,400703,400800,60,48420,2,"""11""",50580,50640
5374,400800,408901,60,48420,2,"""11""",50640,50700
5374,408901,407501,120,48420,2,"""11""",50700,50820
5374,407501,407500,60,48420,2,"""11""",50820,50880
5374,404603,409202,60,49620,2,"""11""",49620,49680
5374,409202,400502,120,49620,2,"""11""",49680,49800
5374,400502,408000,120,49620,2,"""11""",49800,49920
5374,408000,34202,180,49620,2,"""11""",49920,50100
5374,34202,407701,60,49620,2,"""11""",50100,50160
5374,407701,400601,120,49620,2,"""11""",50160,50280
5374,400601,407200,60,49620,2,"""11""",50280,50340
5374,407200,101102,120,49620,2,"""11""",50340,50460
5374,101102,102001,120,49620,2,"""11""",50460,50580
5374,102001,101001,120,49620,2,"""11""",50580,50700
5374,101001,118101,60,49620,2,"""11""",50700,50760
5374,118101,106001,60,49620,2,"""11""",50760,50820
5374,106001,118001,120,49620,2,"""11""",50820,50940
5374,118001,103004,180,49620,2,"""11""",50940,51120
5374,103004,112102,180,49620,2,"""11""",51120,51300
5374,112102,117001,180,49620,2,"""11""",51300,51480
5374,117001,404201,60,49620,2,"""11""",51480,51540
5374,404201,407101,60,49620,2,"""11""",51540,51600
5374,407101,405601,60,49620,2,"""11""",51600,51660
5374,405601,408502,60,49620,2,"""11""",51660,51720
5374,408502,400703,60,49620,2,"""11""",51720,51780
5374,400703,400800,60,49620,2,"""11""",51780,51840
5374,400800,408901,60,49620,2,"""11""",51840,51900
5374,408901,407501,120,49620,2,"""11""",51900,52020
5374,407501,407500,60,49620,2,"""11""",52020,52080
5374,404603,409202,60,50820,2,"""11""",50820,50880
5374,409202,400502,120,50820,2,"""11""",50880,51000
5374,400502,408000,120,50820,2,"""11""",51000,51120
5374,408000,34202,180,50820,2,"""11""",51120,51300
5374,34202,407701,60,50820,2,"""11""",51300,51360
5374,407701,400601,120,50820,2,"""11""",51360,51480
5374,400601,407200,60,50820,2,"""11""",51480,51540
5374,407200,101102,120,50820,2,"""11""",51540,51660
5374,101102,102001,120,50820,2,"""11""",51660,51780
5374,102001,101001,120,50820,2,"""11""",51780,51900
5374,101001,118101,60,50820,2,"""11""",51900,51960
5374,118101,106001,60,50820,2,"""11""",51960,52020
5374,106001,118001,120,50820,2,"""11""",52020,52140
5374,118001,103004,180,50820,2,"""11""",52140,52320
5374,103004,112102,180,50820,2,"""11""",52320,52500
5374,112102,117001,180,50820,2,"""11""",52500,52680
5374,117001,404201,60,50820,2,"""11""",52680,52740
5374,404201,407101,60,50820,2,"""11""",52740,52800
5374,407101,405601,60,50820,2,"""11""",52800,52860
5374,405601,408502,60,50820,2,"""11""",52860,52920
5374,408502,400703,60,50820,2,"""11""",52920,52980
5374,400703,400800,60,50820,2,"""11""",52980,53040
5374,400800,408901,60,50820,2,"""11""",53040,53100
5374,408901,407501,120,50820,2,"""11""",53100,53220
5374,407501,407500,60,50820,2,"""11""",53220,53280
5374,404603,409202,60,52020,2,"""11""",52020,52080
5374,409202,400502,120,52020,2,"""11""",52080,52200
5374,400502,408000,120,52020,2,"""11""",52200,52320
5374,408000,34202,180,52020,2,"""11""",52320,52500
5374,34202,407701,60,52020,2,"""11""",52500,52560
5374,407701,400601,120,52020,2,"""11""",52560,52680
5374,400601,407200,60,52020,2,"""11""",52680,52740
5374,407200,101102,120,52020,2,"""11""",52740,52860
5374,101102,102001,120,52020,2,"""11""",52860,52980
5374,102001,101001,120,52020,2,"""11""",52980,53100
5374,101001,118101,60,52020,2,"""11""",53100,53160
5374,118101,106001,60,52020,2,"""11""",53160,53220
5374,106001,118001,120,52020,2,"""11""",53220,53340
5374,118001,103004,180,52020,2,"""11""",53340,53520
5374,103004,112102,180,52020,2,"""11""",53520,53700
5374,112102,117001,180,52020,2,"""11""",53700,53880
5374,117001,404201,60,52020,2,"""11""",53880,53940
5374,404201,407101,60,52020,2,"""11""",53940,54000
5374,407101,405601,60,52020,2,"""11""",54000,54060
5374,405601,408502,60,52020,2,"""11""",54060,54120
5374,408502,400703,60,52020,2,"""11""",54120,54180
5374,400703,400800,60,52020,2,"""11""",54180,54240
5374,400800,408901,60,52020,2,"""11""",54240,54300
5374,408901,407501,120,52020,2,"""11""",54300,54420
5374,407501,407500,60,52020,2,"""11""",54420,54480
5374,404603,409202,60,53220,2,"""11""",53220,53280
5374,409202,400502,120,53220,2,"""11""",53280,53400
5374,400502,408000,120,53220,2,"""11""",53400,53520
5374,408000,34202,180,53220,2,"""11""",53520,53700
5374,34202,407701,60,53220,2,"""11""",53700,53760
5374,407701,400601,120,53220,2,"""11""",53760,53880
5374,400601,407200,60,53220,2,"""11""",53880,53940
5374,407200,101102,120,53220,2,"""11""",53940,54060
5374,101102,102001,120,53220,2,"""11""",54060,54180
5374,102001,101001,120,53220,2,"""11""",54180,54300
5374,101001,118101,60,53220,2,"""11""",54300,54360
5374,118101,106001,60,53220,2,"""11""",54360,54420
5374,106001,118001,120,53220,2,"""11""",54420,54540
5374,118001,103004,180,53220,2,"""11""",54540,54720
5374,103004,112102,180,53220,2,"""11""",54720,54900
5374,112102,117001,180,53220,2,"""11""",54900,55080
5374,117001,404201,60,53220,2,"""11""",55080,55140
5374,404201,407101,60,53220,2,"""11""",55140,55200
5374,407101,405601,60,53220,2,"""11""",55200,55260
5374,405601,408502,60,53220,2,"""11""",55260,55320
5374,408502,400703,60,53220,2,"""11""",55320,55380
5374,400703,400800,60,53220,2,"""11""",55380,55440
5374,400800,408901,60,53220,2,"""11""",55440,55500
5374,408901,407501,120,53220,2,"""11""",55500,55620
5374,407501,407500,60,53220,2,"""11""",55620,55680
5374,404603,409202,60,54420,2,"""11""",54420,54480
5374,409202,400502,120,54420,2,"""11""",54480,54600
5374,400502,408000,120,54420,2,"""11""",54600,54720
5374,408000,34202,180,54420,2,"""11""",54720,54900
5374,34202,407701,60,54420,2,"""11""",54900,54960
5374,407701,400601,120,54420,2,"""11""",54960,55080
5374,400601,407200,60,54420,2,"""11""",55080,55140
5374,407200,101102,120,54420,2,"""11""",55140,55260
5374,101102,102001,120,54420,2,"""11""",55260,55380
5374,102001,101001,120,54420,2,"""11""",55380,55500
5374,101001,118101,60,54420,2,"""11""",55500,55560
5374,118101,106001,60,54420,2,"""11""",55560,55620
5374,106001,118001,120,54420,2,"""11""",55620,55740
5374,118001,103004,180,54420,2,"""11""",55740,55920
5374,103004,112102,180,54420,2,"""11""",55920,56100
5374,112102,117001,180,54420,2,"""11""",56100,56280
5374,117001,404201,60,54420,2,"""11""",56280,56340
5374,404201,407101,60,54420,2,"""11""",56340,56400
5374,407101,405601,60,54420,2,"""11""",56400,56460
5374,405601,408502,60,54420,2,"""11""",56460,56520
5374,408502,400703,60,54420,2,"""11""",56520,56580
5374,400703,400800,60,54420,2,"""11""",56580,56640
5374,400800,408901,60,54420,2,"""11""",56640,56700
5374,408901,407501,120,54420,2,"""11""",56700,56820
5374,407501,407500,60,54420,2,"""11""",56820,56880
5374,404603,409202,60,55620,2,"""11""",55620,55680
5374,409202,400502,120,55620,2,"""11""",55680,55800
5374,400502,408000,120,55620,2,"""11""",55800,55920
5374,408000,34202,180,55620,2,"""11""",55920,56100
5374,34202,407701,60,55620,2,"""11""",56100,56160
5374,407701,400601,120,55620,2,"""11""",56160,56280
5374,400601,407200,60,55620,2,"""11""",56280,56340
5374,407200,101102,120,55620,2,"""11""",56340,56460
5374,101102,102001,120,55620,2,"""11""",56460,56580
5374,102001,101001,120,55620,2,"""11""",56580,56700
5374,101001,118101,60,55620,2,"""11""",56700,56760
5374,118101,106001,60,55620,2,"""11""",56760,56820
5374,106001,118001,120,55620,2,"""11""",56820,56940
5374,118001,103004,180,55620,2,"""11""",56940,57120
5374,103004,112102,180,55620,2,"""11""",57120,57300
5374,112102,117001,180,55620,2,"""11""",57300,57480
5374,117001,404201,60,55620,2,"""11""",57480,57540
5374,404201,407101,60,55620,2,"""11""",57540,57600
5374,407101,405601,60,55620,2,"""11""",57600,57660
5374,405601,408502,60,55620,2,"""11""",57660,57720
5374,408502,400703,60,55620,2,"""11""",57720,57780
5374,400703,400800,60,55620,2,"""11""",57780,57840
5374,400800,408901,60,55620,2,"""11""",57840,57900
5374,408901,407501,120,55620,2,"""11""",57900,58020
5374,407501,407500,60,55620,2,"""11""",58020,58080
5374,404603,409202,60,56820,2,"""11""",56820,56880
5374,409202,400502,120,56820,2,"""11""",56880,57000
5374,400502,408000,120,56820,2,"""11""",57000,57120
5374,408000,34202,180,56820,2,"""11""",57120,57300
5374,34202,407701,60,56820,2,"""11""",57300,57360
5374,407701,400601,120,56820,2,"""11""",57360,57480
5374,400601,407200,60,56820,2,"""11""",57480,57540
5374,407200,101102,120,56820,2,"""11""",57540,57660
5374,101102,102001,120,56820,2,"""11""",57660,57780
5374,102001,101001,120,56820,2,"""11""",57780,57900
5374,101001,118101,60,56820,2,"""11""",57900,57960
5374,118101,106001,60,56820,2,"""11""",57960,58020
5374,106001,118001,120,56820,2,"""11""",58020,58140
5374,118001,103004,180,56820,2,"""11""",58140,58320
5374,103004,112102,180,56820,2,"""11""",58320,58500
5374,112102,117001,180,56820,2,"""11""",58500,58680
5374,117001,404201,60,56820,2,"""11""",58680,58740
5374,404201,407101,60,56820,2,"""11""",58740,58800
5374,407101,405601,60,56820,2,"""11""",58800,58860
5374,405601,408502,60,56820,2,"""11""",58860,58920
5374,408502,400703,60,56820,2,"""11""",58920,58980
5374,400703,400800,60,56820,2,"""11""",58980,59040
5374,400800,408901,60,56820,2,"""11""",59040,59100
5374,408901,407501,120,56820,2,"""11""",59100,59220
5374,407501,407500,60,56820,2,"""11""",59220,59280
5374,404603,409202,60,58020,2,"""11""",58020,58080
5374,409202,400502,120,58020,2,"""11""",58080,58200
5374,400502,408000,120,58020,2,"""11""",58200,58320
5374,408000,34202,180,58020,2,"""11""",58320,58500
5374,34202,407701,60,58020,2,"""11""",58500,58560
5374,407701,400601,120,58020,2,"""11""",58560,58680
5374,400601,407200,60,58020,2,"""11""",58680,58740
5374,407200,101102,120,58020,2,"""11""",58740,58860
5374,101102,102001,120,58020,2,"""11""",58860,58980
5374,102001,101001,120,58020,2,"""11""",58980,59100
5374,101001,118101,60,58020,2,"""11""",59100,59160
5374,118101,106001,60,58020,2,"""11""",59160,59220
5374,106001,118001,120,58020,2,"""11""",59220,59340
5374,118001,103004,180,58020,2,"""11""",59340,59520
5374,103004,112102,180,58020,2,"""11""",59520,59700
5374,112102,117001,180,58020,2,"""11""",59700,59880
5374,117001,404201,60,58020,2,"""11""",59880,59940
5374,404201,407101,60,58020,2,"""11""",59940,60000
5374,407101,405601,60,58020,2,"""11""",60000,60060
5374,405601,408502,60,58020,2,"""11""",60060,60120
5374,408502,400703,60,58020,2,"""11""",60120,60180
5374,400703,400800,60,58020,2,"""11""",60180,60240
5374,400800,408901,60,58020,2,"""11""",60240,60300
5374,408901,407501,120,58020,2,"""11""",60300,60420
5374,407501,407500,60,58020,2,"""11""",60420,60480
5374,404603,409202,60,59220,2,"""11""",59220,59280
5374,409202,400502,120,59220,2,"""11""",59280,59400
5374,400502,408000,120,59220,2,"""11""",59400,59520
5374,408000,34202,180,59220,2,"""11""",59520,59700
5374,34202,407701,60,59220,2,"""11""",59700,59760
5374,407701,400601,120,59220,2,"""11""",59760,59880
5374,400601,407200,60,59220,2,"""11""",59880,59940
5374,407200,101102,120,59220,2,"""11""",59940,60060
5374,101102,102001,120,59220,2,"""11""",60060,60180
5374,102001,101001,120,59220,2,"""11""",60180,60300
5374,101001,118101,60,59220,2,"""11""",60300,60360
5374,118101,106001,60,59220,2,"""11""",60360,60420
5374,106001,118001,120,59220,2,"""11""",60420,60540
5374,118001,103004,180,59220,2,"""11""",60540,60720
5374,103004,112102,180,59220,2,"""11""",60720,60900
5374,112102,117001,180,59220,2,"""11""",60900,61080
5374,117001,404201,60,59220,2,"""11""",61080,61140
5374,404201,407101,60,59220,2,"""11""",61140,61200
5374,407101,405601,60,59220,2,"""11""",61200,61260
5374,405601,408502,60,59220,2,"""11""",61260,61320
5374,408502,400703,60,59220,2,"""11""",61320,61380
5374,400703,400800,60,59220,2,"""11""",61380,61440
5374,400800,408901,60,59220,2,"""11""",61440,61500
5374,408901,407501,120,59220,2,"""11""",61500,61620
5374,407501,407500,60,59220,2,"""11""",61620,61680
5374,404603,409202,60,60420,2,"""11""",60420,60480
5374,409202,400502,120,60420,2,"""11""",60480,60600
5374,400502,408000,120,60420,2,"""11""",60600,60720
5374,408000,34202,180,60420,2,"""11""",60720,60900
5374,34202,407701,60,60420,2,"""11""",60900,60960
5374,407701,400601,120,60420,2,"""11""",60960,61080
5374,400601,407200,60,60420,2,"""11""",61080,61140
5374,407200,101102,120,60420,2,"""11""",61140,61260
5374,101102,102001,120,60420,2,"""11""",61260,61380
5374,102001,101001,120,60420,2,"""11""",61380,61500
5374,101001,118101,60,60420,2,"""11""",61500,61560
5374,118101,106001,60,60420,2,"""11""",61560,61620
5374,106001,118001,120,60420,2,"""11""",61620,61740
5374,118001,103004,180,60420,2,"""11""",61740,61920
5374,103004,112102,180,60420,2,"""11""",61920,62100
5374,112102,117001,180,60420,2,"""11""",62100,62280
5374,117001,404201,60,60420,2,"""11""",62280,62340
5374,404201,407101,60,60420,2,"""11""",62340,62400
5374,407101,405601,60,60420,2,"""11""",62400,62460
5374,405601,408502,60,60420,2,"""11""",62460,62520
5374,408502,400703,60,60420,2,"""11""",62520,62580
5374,400703,400800,60,60420,2,"""11""",62580,62640
5374,400800,408901,60,60420,2,"""11""",62640,62700
5374,408901,407501,120,60420,2,"""11""",62700,62820
5374,407501,407500,60,60420,2,"""11""",62820,62880
5374,404603,409202,60,61620,2,"""11""",61620,61680
5374,409202,400502,120,61620,2,"""11""",61680,61800
5374,400502,408000,120,61620,2,"""11""",61800,61920
5374,408000,34202,180,61620,2,"""11""",61920,62100
5374,34202,407701,60,61620,2,"""11""",62100,62160
5374,407701,400601,120,61620,2,"""11""",62160,62280
5374,400601,407200,60,61620,2,"""11""",62280,62340
5374,407200,101102,120,61620,2,"""11""",62340,62460
5374,101102,102001,120,61620,2,"""11""",62460,62580
5374,102001,101001,120,61620,2,"""11""",62580,62700
5374,101001,118101,60,61620,2,"""11""",62700,62760
5374,118101,106001,60,61620,2,"""11""",62760,62820
5374,106001,118001,120,61620,2,"""11""",62820,62940
5374,118001,103004,180,61620,2,"""11""",62940,63120
5374,103004,112102,180,61620,2,"""11""",63120,63300
5374,112102,117001,180,61620,2,"""11""",63300,63480
5374,117001,404201,60,61620,2,"""11""",63480,63540
5374,404201,407101,60,61620,2,"""11""",63540,63600
5374,407101,405601,60,61620,2,"""11""",63600,63660
5374,405601,408502,60,61620,2,"""11""",63660,63720
5374,408502,400703,60,61620,2,"""11""",63720,63780
5374,400703,400800,60,61620,2,"""11""",63780,63840
5374,400800,408901,60,61620,2,"""11""",63840,63900
5374,408901,407501,120,61620,2,"""11""",63900,64020
5374,407501,407500,60,61620,2,"""11""",64020,64080
5374,404603,409202,60,62820,2,"""11""",62820,62880
5374,409202,400502,120,62820,2,"""11""",62880,63000
5374,400502,408000,120,62820,2,"""11""",63000,63120
5374,408000,34202,180,62820,2,"""11""",63120,63300
5374,34202,407701,60,62820,2,"""11""",63300,63360
5374,407701,400601,120,62820,2,"""11""",63360,63480
5374,400601,407200,60,62820,2,"""11""",63480,63540
5374,407200,101102,120,62820,2,"""11""",63540,63660
5374,101102,102001,120,62820,2,"""11""",63660,63780
5374,102001,101001,120,62820,2,"""11""",63780,63900
5374,101001,118101,60,62820,2,"""11""",63900,63960
5374,118101,106001,60,62820,2,"""11""",63960,64020
5374,106001,118001,120,62820,2,"""11""",64020,64140
5374,118001,103004,180,62820,2,"""11""",64140,64320
5374,103004,112102,180,62820,2,"""11""",64320,64500
5374,112102,117001,180,62820,2,"""11""",64500,64680
5374,117001,404201,60,62820,2,"""11""",64680,64740
5374,404201,407101,60,62820,2,"""11""",64740,64800
5374,407101,405601,60,62820,2,"""11""",64800,64860
5374,405601,408502,60,62820,2,"""11""",64860,64920
5374,408502,400703,60,62820,2,"""11""",64920,64980
5374,400703,400800,60,62820,2,"""11""",64980,65040
5374,400800,408901,60,62820,2,"""11""",65040,65100
5374,408901,407501,120,62820,2,"""11""",65100,65220
5374,407501,407500,60,62820,2,"""11""",65220,65280
5374,404603,409202,60,64020,2,"""11""",64020,64080
5374,409202,400502,120,64020,2,"""11""",64080,64200
5374,400502,408000,120,64020,2,"""11""",64200,64320
5374,408000,34202,180,64020,2,"""11""",64320,64500
5374,34202,407701,60,64020,2,"""11""",64500,64560
5374,407701,400601,120,64020,2,"""11""",64560,64680
5374,400601,407200,60,64020,2,"""11""",64680,64740
5374,407200,101102,120,64020,2,"""11""",64740,64860
5374,101102,102001,120,64020,2,"""11""",64860,64980
5374,102001,101001,120,64020,2,"""11""",64980,65100
5374,101001,118101,60,64020,2,"""11""",65100,65160
5374,118101,106001,60,64020,2,"""11""",65160,65220
5374,106001,118001,120,64020,2,"""11""",65220,65340
5374,118001,103004,180,64020,2,"""11""",65340,65520
5374,103004,112102,180,64020,2,"""11""",65520,65700
5374,112102,117001,180,64020,2,"""11""",65700,65880
5374,117001,404201,60,64020,2,"""11""",65880,65940
5374,404201,407101,60,64020,2,"""11""",65940,66000
5374,407101,405601,60,64020,2,"""11""",66000,66060
5374,405601,408502,60,64020,2,"""11""",66060,66120
5374,408502,400703,60,64020,2,"""11""",66120,66180
5374,400703,400800,60,64020,2,"""11""",66180,66240
5374,400800,408901,60,64020,2,"""11""",66240,66300
5374,408901,407501,120,64020,2,"""11""",66300,66420
5374,407501,407500,60,64020,2,"""11""",66420,66480
5374,404603,409202,60,65220,2,"""11""",65220,65280
5374,409202,400502,120,65220,2,"""11""",65280,65400
5374,400502,408000,120,65220,2,"""11""",65400,65520
5374,408000,34202,180,65220,2,"""11""",65520,65700
5374,34202,407701,60,65220,2,"""11""",65700,65760
5374,407701,400601,120,65220,2,"""11""",65760,65880
5374,400601,407200,60,65220,2,"""11""",65880,65940
5374,407200,101102,120,65220,2,"""11""",65940,66060
5374,101102,102001,120,65220,2,"""11""",66060,66180
5374,102001,101001,120,65220,2,"""11""",66180,66300
5374,101001,118101,60,65220,2,"""11""",66300,66360
5374,118101,106001,60,65220,2,"""11""",66360,66420
5374,106001,118001,120,65220,2,"""11""",66420,66540
5374,118001,103004,180,65220,2,"""11""",66540,66720
5374,103004,112102,180,65220,2,"""11""",66720,66900
5374,112102,117001,180,65220,2,"""11""",66900,67080
5374,117001,404201,60,65220,2,"""11""",67080,67140
5374,404201,407101,60,65220,2,"""11""",67140,67200
5374,407101,405601,60,65220,2,"""11""",67200,67260
5374,405601,408502,60,65220,2,"""11""",67260,67320
5374,408502,400703,60,65220,2,"""11""",67320,67380
5374,400703,400800,60,65220,2,"""11""",67380,67440
5374,400800,408901,60,65220,2,"""11""",67440,67500
5374,408901,407501,120,65220,2,"""11""",67500,67620
5374,407501,407500,60,65220,2,"""11""",67620,67680
5374,404603,409202,60,66420,2,"""11""",66420,66480
5374,409202,400502,120,66420,2,"""11""",66480,66600
5374,400502,408000,120,66420,2,"""11""",66600,66720
5374,408000,34202,180,66420,2,"""11""",66720,66900
5374,34202,407701,60,66420,2,"""11""",66900,66960
5374,407701,400601,120,66420,2,"""11""",66960,67080
5374,400601,407200,60,66420,2,"""11""",67080,67140
5374,407200,101102,120,66420,2,"""11""",67140,67260
5374,101102,102001,120,66420,2,"""11""",67260,67380
5374,102001,101001,120,66420,2,"""11""",67380,67500
5374,101001,118101,60,66420,2,"""11""",67500,67560
5374,118101,106001,60,66420,2,"""11""",67560,67620
5374,106001,118001,120,66420,2,"""11""",67620,67740
5374,118001,103004,180,66420,2,"""11""",67740,67920
5374,103004,112102,180,66420,2,"""11""",67920,68100
5374,112102,117001,180,66420,2,"""11""",68100,68280
5374,117001,404201,60,66420,2,"""11""",68280,68340
5374,404201,407101,60,66420,2,"""11""",68340,68400
5374,407101,405601,60,66420,2,"""11""",68400,68460
5374,405601,408502,60,66420,2,"""11""",68460,68520
5374,408502,400703,60,66420,2,"""11""",68520,68580
5374,400703,400800,60,66420,2,"""11""",68580,68640
5374,400800,408901,60,66420,2,"""11""",68640,68700
5374,408901,407501,120,66420,2,"""11""",68700,68820
5374,407501,407500,60,66420,2,"""11""",68820,68880
5374,404603,409202,60,67620,2,"""11""",67620,67680
5374,409202,400502,120,67620,2,"""11""",67680,67800
5374,400502,408000,120,67620,2,"""11""",67800,67920
5374,408000,34202,180,67620,2,"""11""",67920,68100
5374,34202,407701,60,67620,2,"""11""",68100,68160
5374,407701,400601,120,67620,2,"""11""",68160,68280
5374,400601,407200,60,67620,2,"""11""",68280,68340
5374,407200,101102,120,67620,2,"""11""",68340,68460
5374,101102,102001,120,67620,2,"""11""",68460,68580
5374,102001,101001,120,67620,2,"""11""",68580,68700
5374,101001,118101,60,67620,2,"""11""",68700,68760
5374,118101,106001,60,67620,2,"""11""",68760,68820
5374,106001,118001,120,67620,2,"""11""",68820,68940
5374,118001,103004,180,67620,2,"""11""",68940,69120
5374,103004,112102,180,67620,2,"""11""",69120,69300
5374,112102,117001,180,67620,2,"""11""",69300,69480
5374,117001,404201,60,67620,2,"""11""",69480,69540
5374,404201,407101,60,67620,2,"""11""",69540,69600
5374,407101,405601,60,67620,2,"""11""",69600,69660
5374,405601,408502,60,67620,2,"""11""",69660,69720
5374,408502,400703,60,67620,2,"""11""",69720,69780
5374,400703,400800,60,67620,2,"""11""",69780,69840
5374,400800,408901,60,67620,2,"""11""",69840,69900
5374,408901,407501,120,67620,2,"""11""",69900,70020
5374,407501,407500,60,67620,2,"""11""",70020,70080
5375,404601,403700,60,20580,2,"""3""",20580,20640
5375,403700,403501,0,20580,2,"""3""",20640,20640
5375,403501,408402,60,20580,2,"""3""",20640,20700
5375,408402,407701,60,20580,2,"""3""",20700,20760
5375,407701,400601,120,20580,2,"""3""",20760,20880
5375,400601,407200,60,20580,2,"""3""",20880,20940
5375,407200,101102,120,20580,2,"""3""",20940,21060
5375,101102,102001,120,20580,2,"""3""",21060,21180
5375,102001,101001,120,20580,2,"""3""",21180,21300
5375,101001,118101,60,20580,2,"""3""",21300,21360
5375,118101,106001,60,20580,2,"""3""",21360,21420
5375,106001,118001,120,20580,2,"""3""",21420,21540
5375,118001,103004,180,20580,2,"""3""",21540,21720
5375,103004,112102,180,20580,2,"""3""",21720,21900
5375,112102,117001,180,20580,2,"""3""",21900,22080
5375,117001,404201,60,20580,2,"""3""",22080,22140
5375,404201,407101,60,20580,2,"""3""",22140,22200
5375,407101,405601,60,20580,2,"""3""",22200,22260
5375,405601,408502,60,20580,2,"""3""",22260,22320
5375,408502,400703,60,20580,2,"""3""",22320,22380
5375,400703,400800,60,20580,2,"""3""",22380,22440
5375,400800,408901,60,20580,2,"""3""",22440,22500
5375,408901,407501,120,20580,2,"""3""",22500,22620
5375,407501,407500,60,20580,2,"""3""",22620,22680
5375,404601,403700,60,21180,2,"""3""",21180,21240
5375,403700,403501,0,21180,2,"""3""",21240,21240
5375,403501,408402,60,21180,2,"""3""",21240,21300
5375,408402,407701,60,21180,2,"""3""",21300,21360
5375,407701,400601,120,21180,2,"""3""",21360,21480
5375,400601,407200,60,21180,2,"""3""",21480,21540
5375,407200,101102,120,21180,2,"""3""",21540,21660
5375,101102,102001,120,21180,2,"""3""",21660,21780
5375,102001,101001,120,21180,2,"""3""",21780,21900
5375,101001,118101,60,21180,2,"""3""",21900,21960
5375,118101,106001,60,21180,2,"""3""",21960,22020
5375,106001,118001,120,21180,2,"""3""",22020,22140
5375,118001,103004,180,21180,2,"""3""",22140,22320
5375,103004,112102,180,21180,2,"""3""",22320,22500
5375,112102,117001,180,21180,2,"""3""",22500,22680
5375,117001,404201,60,21180,2,"""3""",22680,22740
5375,404201,407101,60,21180,2,"""3""",22740,22800
5375,407101,405601,60,21180,2,"""3""",22800,22860
5375,405601,408502,60,21180,2,"""3""",22860,22920
5375,408502,400703,60,21180,2,"""3""",22920,22980
5375,400703,400800,60,21180,2,"""3""",22980,23040
5375,400800,408901,60,21180,2,"""3""",23040,23100
5375,408901,407501,120,21180,2,"""3""",23100,23220
5375,407501,407500,60,21180,2,"""3""",23220,23280
5375,404601,403700,60,22380,2,"""3""",22380,22440
5375,403700,403501,0,22380,2,"""3""",22440,22440
5375,403501,408402,60,22380,2,"""3""",22440,22500
5375,408402,407701,60,22380,2,"""3""",22500,22560
5375,407701,400601,120,22380,2,"""3""",22560,22680
5375,400601,407200,60,22380,2,"""3""",22680,22740
5375,407200,101102,120,22380,2,"""3""",22740,22860
5375,101102,102001,120,22380,2,"""3""",22860,22980
5375,102001,101001,120,22380,2,"""3""",22980,23100
5375,101001,118101,60,22380,2,"""3""",23100,23160
5375,118101,106001,60,22380,2,"""3""",23160,23220
5375,106001,118001,120,22380,2,"""3""",23220,23340
5375,118001,103004,180,22380,2,"""3""",23340,23520
5375,103004,112102,180,22380,2,"""3""",23520,23700
5375,112102,117001,180,22380,2,"""3""",23700,23880
5375,117001,404201,60,22380,2,"""3""",23880,23940
5375,404201,407101,60,22380,2,"""3""",23940,24000
5375,407101,405601,60,22380,2,"""3""",24000,24060
5375,405601,408502,60,22380,2,"""3""",24060,24120
5375,408502,400703,60,22380,2,"""3""",24120,24180
5375,400703,400800,60,22380,2,"""3""",24180,24240
5375,400800,408901,60,22380,2,"""3""",24240,24300
5375,408901,407501,120,22380,2,"""3""",24300,24420
5375,407501,407500,60,22380,2,"""3""",24420,24480
5375,404601,403700,60,23580,2,"""3""",23580,23640
5375,403700,403501,0,23580,2,"""3""",23640,23640
5375,403501,408402,60,23580,2,"""3""",23640,23700
5375,408402,407701,60,23580,2,"""3""",23700,23760
5375,407701,400601,120,23580,2,"""3""",23760,23880
5375,400601,407200,60,23580,2,"""3""",23880,23940
5375,407200,101102,120,23580,2,"""3""",23940,24060
5375,101102,102001,120,23580,2,"""3""",24060,24180
5375,102001,101001,120,23580,2,"""3""",24180,24300
5375,101001,118101,60,23580,2,"""3""",24300,24360
5375,118101,106001,60,23580,2,"""3""",24360,24420
5375,106001,118001,120,23580,2,"""3""",24420,24540
5375,118001,103004,180,23580,2,"""3""",24540,24720
5375,103004,112102,180,23580,2,"""3""",24720,24900
5375,112102,117001,180,23580,2,"""3""",24900,25080
5375,117001,404201,60,23580,2,"""3""",25080,25140
5375,404201,407101,60,23580,2,"""3""",25140,25200
5375,407101,405601,60,23580,2,"""3""",25200,25260
5375,405601,408502,60,23580,2,"""3""",25260,25320
5375,408502,400703,60,23580,2,"""3""",25320,25380
5375,400703,400800,60,23580,2,"""3""",25380,25440
5375,400800,408901,60,23580,2,"""3""",25440,25500
5375,408901,407501,120,23580,2,"""3""",25500,25620
5375,407501,407500,60,23580,2,"""3""",25620,25680
5375,404601,403700,60,24780,2,"""3""",24780,24840
5375,403700,403501,0,24780,2,"""3""",24840,24840
5375,403501,408402,60,24780,2,"""3""",24840,24900
5375,408402,407701,60,24780,2,"""3""",24900,24960
5375,407701,400601,120,24780,2,"""3""",24960,25080
5375,400601,407200,60,24780,2,"""3""",25080,25140
5375,407200,101102,120,24780,2,"""3""",25140,25260
5375,101102,102001,120,24780,2,"""3""",25260,25380
5375,102001,101001,120,24780,2,"""3""",25380,25500
5375,101001,118101,60,24780,2,"""3""",25500,25560
5375,118101,106001,60,24780,2,"""3""",25560,25620
5375,106001,118001,120,24780,2,"""3""",25620,25740
5375,118001,103004,180,24780,2,"""3""",25740,25920
5375,103004,112102,180,24780,2,"""3""",25920,26100
5375,112102,117001,180,24780,2,"""3""",26100,26280
5375,117001,404201,60,24780,2,"""3""",26280,26340
5375,404201,407101,60,24780,2,"""3""",26340,26400
5375,407101,405601,60,24780,2,"""3""",26400,26460
5375,405601,408502,60,24780,2,"""3""",26460,26520
5375,408502,400703,60,24780,2,"""3""",26520,26580
5375,400703,400800,60,24780,2,"""3""",26580,26640
5375,400800,408901,60,24780,2,"""3""",26640,26700
5375,408901,407501,120,24780,2,"""3""",26700,26820
5375,407501,407500,60,24780,2,"""3""",26820,26880
5378,407500,407503,60,21360,2,"""2""",21360,21420
5378,407503,408900,60,21360,2,"""2""",21420,21480
5378,408900,400802,60,21360,2,"""2""",21480,21540
5378,400802,400704,120,21360,2,"""2""",21540,21660
5378,400704,408503,60,21360,2,"""2""",21660,21720
5378,408503,405602,60,21360,2,"""2""",21720,21780
5378,405602,407102,60,21360,2,"""2""",21780,21840
5378,407102,404202,60,21360,2,"""2""",21840,21900
5378,404202,117000,60,21360,2,"""2""",21900,21960
5378,117000,112106,120,21360,2,"""2""",21960,22080
5378,112106,103003,120,21360,2,"""2""",22080,22200
5378,103003,118002,180,21360,2,"""2""",22200,22380
5378,118002,106002,60,21360,2,"""2""",22380,22440
5378,106002,118102,60,21360,2,"""2""",22440,22500
5378,118102,101002,120,21360,2,"""2""",22500,22620
5378,101002,102002,60,21360,2,"""2""",22620,22680
5378,102002,101101,120,21360,2,"""2""",22680,22800
5378,101101,403802,120,21360,2,"""2""",22800,22920
5378,403802,408300,120,21360,2,"""2""",22920,23040
5378,408300,406502,60,21360,2,"""2""",23040,23100
5378,406502,407702,60,21360,2,"""2""",23100,23160
5378,407702,408403,60,21360,2,"""2""",23160,23220
5378,408403,403502,60,21360,2,"""2""",23220,23280
5378,403502,403701,60,21360,2,"""2""",23280,23340
5378,403701,404600,60,21360,2,"""2""",23340,23400
5378,404600,402602,60,21360,2,"""2""",23400,23460
5378,402602,403602,120,21360,2,"""2""",23460,23580
5378,403602,404700,120,21360,2,"""2""",23580,23700
5378,404700,404701,0,21360,2,"""2""",23700,23700
5378,407500,407503,60,22560,2,"""2""",22560,22620
5378,407503,408900,60,22560,2,"""2""",22620,22680
5378,408900,400802,60,22560,2,"""2""",22680,22740
5378,400802,400704,120,22560,2,"""2""",22740,22860
5378,400704,408503,60,22560,2,"""2""",22860,22920
5378,408503,405602,60,22560,2,"""2""",22920,22980
5378,405602,407102,60,22560,2,"""2""",22980,23040
5378,407102,404202,60,22560,2,"""2""",23040,23100
5378,404202,117000,60,22560,2,"""2""",23100,23160
5378,117000,112106,120,22560,2,"""2""",23160,23280
5378,112106,103003,120,22560,2,"""2""",23280,23400
5378,103003,118002,180,22560,2,"""2""",23400,23580
5378,118002,106002,60,22560,2,"""2""",23580,23640
5378,106002,118102,60,22560,2,"""2""",23640,23700
5378,118102,101002,120,22560,2,"""2""",23700,23820
5378,101002,102002,60,22560,2,"""2""",23820,23880
5378,102002,101101,120,22560,2,"""2""",23880,24000
5378,101101,403802,120,22560,2,"""2""",24000,24120
5378,403802,408300,120,22560,2,"""2""",24120,24240
5378,408300,406502,60,22560,2,"""2""",24240,24300
5378,406502,407702,60,22560,2,"""2""",24300,24360
5378,407702,408403,60,22560,2,"""2""",24360,24420
5378,408403,403502,60,22560,2,"""2""",24420,24480
5378,403502,403701,60,22560,2,"""2""",24480,24540
5378,403701,404600,60,22560,2,"""2""",24540,24600
5378,404600,402602,60,22560,2,"""2""",24600,24660
5378,402602,403602,120,22560,2,"""2""",24660,24780
5378,403602,404700,120,22560,2,"""2""",24780,24900
5378,404700,404701,0,22560,2,"""2""",24900,24900
5378,407500,407503,60,23760,2,"""2""",23760,23820
5378,407503,408900,60,23760,2,"""2""",23820,23880
5378,408900,400802,60,23760,2,"""2""",23880,23940
5378,400802,400704,120,23760,2,"""2""",23940,24060
5378,400704,408503,60,23760,2,"""2""",24060,24120
5378,408503,405602,60,23760,2,"""2""",24120,24180
5378,405602,407102,60,23760,2,"""2""",24180,24240
5378,407102,404202,60,23760,2,"""2""",24240,24300
5378,404202,117000,60,23760,2,"""2""",24300,24360
5378,117000,112106,120,23760,2,"""2""",24360,24480
5378,112106,103003,120,23760,2,"""2""",24480,24600
5378,103003,118002,180,23760,2,"""2""",24600,24780
5378,118002,106002,60,23760,2,"""2""",24780,24840
5378,106002,118102,60,23760,2,"""2""",24840,24900
5378,118102,101002,120,23760,2,"""2""",24900,25020
5378,101002,102002,60,23760,2,"""2""",25020,25080
5378,102002,101101,120,23760,2,"""2""",25080,25200
5378,101101,403802,120,23760,2,"""2""",25200,25320
5378,403802,408300,120,23760,2,"""2""",25320,25440
5378,408300,406502,60,23760,2,"""2""",25440,25500
5378,406502,407702,60,23760,2,"""2""",25500,25560
5378,407702,408403,60,23760,2,"""2""",25560,25620
5378,408403,403502,60,23760,2,"""2""",25620,25680
5378,403502,403701,60,23760,2,"""2""",25680,25740
5378,403701,404600,60,23760,2,"""2""",25740,25800
5378,404600,402602,60,23760,2,"""2""",25800,25860
5378,402602,403602,120,23760,2,"""2""",25860,25980
5378,403602,404700,120,23760,2,"""2""",25980,26100
5378,404700,404701,0,23760,2,"""2""",26100,26100
5378,407500,407503,60,24960,2,"""2""",24960,25020
5378,407503,408900,60,24960,2,"""2""",25020,25080
5378,408900,400802,60,24960,2,"""2""",25080,25140
5378,400802,400704,120,24960,2,"""2""",25140,25260
5378,400704,408503,60,24960,2,"""2""",25260,25320
5378,408503,405602,60,24960,2,"""2""",25320,25380
5378,405602,407102,60,24960,2,"""2""",25380,25440
5378,407102,404202,60,24960,2,"""2""",25440,25500
5378,404202,117000,60,24960,2,"""2""",25500,25560
5378,117000,112106,120,24960,2,"""2""",25560,25680
5378,112106,103003,120,24960,2,"""2""",25680,25800
5378,103003,118002,180,24960,2,"""2""",25800,25980
5378,118002,106002,60,24960,2,"""2""",25980,26040
5378,106002,118102,60,24960,2,"""2""",26040,26100
5378,118102,101002,120,24960,2,"""2""",26100,26220
5378,101002,102002,60,24960,2,"""2""",26220,26280
5378,102002,101101,120,24960,2,"""2""",26280,26400
5378,101101,403802,120,24960,2,"""2""",26400,26520
5378,403802,408300,120,24960,2,"""2""",26520,26640
5378,408300,406502,60,24960,2,"""2""",26640,26700
5378,406502,407702,60,24960,2,"""2""",26700,26760
5378,407702,408403,60,24960,2,"""2""",26760,26820
5378,408403,403502,60,24960,2,"""2""",26820,26880
5378,403502,403701,60,24960,2,"""2""",26880,26940
5378,403701,404600,60,24960,2,"""2""",26940,27000
5378,404600,402602,60,24960,2,"""2""",27000,27060
5378,402602,403602,120,24960,2,"""2""",27060,27180
5378,403602,404700,120,24960,2,"""2""",27180,27300
5378,404700,404701,0,24960,2,"""2""",27300,27300
5378,407500,407503,60,26160,2,"""2""",26160,26220
5378,407503,408900,60,26160,2,"""2""",26220,26280
5378,408900,400802,60,26160,2,"""2""",26280,26340
5378,400802,400704,120,26160,2,"""2""",26340,26460
5378,400704,408503,60,26160,2,"""2""",26460,26520
5378,408503,405602,60,26160,2,"""2""",26520,26580
5378,405602,407102,60,26160,2,"""2""",26580,26640
5378,407102,404202,60,26160,2,"""2""",26640,26700
5378,404202,117000,60,26160,2,"""2""",26700,26760
5378,117000,112106,120,26160,2,"""2""",26760,26880
5378,112106,103003,120,26160,2,"""2""",26880,27000
5378,103003,118002,180,26160,2,"""2""",27000,27180
5378,118002,106002,60,26160,2,"""2""",27180,27240
5378,106002,118102,60,26160,2,"""2""",27240,27300
5378,118102,101002,120,26160,2,"""2""",27300,27420
5378,101002,102002,60,26160,2,"""2""",27420,27480
5378,102002,101101,120,26160,2,"""2""",27480,27600
5378,101101,403802,120,26160,2,"""2""",27600,27720
5378,403802,408300,120,26160,2,"""2""",27720,27840
5378,408300,406502,60,26160,2,"""2""",27840,27900
5378,406502,407702,60,26160,2,"""2""",27900,27960
5378,407702,408403,60,26160,2,"""2""",27960,28020
5378,408403,403502,60,26160,2,"""2""",28020,28080
5378,403502,403701,60,26160,2,"""2""",28080,28140
5378,403701,404600,60,26160,2,"""2""",28140,28200
5378,404600,402602,60,26160,2,"""2""",28200,28260
5378,402602,403602,120,26160,2,"""2""",28260,28380
5378,403602,404700,120,26160,2,"""2""",28380,28500
5378,404700,404701,0,26160,2,"""2""",28500,28500
5378,407500,407503,60,27360,2,"""2""",27360,27420
5378,407503,408900,60,27360,2,"""2""",27420,27480
5378,408900,400802,60,27360,2,"""2""",27480,27540
5378,400802,400704,120,27360,2,"""2""",27540,27660
5378,400704,408503,60,27360,2,"""2""",27660,27720
5378,408503,405602,60,27360,2,"""2""",27720,27780
5378,405602,407102,60,27360,2,"""2""",27780,27840
5378,407102,404202,60,27360,2,"""2""",27840,27900
5378,404202,117000,60,27360,2,"""2""",27900,27960
5378,117000,112106,120,27360,2,"""2""",27960,28080
5378,112106,103003,120,27360,2,"""2""",28080,28200
5378,103003,118002,180,27360,2,"""2""",28200,28380
5378,118002,106002,60,27360,2,"""2""",28380,28440
5378,106002,118102,60,27360,2,"""2""",28440,28500
5378,118102,101002,120,27360,2,"""2""",28500,28620
5378,101002,102002,60,27360,2,"""2""",28620,28680
5378,102002,101101,120,27360,2,"""2""",28680,28800
5378,101101,403802,120,27360,2,"""2""",28800,28920
5378,403802,408300,120,27360,2,"""2""",28920,29040
5378,408300,406502,60,27360,2,"""2""",29040,29100
5378,406502,407702,60,27360,2,"""2""",29100,29160
5378,407702,408403,60,27360,2,"""2""",29160,29220
5378,408403,403502,60,27360,2,"""2""",29220,29280
5378,403502,403701,60,27360,2,"""2""",29280,29340
5378,403701,404600,60,27360,2,"""2""",29340,29400
5378,404600,402602,60,27360,2,"""2""",29400,29460
5378,402602,403602,120,27360,2,"""2""",29460,29580
5378,403602,404700,120,27360,2,"""2""",29580,29700
5378,404700,404701,0,27360,2,"""2""",29700,29700
5378,407500,407503,60,28560,2,"""2""",28560,28620
5378,407503,408900,60,28560,2,"""2""",28620,28680
5378,408900,400802,60,28560,2,"""2""",28680,28740
5378,400802,400704,120,28560,2,"""2""",28740,28860
5378,400704,408503,60,28560,2,"""2""",28860,28920
5378,408503,405602,60,28560,2,"""2""",28920,28980
5378,405602,407102,60,28560,2,"""2""",28980,29040
5378,407102,404202,60,28560,2,"""2""",29040,29100
5378,404202,117000,60,28560,2,"""2""",29100,29160
5378,117000,112106,120,28560,2,"""2""",29160,29280
5378,112106,103003,120,28560,2,"""2""",29280,29400
5378,103003,118002,180,28560,2,"""2""",29400,29580
5378,118002,106002,60,28560,2,"""2""",29580,29640
5378,106002,118102,60,28560,2,"""2""",29640,29700
5378,118102,101002,120,28560,2,"""2""",29700,29820
5378,101002,102002,60,28560,2,"""2""",29820,29880
5378,102002,101101,120,28560,2,"""2""",29880,30000
5378,101101,403802,120,28560,2,"""2""",30000,30120
5378,403802,408300,120,28560,2,"""2""",30120,30240
5378,408300,406502,60,28560,2,"""2""",30240,30300
5378,406502,407702,60,28560,2,"""2""",30300,30360
5378,407702,408403,60,28560,2,"""2""",30360,30420
5378,408403,403502,60,28560,2,"""2""",30420,30480
5378,403502,403701,60,28560,2,"""2""",30480,30540
5378,403701,404600,60,28560,2,"""2""",30540,30600
5378,404600,402602,60,28560,2,"""2""",30600,30660
5378,402602,403602,120,28560,2,"""2""",30660,30780
5378,403602,404700,120,28560,2,"""2""",30780,30900
5378,404700,404701,0,28560,2,"""2""",30900,30900
5378,407500,407503,60,29760,2,"""2""",29760,29820
5378,407503,408900,60,29760,2,"""2""",29820,29880
5378,408900,400802,60,29760,2,"""2""",29880,29940
5378,400802,400704,120,29760,2,"""2""",29940,30060
5378,400704,408503,60,29760,2,"""2""",30060,30120
5378,408503,405602,60,29760,2,"""2""",30120,30180
5378,405602,407102,60,29760,2,"""2""",30180,30240
5378,407102,404202,60,29760,2,"""2""",30240,30300
5378,404202,117000,60,29760,2,"""2""",30300,30360
5378,117000,112106,120,29760,2,"""2""",30360,30480
5378,112106,103003,120,29760,2,"""2""",30480,30600
5378,103003,118002,180,29760,2,"""2""",30600,30780
5378,118002,106002,60,29760,2,"""2""",30780,30840
5378,106002,118102,60,29760,2,"""2""",30840,30900
5378,118102,101002,120,29760,2,"""2""",30900,31020
5378,101002,102002,60,29760,2,"""2""",31020,31080
5378,102002,101101,120,29760,2,"""2""",31080,31200
5378,101101,403802,120,29760,2,"""2""",31200,31320
5378,403802,408300,120,29760,2,"""2""",31320,31440
5378,408300,406502,60,29760,2,"""2""",31440,31500
5378,406502,407702,60,29760,2,"""2""",31500,31560
5378,407702,408403,60,29760,2,"""2""",31560,31620
5378,408403,403502,60,29760,2,"""2""",31620,31680
5378,403502,403701,60,29760,2,"""2""",31680,31740
5378,403701,404600,60,29760,2,"""2""",31740,31800
5378,404600,402602,60,29760,2,"""2""",31800,31860
5378,402602,403602,120,29760,2,"""2""",31860,31980
5378,403602,404700,120,29760,2,"""2""",31980,32100
5378,404700,404701,0,29760,2,"""2""",32100,32100
5378,407500,407503,60,30960,2,"""2""",30960,31020
5378,407503,408900,60,30960,2,"""2""",31020,31080
5378,408900,400802,60,30960,2,"""2""",31080,31140
5378,400802,400704,120,30960,2,"""2""",31140,31260
5378,400704,408503,60,30960,2,"""2""",31260,31320
5378,408503,405602,60,30960,2,"""2""",31320,31380
5378,405602,407102,60,30960,2,"""2""",31380,31440
5378,407102,404202,60,30960,2,"""2""",31440,31500
5378,404202,117000,60,30960,2,"""2""",31500,31560
5378,117000,112106,120,30960,2,"""2""",31560,31680
5378,112106,103003,120,30960,2,"""2""",31680,31800
5378,103003,118002,180,30960,2,"""2""",31800,31980
5378,118002,106002,60,30960,2,"""2""",31980,32040
5378,106002,118102,60,30960,2,"""2""",32040,32100
5378,118102,101002,120,30960,2,"""2""",32100,32220
5378,101002,102002,60,30960,2,"""2""",32220,32280
5378,102002,101101,120,30960,2,"""2""",32280,32400
5378,101101,403802,120,30960,2,"""2""",32400,32520
5378,403802,408300,120,30960,2,"""2""",32520,32640
5378,408300,406502,60,30960,2,"""2""",32640,32700
5378,406502,407702,60,30960,2,"""2""",32700,32760
5378,407702,408403,60,30960,2,"""2""",32760,32820
5378,408403,403502,60,30960,2,"""2""",32820,32880
5378,403502,403701,60,30960,2,"""2""",32880,32940
5378,403701,404600,60,30960,2,"""2""",32940,33000
5378,404600,402602,60,30960,2,"""2""",33000,33060
5378,402602,403602,120,30960,2,"""2""",33060,33180
5378,403602,404700,120,30960,2,"""2""",33180,33300
5378,404700,404701,0,30960,2,"""2""",33300,33300
5378,407500,407503,60,32160,2,"""2""",32160,32220
5378,407503,408900,60,32160,2,"""2""",32220,32280
5378,408900,400802,60,32160,2,"""2""",32280,32340
5378,400802,400704,120,32160,2,"""2""",32340,32460
5378,400704,408503,60,32160,2,"""2""",32460,32520
5378,408503,405602,60,32160,2,"""2""",32520,32580
5378,405602,407102,60,32160,2,"""2""",32580,32640
5378,407102,404202,60,32160,2,"""2""",32640,32700
5378,404202,117000,60,32160,2,"""2""",32700,32760
5378,117000,112106,120,32160,2,"""2""",32760,32880
5378,112106,103003,120,32160,2,"""2""",32880,33000
5378,103003,118002,180,32160,2,"""2""",33000,33180
5378,118002,106002,60,32160,2,"""2""",33180,33240
5378,106002,118102,60,32160,2,"""2""",33240,33300
5378,118102,101002,120,32160,2,"""2""",33300,33420
5378,101002,102002,60,32160,2,"""2""",33420,33480
5378,102002,101101,120,32160,2,"""2""",33480,33600
5378,101101,403802,120,32160,2,"""2""",33600,33720
5378,403802,408300,120,32160,2,"""2""",33720,33840
5378,408300,406502,60,32160,2,"""2""",33840,33900
5378,406502,407702,60,32160,2,"""2""",33900,33960
5378,407702,408403,60,32160,2,"""2""",33960,34020
5378,408403,403502,60,32160,2,"""2""",34020,34080
5378,403502,403701,60,32160,2,"""2""",34080,34140
5378,403701,404600,60,32160,2,"""2""",34140,34200
5378,404600,402602,60,32160,2,"""2""",34200,34260
5378,402602,403602,120,32160,2,"""2""",34260,34380
5378,403602,404700,120,32160,2,"""2""",34380,34500
5378,404700,404701,0,32160,2,"""2""",34500,34500
5378,407500,407503,60,33360,2,"""2""",33360,33420
5378,407503,408900,60,33360,2,"""2""",33420,33480
5378,408900,400802,60,33360,2,"""2""",33480,33540
5378,400802,400704,120,33360,2,"""2""",33540,33660
5378,400704,408503,60,33360,2,"""2""",33660,33720
5378,408503,405602,60,33360,2,"""2""",33720,33780
5378,405602,407102,60,33360,2,"""2""",33780,33840
5378,407102,404202,60,33360,2,"""2""",33840,33900
5378,404202,117000,60,33360,2,"""2""",33900,33960
5378,117000,112106,120,33360,2,"""2""",33960,34080
5378,112106,103003,120,33360,2,"""2""",34080,34200
5378,103003,118002,180,33360,2,"""2""",34200,34380
5378,118002,106002,60,33360,2,"""2""",34380,34440
5378,106002,118102,60,33360,2,"""2""",34440,34500
5378,118102,101002,120,33360,2,"""2""",34500,34620
5378,101002,102002,60,33360,2,"""2""",34620,34680
5378,102002,101101,120,33360,2,"""2""",34680,34800
5378,101101,403802,120,33360,2,"""2""",34800,34920
5378,403802,408300,120,33360,2,"""2""",34920,35040
5378,408300,406502,60,33360,2,"""2""",35040,35100
5378,406502,407702,60,33360,2,"""2""",35100,35160
5378,407702,408403,60,33360,2,"""2""",35160,35220
5378,408403,403502,60,33360,2,"""2""",35220,35280
5378,403502,403701,60,33360,2,"""2""",35280,35340
5378,403701,404600,60,33360,2,"""2""",35340,35400
5378,404600,402602,60,33360,2,"""2""",35400,35460
5378,402602,403602,120,33360,2,"""2""",35460,35580
5378,403602,404700,120,33360,2,"""2""",35580,35700
5378,404700,404701,0,33360,2,"""2""",35700,35700
5378,407500,407503,60,34560,2,"""2""",34560,34620
5378,407503,408900,60,34560,2,"""2""",34620,34680
5378,408900,400802,60,34560,2,"""2""",34680,34740
5378,400802,400704,120,34560,2,"""2""",34740,34860
5378,400704,408503,60,34560,2,"""2""",34860,34920
5378,408503,405602,60,34560,2,"""2""",34920,34980
5378,405602,407102,60,34560,2,"""2""",34980,35040
5378,407102,404202,60,34560,2,"""2""",35040,35100
5378,404202,117000,60,34560,2,"""2""",35100,35160
5378,117000,112106,120,34560,2,"""2""",35160,35280
5378,112106,103003,120,34560,2,"""2""",35280,35400
5378,103003,118002,180,34560,2,"""2""",35400,35580
5378,118002,106002,60,34560,2,"""2""",35580,35640
5378,106002,118102,60,34560,2,"""2""",35640,35700
5378,118102,101002,120,34560,2,"""2""",35700,35820
5378,101002,102002,60,34560,2,"""2""",35820,35880
5378,102002,101101,120,34560,2,"""2""",35880,36000
5378,101101,403802,120,34560,2,"""2""",36000,36120
5378,403802,408300,120,34560,2,"""2""",36120,36240
5378,408300,406502,60,34560,2,"""2""",36240,36300
5378,406502,407702,60,34560,2,"""2""",36300,36360
5378,407702,408403,60,34560,2,"""2""",36360,36420
5378,408403,403502,60,34560,2,"""2""",36420,36480
5378,403502,403701,60,34560,2,"""2""",36480,36540
5378,403701,404600,60,34560,2,"""2""",36540,36600
5378,404600,402602,60,34560,2,"""2""",36600,36660
5378,402602,403602,120,34560,2,"""2""",36660,36780
5378,403602,404700,120,34560,2,"""2""",36780,36900
5378,404700,404701,0,34560,2,"""2""",36900,36900
5378,407500,407503,60,35760,2,"""2""",35760,35820
5378,407503,408900,60,35760,2,"""2""",35820,35880
5378,408900,400802,60,35760,2,"""2""",35880,35940
5378,400802,400704,120,35760,2,"""2""",35940,36060
5378,400704,408503,60,35760,2,"""2""",36060,36120
5378,408503,405602,60,35760,2,"""2""",36120,36180
5378,405602,407102,60,35760,2,"""2""",36180,36240
5378,407102,404202,60,35760,2,"""2""",36240,36300
5378,404202,117000,60,35760,2,"""2""",36300,36360
5378,117000,112106,120,35760,2,"""2""",36360,36480
5378,112106,103003,120,35760,2,"""2""",36480,36600
5378,103003,118002,180,35760,2,"""2""",36600,36780
5378,118002,106002,60,35760,2,"""2""",36780,36840
5378,106002,118102,60,35760,2,"""2""",36840,36900
5378,118102,101002,120,35760,2,"""2""",36900,37020
5378,101002,102002,60,35760,2,"""2""",37020,37080
5378,102002,101101,120,35760,2,"""2""",37080,37200
5378,101101,403802,120,35760,2,"""2""",37200,37320
5378,403802,408300,120,35760,2,"""2""",37320,37440
5378,408300,406502,60,35760,2,"""2""",37440,37500
5378,406502,407702,60,35760,2,"""2""",37500,37560
5378,407702,408403,60,35760,2,"""2""",37560,37620
5378,408403,403502,60,35760,2,"""2""",37620,37680
5378,403502,403701,60,35760,2,"""2""",37680,37740
5378,403701,404600,60,35760,2,"""2""",37740,37800
5378,404600,402602,60,35760,2,"""2""",37800,37860
5378,402602,403602,120,35760,2,"""2""",37860,37980
5378,403602,404700,120,35760,2,"""2""",37980,38100
5378,404700,404701,0,35760,2,"""2""",38100,38100
5378,407500,407503,60,36960,2,"""2""",36960,37020
5378,407503,408900,60,36960,2,"""2""",37020,37080
5378,408900,400802,60,36960,2,"""2""",37080,37140
5378,400802,400704,120,36960,2,"""2""",37140,37260
5378,400704,408503,60,36960,2,"""2""",37260,37320
5378,408503,405602,60,36960,2,"""2""",37320,37380
5378,405602,407102,60,36960,2,"""2""",37380,37440
5378,407102,404202,60,36960,2,"""2""",37440,37500
5378,404202,117000,60,36960,2,"""2""",37500,37560
5378,117000,112106,120,36960,2,"""2""",37560,37680
5378,112106,103003,120,36960,2,"""2""",37680,37800
5378,103003,118002,180,36960,2,"""2""",37800,37980
5378,118002,106002,60,36960,2,"""2""",37980,38040
5378,106002,118102,60,36960,2,"""2""",38040,38100
5378,118102,101002,120,36960,2,"""2""",38100,38220
5378,101002,102002,60,36960,2,"""2""",38220,38280
5378,102002,101101,120,36960,2,"""2""",38280,38400
5378,101101,403802,120,36960,2,"""2""",38400,38520
5378,403802,408300,120,36960,2,"""2""",38520,38640
5378,408300,406502,60,36960,2,"""2""",38640,38700
5378,406502,407702,60,36960,2,"""2""",38700,38760
5378,407702,408403,60,36960,2,"""2""",38760,38820
5378,408403,403502,60,36960,2,"""2""",38820,38880
5378,403502,403701,60,36960,2,"""2""",38880,38940
5378,403701,404600,60,36960,2,"""2""",38940,39000
5378,404600,402602,60,36960,2,"""2""",39000,39060
5378,402602,403602,120,36960,2,"""2""",39060,39180
5378,403602,404700,120,36960,2,"""2""",39180,39300
5378,404700,404701,0,36960,2,"""2""",39300,39300
5378,407500,407503,60,38160,2,"""2""",38160,38220
5378,407503,408900,60,38160,2,"""2""",38220,38280
5378,408900,400802,60,38160,2,"""2""",38280,38340
5378,400802,400704,120,38160,2,"""2""",38340,38460
5378,400704,408503,60,38160,2,"""2""",38460,38520
5378,408503,405602,60,38160,2,"""2""",38520,38580
5378,405602,407102,60,38160,2,"""2""",38580,38640
5378,407102,404202,60,38160,2,"""2""",38640,38700
5378,404202,117000,60,38160,2,"""2""",38700,38760
5378,117000,112106,120,38160,2,"""2""",38760,38880
5378,112106,103003,120,38160,2,"""2""",38880,39000
5378,103003,118002,180,38160,2,"""2""",39000,39180
5378,118002,106002,60,38160,2,"""2""",39180,39240
5378,106002,118102,60,38160,2,"""2""",39240,39300
5378,118102,101002,120,38160,2,"""2""",39300,39420
5378,101002,102002,60,38160,2,"""2""",39420,39480
5378,102002,101101,120,38160,2,"""2""",39480,39600
5378,101101,403802,120,38160,2,"""2""",39600,39720
5378,403802,408300,120,38160,2,"""2""",39720,39840
5378,408300,406502,60,38160,2,"""2""",39840,39900
5378,406502,407702,60,38160,2,"""2""",39900,39960
5378,407702,408403,60,38160,2,"""2""",39960,40020
5378,408403,403502,60,38160,2,"""2""",40020,40080
5378,403502,403701,60,38160,2,"""2""",40080,40140
5378,403701,404600,60,38160,2,"""2""",40140,40200
5378,404600,402602,60,38160,2,"""2""",40200,40260
5378,402602,403602,120,38160,2,"""2""",40260,40380
5378,403602,404700,120,38160,2,"""2""",40380,40500
5378,404700,404701,0,38160,2,"""2""",40500,40500
5378,407500,407503,60,39360,2,"""2""",39360,39420
5378,407503,408900,60,39360,2,"""2""",39420,39480
5378,408900,400802,60,39360,2,"""2""",39480,39540
5378,400802,400704,120,39360,2,"""2""",39540,39660
5378,400704,408503,60,39360,2,"""2""",39660,39720
5378,408503,405602,60,39360,2,"""2""",39720,39780
5378,405602,407102,60,39360,2,"""2""",39780,39840
5378,407102,404202,60,39360,2,"""2""",39840,39900
5378,404202,117000,60,39360,2,"""2""",39900,39960
5378,117000,112106,120,39360,2,"""2""",39960,40080
5378,112106,103003,120,39360,2,"""2""",40080,40200
5378,103003,118002,180,39360,2,"""2""",40200,40380
5378,118002,106002,60,39360,2,"""2""",40380,40440
5378,106002,118102,60,39360,2,"""2""",40440,40500
5378,118102,101002,120,39360,2,"""2""",40500,40620
5378,101002,102002,60,39360,2,"""2""",40620,40680
5378,102002,101101,120,39360,2,"""2""",40680,40800
5378,101101,403802,120,39360,2,"""2""",40800,40920
5378,403802,408300,120,39360,2,"""2""",40920,41040
5378,408300,406502,60,39360,2,"""2""",41040,41100
5378,406502,407702,60,39360,2,"""2""",41100,41160
5378,407702,408403,60,39360,2,"""2""",41160,41220
5378,408403,403502,60,39360,2,"""2""",41220,41280
5378,403502,403701,60,39360,2,"""2""",41280,41340
5378,403701,404600,60,39360,2,"""2""",41340,41400
5378,404600,402602,60,39360,2,"""2""",41400,41460
5378,402602,403602,120,39360,2,"""2""",41460,41580
5378,403602,404700,120,39360,2,"""2""",41580,41700
5378,404700,404701,0,39360,2,"""2""",41700,41700
5378,407500,407503,60,40560,2,"""2""",40560,40620
5378,407503,408900,60,40560,2,"""2""",40620,40680
5378,408900,400802,60,40560,2,"""2""",40680,40740
5378,400802,400704,120,40560,2,"""2""",40740,40860
5378,400704,408503,60,40560,2,"""2""",40860,40920
5378,408503,405602,60,40560,2,"""2""",40920,40980
5378,405602,407102,60,40560,2,"""2""",40980,41040
5378,407102,404202,60,40560,2,"""2""",41040,41100
5378,404202,117000,60,40560,2,"""2""",41100,41160
5378,117000,112106,120,40560,2,"""2""",41160,41280
5378,112106,103003,120,40560,2,"""2""",41280,41400
5378,103003,118002,180,40560,2,"""2""",41400,41580
5378,118002,106002,60,40560,2,"""2""",41580,41640
5378,106002,118102,60,40560,2,"""2""",41640,41700
5378,118102,101002,120,40560,2,"""2""",41700,41820
5378,101002,102002,60,40560,2,"""2""",41820,41880
5378,102002,101101,120,40560,2,"""2""",41880,42000
5378,101101,403802,120,40560,2,"""2""",42000,42120
5378,403802,408300,120,40560,2,"""2""",42120,42240
5378,408300,406502,60,40560,2,"""2""",42240,42300
5378,406502,407702,60,40560,2,"""2""",42300,42360
5378,407702,408403,60,40560,2,"""2""",42360,42420
5378,408403,403502,60,40560,2,"""2""",42420,42480
5378,403502,403701,60,40560,2,"""2""",42480,42540
5378,403701,404600,60,40560,2,"""2""",42540,42600
5378,404600,402602,60,40560,2,"""2""",42600,42660
5378,402602,403602,120,40560,2,"""2""",42660,42780
5378,403602,404700,120,40560,2,"""2""",42780,42900
5378,404700,404701,0,40560,2,"""2""",42900,42900
5378,407500,407503,60,41760,2,"""2""",41760,41820
5378,407503,408900,60,41760,2,"""2""",41820,41880
5378,408900,400802,60,41760,2,"""2""",41880,41940
5378,400802,400704,120,41760,2,"""2""",41940,42060
5378,400704,408503,60,41760,2,"""2""",42060,42120
5378,408503,405602,60,41760,2,"""2""",42120,42180
5378,405602,407102,60,41760,2,"""2""",42180,42240
5378,407102,404202,60,41760,2,"""2""",42240,42300
5378,404202,117000,60,41760,2,"""2""",42300,42360
5378,117000,112106,120,41760,2,"""2""",42360,42480
5378,112106,103003,120,41760,2,"""2""",42480,42600
5378,103003,118002,180,41760,2,"""2""",42600,42780
5378,118002,106002,60,41760,2,"""2""",42780,42840
5378,106002,118102,60,41760,2,"""2""",42840,42900
5378,118102,101002,120,41760,2,"""2""",42900,43020
5378,101002,102002,60,41760,2,"""2""",43020,43080
5378,102002,101101,120,41760,2,"""2""",43080,43200
5378,101101,403802,120,41760,2,"""2""",43200,43320
5378,403802,408300,120,41760,2,"""2""",43320,43440
5378,408300,406502,60,41760,2,"""2""",43440,43500
5378,406502,407702,60,41760,2,"""2""",43500,43560
5378,407702,408403,60,41760,2,"""2""",43560,43620
5378,408403,403502,60,41760,2,"""2""",43620,43680
5378,403502,403701,60,41760,2,"""2""",43680,43740
5378,403701,404600,60,41760,2,"""2""",43740,43800
5378,404600,402602,60,41760,2,"""2""",43800,43860
5378,402602,403602,120,41760,2,"""2""",43860,43980
5378,403602,404700,120,41760,2,"""2""",43980,44100
5378,404700,404701,0,41760,2,"""2""",44100,44100
5378,407500,407503,60,42960,2,"""2""",42960,43020
5378,407503,408900,60,42960,2,"""2""",43020,43080
5378,408900,400802,60,42960,2,"""2""",43080,43140
5378,400802,400704,120,42960,2,"""2""",43140,43260
5378,400704,408503,60,42960,2,"""2""",43260,43320
5378,408503,405602,60,42960,2,"""2""",43320,43380
5378,405602,407102,60,42960,2,"""2""",43380,43440
5378,407102,404202,60,42960,2,"""2""",43440,43500
5378,404202,117000,60,42960,2,"""2""",43500,43560
5378,117000,112106,120,42960,2,"""2""",43560,43680
5378,112106,103003,120,42960,2,"""2""",43680,43800
5378,103003,118002,180,42960,2,"""2""",43800,43980
5378,118002,106002,60,42960,2,"""2""",43980,44040
5378,106002,118102,60,42960,2,"""2""",44040,44100
5378,118102,101002,120,42960,2,"""2""",44100,44220
5378,101002,102002,60,42960,2,"""2""",44220,44280
5378,102002,101101,120,42960,2,"""2""",44280,44400
5378,101101,403802,120,42960,2,"""2""",44400,44520
5378,403802,408300,120,42960,2,"""2""",44520,44640
5378,408300,406502,60,42960,2,"""2""",44640,44700
5378,406502,407702,60,42960,2,"""2""",44700,44760
5378,407702,408403,60,42960,2,"""2""",44760,44820
5378,408403,403502,60,42960,2,"""2""",44820,44880
5378,403502,403701,60,42960,2,"""2""",44880,44940
5378,403701,404600,60,42960,2,"""2""",44940,45000
5378,404600,402602,60,42960,2,"""2""",45000,45060
5378,402602,403602,120,42960,2,"""2""",45060,45180
5378,403602,404700,120,42960,2,"""2""",45180,45300
5378,404700,404701,0,42960,2,"""2""",45300,45300
5378,407500,407503,60,44160,2,"""2""",44160,44220
5378,407503,408900,60,44160,2,"""2""",44220,44280
5378,408900,400802,60,44160,2,"""2""",44280,44340
5378,400802,400704,120,44160,2,"""2""",44340,44460
5378,400704,408503,60,44160,2,"""2""",44460,44520
5378,408503,405602,60,44160,2,"""2""",44520,44580
5378,405602,407102,60,44160,2,"""2""",44580,44640
5378,407102,404202,60,44160,2,"""2""",44640,44700
5378,404202,117000,60,44160,2,"""2""",44700,44760
5378,117000,112106,120,44160,2,"""2""",44760,44880
5378,112106,103003,120,44160,2,"""2""",44880,45000
5378,103003,118002,180,44160,2,"""2""",45000,45180
5378,118002,106002,60,44160,2,"""2""",45180,45240
5378,106002,118102,60,44160,2,"""2""",45240,45300
5378,118102,101002,120,44160,2,"""2""",45300,45420
5378,101002,102002,60,44160,2,"""2""",45420,45480
5378,102002,101101,120,44160,2,"""2""",45480,45600
5378,101101,403802,120,44160,2,"""2""",45600,45720
5378,403802,408300,120,44160,2,"""2""",45720,45840
5378,408300,406502,60,44160,2,"""2""",45840,45900
5378,406502,407702,60,44160,2,"""2""",45900,45960
5378,407702,408403,60,44160,2,"""2""",45960,46020
5378,408403,403502,60,44160,2,"""2""",46020,46080
5378,403502,403701,60,44160,2,"""2""",46080,46140
5378,403701,404600,60,44160,2,"""2""",46140,46200
5378,404600,402602,60,44160,2,"""2""",46200,46260
5378,402602,403602,120,44160,2,"""2""",46260,46380
5378,403602,404700,120,44160,2,"""2""",46380,46500
5378,404700,404701,0,44160,2,"""2""",46500,46500
5378,407500,407503,60,45360,2,"""2""",45360,45420
5378,407503,408900,60,45360,2,"""2""",45420,45480
5378,408900,400802,60,45360,2,"""2""",45480,45540
5378,400802,400704,120,45360,2,"""2""",45540,45660
5378,400704,408503,60,45360,2,"""2""",45660,45720
5378,408503,405602,60,45360,2,"""2""",45720,45780
5378,405602,407102,60,45360,2,"""2""",45780,45840
5378,407102,404202,60,45360,2,"""2""",45840,45900
5378,404202,117000,60,45360,2,"""2""",45900,45960
5378,117000,112106,120,45360,2,"""2""",45960,46080
5378,112106,103003,120,45360,2,"""2""",46080,46200
5378,103003,118002,180,45360,2,"""2""",46200,46380
5378,118002,106002,60,45360,2,"""2""",46380,46440
5378,106002,118102,60,45360,2,"""2""",46440,46500
5378,118102,101002,120,45360,2,"""2""",46500,46620
5378,101002,102002,60,45360,2,"""2""",46620,46680
5378,102002,101101,120,45360,2,"""2""",46680,46800
5378,101101,403802,120,45360,2,"""2""",46800,46920
5378,403802,408300,120,45360,2,"""2""",46920,47040
5378,408300,406502,60,45360,2,"""2""",47040,47100
5378,406502,407702,60,45360,2,"""2""",47100,47160
5378,407702,408403,60,45360,2,"""2""",47160,47220
5378,408403,403502,60,45360,2,"""2""",47220,47280
5378,403502,403701,60,45360,2,"""2""",47280,47340
5378,403701,404600,60,45360,2,"""2""",47340,47400
5378,404600,402602,60,45360,2,"""2""",47400,47460
5378,402602,403602,120,45360,2,"""2""",47460,47580
5378,403602,404700,120,45360,2,"""2""",47580,47700
5378,404700,404701,0,45360,2,"""2""",47700,47700
5378,407500,407503,60,46560,2,"""2""",46560,46620
5378,407503,408900,60,46560,2,"""2""",46620,46680
5378,408900,400802,60,46560,2,"""2""",46680,46740
5378,400802,400704,120,46560,2,"""2""",46740,46860
5378,400704,408503,60,46560,2,"""2""",46860,46920
5378,408503,405602,60,46560,2,"""2""",46920,46980
5378,405602,407102,60,46560,2,"""2""",46980,47040
5378,407102,404202,60,46560,2,"""2""",47040,47100
5378,404202,117000,60,46560,2,"""2""",47100,47160
5378,117000,112106,120,46560,2,"""2""",47160,47280
5378,112106,103003,120,46560,2,"""2""",47280,47400
5378,103003,118002,180,46560,2,"""2""",47400,47580
5378,118002,106002,60,46560,2,"""2""",47580,47640
5378,106002,118102,60,46560,2,"""2""",47640,47700
5378,118102,101002,120,46560,2,"""2""",47700,47820
5378,101002,102002,60,46560,2,"""2""",47820,47880
5378,102002,101101,120,46560,2,"""2""",47880,48000
5378,101101,403802,120,46560,2,"""2""",48000,48120
5378,403802,408300,120,46560,2,"""2""",48120,48240
5378,408300,406502,60,46560,2,"""2""",48240,48300
5378,406502,407702,60,46560,2,"""2""",48300,48360
5378,407702,408403,60,46560,2,"""2""",48360,48420
5378,408403,403502,60,46560,2,"""2""",48420,48480
5378,403502,403701,60,46560,2,"""2""",48480,48540
5378,403701,404600,60,46560,2,"""2""",48540,48600
5378,404600,402602,60,46560,2,"""2""",48600,48660
5378,402602,403602,120,46560,2,"""2""",48660,48780
5378,403602,404700,120,46560,2,"""2""",48780,48900
5378,404700,404701,0,46560,2,"""2""",48900,48900
5378,407500,407503,60,47760,2,"""2""",47760,47820
5378,407503,408900,60,47760,2,"""2""",47820,47880
5378,408900,400802,60,47760,2,"""2""",47880,47940
5378,400802,400704,120,47760,2,"""2""",47940,48060
5378,400704,408503,60,47760,2,"""2""",48060,48120
5378,408503,405602,60,47760,2,"""2""",48120,48180
5378,405602,407102,60,47760,2,"""2""",48180,48240
5378,407102,404202,60,47760,2,"""2""",48240,48300
5378,404202,117000,60,47760,2,"""2""",48300,48360
5378,117000,112106,120,47760,2,"""2""",48360,48480
5378,112106,103003,120,47760,2,"""2""",48480,48600
5378,103003,118002,180,47760,2,"""2""",48600,48780
5378,118002,106002,60,47760,2,"""2""",48780,48840
5378,106002,118102,60,47760,2,"""2""",48840,48900
5378,118102,101002,120,47760,2,"""2""",48900,49020
5378,101002,102002,60,47760,2,"""2""",49020,49080
5378,102002,101101,120,47760,2,"""2""",49080,49200
5378,101101,403802,120,47760,2,"""2""",49200,49320
5378,403802,408300,120,47760,2,"""2""",49320,49440
5378,408300,406502,60,47760,2,"""2""",49440,49500
5378,406502,407702,60,47760,2,"""2""",49500,49560
5378,407702,408403,60,47760,2,"""2""",49560,49620
5378,408403,403502,60,47760,2,"""2""",49620,49680
5378,403502,403701,60,47760,2,"""2""",49680,49740
5378,403701,404600,60,47760,2,"""2""",49740,49800
5378,404600,402602,60,47760,2,"""2""",49800,49860
5378,402602,403602,120,47760,2,"""2""",49860,49980
5378,403602,404700,120,47760,2,"""2""",49980,50100
5378,404700,404701,0,47760,2,"""2""",50100,50100
5378,407500,407503,60,48960,2,"""2""",48960,49020
5378,407503,408900,60,48960,2,"""2""",49020,49080
5378,408900,400802,60,48960,2,"""2""",49080,49140
5378,400802,400704,120,48960,2,"""2""",49140,49260
5378,400704,408503,60,48960,2,"""2""",49260,49320
5378,408503,405602,60,48960,2,"""2""",49320,49380
5378,405602,407102,60,48960,2,"""2""",49380,49440
5378,407102,404202,60,48960,2,"""2""",49440,49500
5378,404202,117000,60,48960,2,"""2""",49500,49560
5378,117000,112106,120,48960,2,"""2""",49560,49680
5378,112106,103003,120,48960,2,"""2""",49680,49800
5378,103003,118002,180,48960,2,"""2""",49800,49980
5378,118002,106002,60,48960,2,"""2""",49980,50040
5378,106002,118102,60,48960,2,"""2""",50040,50100
5378,118102,101002,120,48960,2,"""2""",50100,50220
5378,101002,102002,60,48960,2,"""2""",50220,50280
5378,102002,101101,120,48960,2,"""2""",50280,50400
5378,101101,403802,120,48960,2,"""2""",50400,50520
5378,403802,408300,120,48960,2,"""2""",50520,50640
5378,408300,406502,60,48960,2,"""2""",50640,50700
5378,406502,407702,60,48960,2,"""2""",50700,50760
5378,407702,408403,60,48960,2,"""2""",50760,50820
5378,408403,403502,60,48960,2,"""2""",50820,50880
5378,403502,403701,60,48960,2,"""2""",50880,50940
5378,403701,404600,60,48960,2,"""2""",50940,51000
5378,404600,402602,60,48960,2,"""2""",51000,51060
5378,402602,403602,120,48960,2,"""2""",51060,51180
5378,403602,404700,120,48960,2,"""2""",51180,51300
5378,404700,404701,0,48960,2,"""2""",51300,51300
5378,407500,407503,60,50160,2,"""2""",50160,50220
5378,407503,408900,60,50160,2,"""2""",50220,50280
5378,408900,400802,60,50160,2,"""2""",50280,50340
5378,400802,400704,120,50160,2,"""2""",50340,50460
5378,400704,408503,60,50160,2,"""2""",50460,50520
5378,408503,405602,60,50160,2,"""2""",50520,50580
5378,405602,407102,60,50160,2,"""2""",50580,50640
5378,407102,404202,60,50160,2,"""2""",50640,50700
5378,404202,117000,60,50160,2,"""2""",50700,50760
5378,117000,112106,120,50160,2,"""2""",50760,50880
5378,112106,103003,120,50160,2,"""2""",50880,51000
5378,103003,118002,180,50160,2,"""2""",51000,51180
5378,118002,106002,60,50160,2,"""2""",51180,51240
5378,106002,118102,60,50160,2,"""2""",51240,51300
5378,118102,101002,120,50160,2,"""2""",51300,51420
5378,101002,102002,60,50160,2,"""2""",51420,51480
5378,102002,101101,120,50160,2,"""2""",51480,51600
5378,101101,403802,120,50160,2,"""2""",51600,51720
5378,403802,408300,120,50160,2,"""2""",51720,51840
5378,408300,406502,60,50160,2,"""2""",51840,51900
5378,406502,407702,60,50160,2,"""2""",51900,51960
5378,407702,408403,60,50160,2,"""2""",51960,52020
5378,408403,403502,60,50160,2,"""2""",52020,52080
5378,403502,403701,60,50160,2,"""2""",52080,52140
5378,403701,404600,60,50160,2,"""2""",52140,52200
5378,404600,402602,60,50160,2,"""2""",52200,52260
5378,402602,403602,120,50160,2,"""2""",52260,52380
5378,403602,404700,120,50160,2,"""2""",52380,52500
5378,404700,404701,0,50160,2,"""2""",52500,52500
5378,407500,407503,60,51360,2,"""2""",51360,51420
5378,407503,408900,60,51360,2,"""2""",51420,51480
5378,408900,400802,60,51360,2,"""2""",51480,51540
5378,400802,400704,120,51360,2,"""2""",51540,51660
5378,400704,408503,60,51360,2,"""2""",51660,51720
5378,408503,405602,60,51360,2,"""2""",51720,51780
5378,405602,407102,60,51360,2,"""2""",51780,51840
5378,407102,404202,60,51360,2,"""2""",51840,51900
5378,404202,117000,60,51360,2,"""2""",51900,51960
5378,117000,112106,120,51360,2,"""2""",51960,52080
5378,112106,103003,120,51360,2,"""2""",52080,52200
5378,103003,118002,180,51360,2,"""2""",52200,52380
5378,118002,106002,60,51360,2,"""2""",52380,52440
5378,106002,118102,60,51360,2,"""2""",52440,52500
5378,118102,101002,120,51360,2,"""2""",52500,52620
5378,101002,102002,60,51360,2,"""2""",52620,52680
5378,102002,101101,120,51360,2,"""2""",52680,52800
5378,101101,403802,120,51360,2,"""2""",52800,52920
5378,403802,408300,120,51360,2,"""2""",52920,53040
5378,408300,406502,60,51360,2,"""2""",53040,53100
5378,406502,407702,60,51360,2,"""2""",53100,53160
5378,407702,408403,60,51360,2,"""2""",53160,53220
5378,408403,403502,60,51360,2,"""2""",53220,53280
5378,403502,403701,60,51360,2,"""2""",53280,53340
5378,403701,404600,60,51360,2,"""2""",53340,53400
5378,404600,402602,60,51360,2,"""2""",53400,53460
5378,402602,403602,120,51360,2,"""2""",53460,53580
5378,403602,404700,120,51360,2,"""2""",53580,53700
5378,404700,404701,0,51360,2,"""2""",53700,53700
5378,407500,407503,60,52560,2,"""2""",52560,52620
5378,407503,408900,60,52560,2,"""2""",52620,52680
5378,408900,400802,60,52560,2,"""2""",52680,52740
5378,400802,400704,120,52560,2,"""2""",52740,52860
5378,400704,408503,60,52560,2,"""2""",52860,52920
5378,408503,405602,60,52560,2,"""2""",52920,52980
5378,405602,407102,60,52560,2,"""2""",52980,53040
5378,407102,404202,60,52560,2,"""2""",53040,53100
5378,404202,117000,60,52560,2,"""2""",53100,53160
5378,117000,112106,120,52560,2,"""2""",53160,53280
5378,112106,103003,120,52560,2,"""2""",53280,53400
5378,103003,118002,180,52560,2,"""2""",53400,53580
5378,118002,106002,60,52560,2,"""2""",53580,53640
5378,106002,118102,60,52560,2,"""2""",53640,53700
5378,118102,101002,120,52560,2,"""2""",53700,53820
5378,101002,102002,60,52560,2,"""2""",53820,53880
5378,102002,101101,120,52560,2,"""2""",53880,54000
5378,101101,403802,120,52560,2,"""2""",54000,54120
5378,403802,408300,120,52560,2,"""2""",54120,54240
5378,408300,406502,60,52560,2,"""2""",54240,54300
5378,406502,407702,60,52560,2,"""2""",54300,54360
5378,407702,408403,60,52560,2,"""2""",54360,54420
5378,408403,403502,60,52560,2,"""2""",54420,54480
5378,403502,403701,60,52560,2,"""2""",54480,54540
5378,403701,404600,60,52560,2,"""2""",54540,54600
5378,404600,402602,60,52560,2,"""2""",54600,54660
5378,402602,403602,120,52560,2,"""2""",54660,54780
5378,403602,404700,120,52560,2,"""2""",54780,54900
5378,404700,404701,0,52560,2,"""2""",54900,54900
5378,407500,407503,60,53760,2,"""2""",53760,53820
5378,407503,408900,60,53760,2,"""2""",53820,53880
5378,408900,400802,60,53760,2,"""2""",53880,53940
5378,400802,400704,120,53760,2,"""2""",53940,54060
5378,400704,408503,60,53760,2,"""2""",54060,54120
5378,408503,405602,60,53760,2,"""2""",54120,54180
5378,405602,407102,60,53760,2,"""2""",54180,54240
5378,407102,404202,60,53760,2,"""2""",54240,54300
5378,404202,117000,60,53760,2,"""2""",54300,54360
5378,117000,112106,120,53760,2,"""2""",54360,54480
5378,112106,103003,120,53760,2,"""2""",54480,54600
5378,103003,118002,180,53760,2,"""2""",54600,54780
5378,118002,106002,60,53760,2,"""2""",54780,54840
5378,106002,118102,60,53760,2,"""2""",54840,54900
5378,118102,101002,120,53760,2,"""2""",54900,55020
5378,101002,102002,60,53760,2,"""2""",55020,55080
5378,102002,101101,120,53760,2,"""2""",55080,55200
5378,101101,403802,120,53760,2,"""2""",55200,55320
5378,403802,408300,120,53760,2,"""2""",55320,55440
5378,408300,406502,60,53760,2,"""2""",55440,55500
5378,406502,407702,60,53760,2,"""2""",55500,55560
5378,407702,408403,60,53760,2,"""2""",55560,55620
5378,408403,403502,60,53760,2,"""2""",55620,55680
5378,403502,403701,60,53760,2,"""2""",55680,55740
5378,403701,404600,60,53760,2,"""2""",55740,55800
5378,404600,402602,60,53760,2,"""2""",55800,55860
5378,402602,403602,120,53760,2,"""2""",55860,55980
5378,403602,404700,120,53760,2,"""2""",55980,56100
5378,404700,404701,0,53760,2,"""2""",56100,56100
5378,407500,407503,60,54960,2,"""2""",54960,55020
5378,407503,408900,60,54960,2,"""2""",55020,55080
5378,408900,400802,60,54960,2,"""2""",55080,55140
5378,400802,400704,120,54960,2,"""2""",55140,55260
5378,400704,408503,60,54960,2,"""2""",55260,55320
5378,408503,405602,60,54960,2,"""2""",55320,55380
5378,405602,407102,60,54960,2,"""2""",55380,55440
5378,407102,404202,60,54960,2,"""2""",55440,55500
5378,404202,117000,60,54960,2,"""2""",55500,55560
5378,117000,112106,120,54960,2,"""2""",55560,55680
5378,112106,103003,120,54960,2,"""2""",55680,55800
5378,103003,118002,180,54960,2,"""2""",55800,55980
5378,118002,106002,60,54960,2,"""2""",55980,56040
5378,106002,118102,60,54960,2,"""2""",56040,56100
5378,118102,101002,120,54960,2,"""2""",56100,56220
5378,101002,102002,60,54960,2,"""2""",56220,56280
5378,102002,101101,120,54960,2,"""2""",56280,56400
5378,101101,403802,120,54960,2,"""2""",56400,56520
5378,403802,408300,120,54960,2,"""2""",56520,56640
5378,408300,406502,60,54960,2,"""2""",56640,56700
5378,406502,407702,60,54960,2,"""2""",56700,56760
5378,407702,408403,60,54960,2,"""2""",56760,56820
5378,408403,403502,60,54960,2,"""2""",56820,56880
5378,403502,403701,60,54960,2,"""2""",56880,56940
5378,403701,404600,60,54960,2,"""2""",56940,57000
5378,404600,402602,60,54960,2,"""2""",57000,57060
5378,402602,403602,120,54960,2,"""2""",57060,57180
5378,403602,404700,120,54960,2,"""2""",57180,57300
5378,404700,404701,0,54960,2,"""2""",57300,57300
5378,407500,407503,60,56160,2,"""2""",56160,56220
5378,407503,408900,60,56160,2,"""2""",56220,56280
5378,408900,400802,60,56160,2,"""2""",56280,56340
5378,400802,400704,120,56160,2,"""2""",56340,56460
5378,400704,408503,60,56160,2,"""2""",56460,56520
5378,408503,405602,60,56160,2,"""2""",56520,56580
5378,405602,407102,60,56160,2,"""2""",56580,56640
5378,407102,404202,60,56160,2,"""2""",56640,56700
5378,404202,117000,60,56160,2,"""2""",56700,56760
5378,117000,112106,120,56160,2,"""2""",56760,56880
5378,112106,103003,120,56160,2,"""2""",56880,57000
5378,103003,118002,180,56160,2,"""2""",57000,57180
5378,118002,106002,60,56160,2,"""2""",57180,57240
5378,106002,118102,60,56160,2,"""2""",57240,57300
5378,118102,101002,120,56160,2,"""2""",57300,57420
5378,101002,102002,60,56160,2,"""2""",57420,57480
5378,102002,101101,120,56160,2,"""2""",57480,57600
5378,101101,403802,120,56160,2,"""2""",57600,57720
5378,403802,408300,120,56160,2,"""2""",57720,57840
5378,408300,406502,60,56160,2,"""2""",57840,57900
5378,406502,407702,60,56160,2,"""2""",57900,57960
5378,407702,408403,60,56160,2,"""2""",57960,58020
5378,408403,403502,60,56160,2,"""2""",58020,58080
5378,403502,403701,60,56160,2,"""2""",58080,58140
5378,403701,404600,60,56160,2,"""2""",58140,58200
5378,404600,402602,60,56160,2,"""2""",58200,58260
5378,402602,403602,120,56160,2,"""2""",58260,58380
5378,403602,404700,120,56160,2,"""2""",58380,58500
5378,404700,404701,0,56160,2,"""2""",58500,58500
5378,407500,407503,60,57360,2,"""2""",57360,57420
5378,407503,408900,60,57360,2,"""2""",57420,57480
5378,408900,400802,60,57360,2,"""2""",57480,57540
5378,400802,400704,120,57360,2,"""2""",57540,57660
5378,400704,408503,60,57360,2,"""2""",57660,57720
5378,408503,405602,60,57360,2,"""2""",57720,57780
5378,405602,407102,60,57360,2,"""2""",57780,57840
5378,407102,404202,60,57360,2,"""2""",57840,57900
5378,404202,117000,60,57360,2,"""2""",57900,57960
5378,117000,112106,120,57360,2,"""2""",57960,58080
5378,112106,103003,120,57360,2,"""2""",58080,58200
5378,103003,118002,180,57360,2,"""2""",58200,58380
5378,118002,106002,60,57360,2,"""2""",58380,58440
5378,106002,118102,60,57360,2,"""2""",58440,58500
5378,118102,101002,120,57360,2,"""2""",58500,58620
5378,101002,102002,60,57360,2,"""2""",58620,58680
5378,102002,101101,120,57360,2,"""2""",58680,58800
5378,101101,403802,120,57360,2,"""2""",58800,58920
5378,403802,408300,120,57360,2,"""2""",58920,59040
5378,408300,406502,60,57360,2,"""2""",59040,59100
5378,406502,407702,60,57360,2,"""2""",59100,59160
5378,407702,408403,60,57360,2,"""2""",59160,59220
5378,408403,403502,60,57360,2,"""2""",59220,59280
5378,403502,403701,60,57360,2,"""2""",59280,59340
5378,403701,404600,60,57360,2,"""2""",59340,59400
5378,404600,402602,60,57360,2,"""2""",59400,59460
5378,402602,403602,120,57360,2,"""2""",59460,59580
5378,403602,404700,120,57360,2,"""2""",59580,59700
5378,404700,404701,0,57360,2,"""2""",59700,59700
5378,407500,407503,60,58560,2,"""2""",58560,58620
5378,407503,408900,60,58560,2,"""2""",58620,58680
5378,408900,400802,60,58560,2,"""2""",58680,58740
5378,400802,400704,120,58560,2,"""2""",58740,58860
5378,400704,408503,60,58560,2,"""2""",58860,58920
5378,408503,405602,60,58560,2,"""2""",58920,58980
5378,405602,407102,60,58560,2,"""2""",58980,59040
5378,407102,404202,60,58560,2,"""2""",59040,59100
5378,404202,117000,60,58560,2,"""2""",59100,59160
5378,117000,112106,120,58560,2,"""2""",59160,59280
5378,112106,103003,120,58560,2,"""2""",59280,59400
5378,103003,118002,180,58560,2,"""2""",59400,59580
5378,118002,106002,60,58560,2,"""2""",59580,59640
5378,106002,118102,60,58560,2,"""2""",59640,59700
5378,118102,101002,120,58560,2,"""2""",59700,59820
5378,101002,102002,60,58560,2,"""2""",59820,59880
5378,102002,101101,120,58560,2,"""2""",59880,60000
5378,101101,403802,120,58560,2,"""2""",60000,60120
5378,403802,408300,120,58560,2,"""2""",60120,60240
5378,408300,406502,60,58560,2,"""2""",60240,60300
5378,406502,407702,60,58560,2,"""2""",60300,60360
5378,407702,408403,60,58560,2,"""2""",60360,60420
5378,408403,403502,60,58560,2,"""2""",60420,60480
5378,403502,403701,60,58560,2,"""2""",60480,60540
5378,403701,404600,60,58560,2,"""2""",60540,60600
5378,404600,402602,60,58560,2,"""2""",60600,60660
5378,402602,403602,120,58560,2,"""2""",60660,60780
5378,403602,404700,120,58560,2,"""2""",60780,60900
5378,404700,404701,0,58560,2,"""2""",60900,60900
5378,407500,407503,60,59760,2,"""2""",59760,59820
5378,407503,408900,60,59760,2,"""2""",59820,59880
5378,408900,400802,60,59760,2,"""2""",59880,59940
5378,400802,400704,120,59760,2,"""2""",59940,60060
5378,400704,408503,60,59760,2,"""2""",60060,60120
5378,408503,405602,60,59760,2,"""2""",60120,60180
5378,405602,407102,60,59760,2,"""2""",60180,60240
5378,407102,404202,60,59760,2,"""2""",60240,60300
5378,404202,117000,60,59760,2,"""2""",60300,60360
5378,117000,112106,120,59760,2,"""2""",60360,60480
5378,112106,103003,120,59760,2,"""2""",60480,60600
5378,103003,118002,180,59760,2,"""2""",60600,60780
5378,118002,106002,60,59760,2,"""2""",60780,60840
5378,106002,118102,60,59760,2,"""2""",60840,60900
5378,118102,101002,120,59760,2,"""2""",60900,61020
5378,101002,102002,60,59760,2,"""2""",61020,61080
5378,102002,101101,120,59760,2,"""2""",61080,61200
5378,101101,403802,120,59760,2,"""2""",61200,61320
5378,403802,408300,120,59760,2,"""2""",61320,61440
5378,408300,406502,60,59760,2,"""2""",61440,61500
5378,406502,407702,60,59760,2,"""2""",61500,61560
5378,407702,408403,60,59760,2,"""2""",61560,61620
5378,408403,403502,60,59760,2,"""2""",61620,61680
5378,403502,403701,60,59760,2,"""2""",61680,61740
5378,403701,404600,60,59760,2,"""2""",61740,61800
5378,404600,402602,60,59760,2,"""2""",61800,61860
5378,402602,403602,120,59760,2,"""2""",61860,61980
5378,403602,404700,120,59760,2,"""2""",61980,62100
5378,404700,404701,0,59760,2,"""2""",62100,62100
5378,407500,407503,60,60960,2,"""2""",60960,61020
5378,407503,408900,60,60960,2,"""2""",61020,61080
5378,408900,400802,60,60960,2,"""2""",61080,61140
5378,400802,400704,120,60960,2,"""2""",61140,61260
5378,400704,408503,60,60960,2,"""2""",61260,61320
5378,408503,405602,60,60960,2,"""2""",61320,61380
5378,405602,407102,60,60960,2,"""2""",61380,61440
5378,407102,404202,60,60960,2,"""2""",61440,61500
5378,404202,117000,60,60960,2,"""2""",61500,61560
5378,117000,112106,120,60960,2,"""2""",61560,61680
5378,112106,103003,120,60960,2,"""2""",61680,61800
5378,103003,118002,180,60960,2,"""2""",61800,61980
5378,118002,106002,60,60960,2,"""2""",61980,62040
5378,106002,118102,60,60960,2,"""2""",62040,62100
5378,118102,101002,120,60960,2,"""2""",62100,62220
5378,101002,102002,60,60960,2,"""2""",62220,62280
5378,102002,101101,120,60960,2,"""2""",62280,62400
5378,101101,403802,120,60960,2,"""2""",62400,62520
5378,403802,408300,120,60960,2,"""2""",62520,62640
5378,408300,406502,60,60960,2,"""2""",62640,62700
5378,406502,407702,60,60960,2,"""2""",62700,62760
5378,407702,408403,60,60960,2,"""2""",62760,62820
5378,408403,403502,60,60960,2,"""2""",62820,62880
5378,403502,403701,60,60960,2,"""2""",62880,62940
5378,403701,404600,60,60960,2,"""2""",62940,63000
5378,404600,402602,60,60960,2,"""2""",63000,63060
5378,402602,403602,120,60960,2,"""2""",63060,63180
5378,403602,404700,120,60960,2,"""2""",63180,63300
5378,404700,404701,0,60960,2,"""2""",63300,63300
5378,407500,407503,60,62160,2,"""2""",62160,62220
5378,407503,408900,60,62160,2,"""2""",62220,62280
5378,408900,400802,60,62160,2,"""2""",62280,62340
5378,400802,400704,120,62160,2,"""2""",62340,62460
5378,400704,408503,60,62160,2,"""2""",62460,62520
5378,408503,405602,60,62160,2,"""2""",62520,62580
5378,405602,407102,60,62160,2,"""2""",62580,62640
5378,407102,404202,60,62160,2,"""2""",62640,62700
5378,404202,117000,60,62160,2,"""2""",62700,62760
5378,117000,112106,120,62160,2,"""2""",62760,62880
5378,112106,103003,120,62160,2,"""2""",62880,63000
5378,103003,118002,180,62160,2,"""2""",63000,63180
5378,118002,106002,60,62160,2,"""2""",63180,63240
5378,106002,118102,60,62160,2,"""2""",63240,63300
5378,118102,101002,120,62160,2,"""2""",63300,63420
5378,101002,102002,60,62160,2,"""2""",63420,63480
5378,102002,101101,120,62160,2,"""2""",63480,63600
5378,101101,403802,120,62160,2,"""2""",63600,63720
5378,403802,408300,120,62160,2,"""2""",63720,63840
5378,408300,406502,60,62160,2,"""2""",63840,63900
5378,406502,407702,60,62160,2,"""2""",63900,63960
5378,407702,408403,60,62160,2,"""2""",63960,64020
5378,408403,403502,60,62160,2,"""2""",64020,64080
5378,403502,403701,60,62160,2,"""2""",64080,64140
5378,403701,404600,60,62160,2,"""2""",64140,64200
5378,404600,402602,60,62160,2,"""2""",64200,64260
5378,402602,403602,120,62160,2,"""2""",64260,64380
5378,403602,404700,120,62160,2,"""2""",64380,64500
5378,404700,404701,0,62160,2,"""2""",64500,64500
5378,407500,407503,60,63360,2,"""2""",63360,63420
5378,407503,408900,60,63360,2,"""2""",63420,63480
5378,408900,400802,60,63360,2,"""2""",63480,63540
5378,400802,400704,120,63360,2,"""2""",63540,63660
5378,400704,408503,60,63360,2,"""2""",63660,63720
5378,408503,405602,60,63360,2,"""2""",63720,63780
5378,405602,407102,60,63360,2,"""2""",63780,63840
5378,407102,404202,60,63360,2,"""2""",63840,63900
5378,404202,117000,60,63360,2,"""2""",63900,63960
5378,117000,112106,120,63360,2,"""2""",63960,64080
5378,112106,103003,120,63360,2,"""2""",64080,64200
5378,103003,118002,180,63360,2,"""2""",64200,64380
5378,118002,106002,60,63360,2,"""2""",64380,64440
5378,106002,118102,60,63360,2,"""2""",64440,64500
5378,118102,101002,120,63360,2,"""2""",64500,64620
5378,101002,102002,60,63360,2,"""2""",64620,64680
5378,102002,101101,120,63360,2,"""2""",64680,64800
5378,101101,403802,120,63360,2,"""2""",64800,64920
5378,403802,408300,120,63360,2,"""2""",64920,65040
5378,408300,406502,60,63360,2,"""2""",65040,65100
5378,406502,407702,60,63360,2,"""2""",65100,65160
5378,407702,408403,60,63360,2,"""2""",65160,65220
5378,408403,403502,60,63360,2,"""2""",65220,65280
5378,403502,403701,60,63360,2,"""2""",65280,65340
5378,403701,404600,60,63360,2,"""2""",65340,65400
5378,404600,402602,60,63360,2,"""2""",65400,65460
5378,402602,403602,120,63360,2,"""2""",65460,65580
5378,403602,404700,120,63360,2,"""2""",65580,65700
5378,404700,404701,0,63360,2,"""2""",65700,65700
5378,407500,407503,60,64560,2,"""2""",64560,64620
5378,407503,408900,60,64560,2,"""2""",64620,64680
5378,408900,400802,60,64560,2,"""2""",64680,64740
5378,400802,400704,120,64560,2,"""2""",64740,64860
5378,400704,408503,60,64560,2,"""2""",64860,64920
5378,408503,405602,60,64560,2,"""2""",64920,64980
5378,405602,407102,60,64560,2,"""2""",64980,65040
5378,407102,404202,60,64560,2,"""2""",65040,65100
5378,404202,117000,60,64560,2,"""2""",65100,65160
5378,117000,112106,120,64560,2,"""2""",65160,65280
5378,112106,103003,120,64560,2,"""2""",65280,65400
5378,103003,118002,180,64560,2,"""2""",65400,65580
5378,118002,106002,60,64560,2,"""2""",65580,65640
5378,106002,118102,60,64560,2,"""2""",65640,65700
5378,118102,101002,120,64560,2,"""2""",65700,65820
5378,101002,102002,60,64560,2,"""2""",65820,65880
5378,102002,101101,120,64560,2,"""2""",65880,66000
5378,101101,403802,120,64560,2,"""2""",66000,66120
5378,403802,408300,120,64560,2,"""2""",66120,66240
5378,408300,406502,60,64560,2,"""2""",66240,66300
5378,406502,407702,60,64560,2,"""2""",66300,66360
5378,407702,408403,60,64560,2,"""2""",66360,66420
5378,408403,403502,60,64560,2,"""2""",66420,66480
5378,403502,403701,60,64560,2,"""2""",66480,66540
5378,403701,404600,60,64560,2,"""2""",66540,66600
5378,404600,402602,60,64560,2,"""2""",66600,66660
5378,402602,403602,120,64560,2,"""2""",66660,66780
5378,403602,404700,120,64560,2,"""2""",66780,66900
5378,404700,404701,0,64560,2,"""2""",66900,66900
5378,407500,407503,60,65760,2,"""2""",65760,65820
5378,407503,408900,60,65760,2,"""2""",65820,65880
5378,408900,400802,60,65760,2,"""2""",65880,65940
5378,400802,400704,120,65760,2,"""2""",65940,66060
5378,400704,408503,60,65760,2,"""2""",66060,66120
5378,408503,405602,60,65760,2,"""2""",66120,66180
5378,405602,407102,60,65760,2,"""2""",66180,66240
5378,407102,404202,60,65760,2,"""2""",66240,66300
5378,404202,117000,60,65760,2,"""2""",66300,66360
5378,117000,112106,120,65760,2,"""2""",66360,66480
5378,112106,103003,120,65760,2,"""2""",66480,66600
5378,103003,118002,180,65760,2,"""2""",66600,66780
5378,118002,106002,60,65760,2,"""2""",66780,66840
5378,106002,118102,60,65760,2,"""2""",66840,66900
5378,118102,101002,120,65760,2,"""2""",66900,67020
5378,101002,102002,60,65760,2,"""2""",67020,67080
5378,102002,101101,120,65760,2,"""2""",67080,67200
5378,101101,403802,120,65760,2,"""2""",67200,67320
5378,403802,408300,120,65760,2,"""2""",67320,67440
5378,408300,406502,60,65760,2,"""2""",67440,67500
5378,406502,407702,60,65760,2,"""2""",67500,67560
5378,407702,408403,60,65760,2,"""2""",67560,67620
5378,408403,403502,60,65760,2,"""2""",67620,67680
5378,403502,403701,60,65760,2,"""2""",67680,67740
5378,403701,404600,60,65760,2,"""2""",67740,67800
5378,404600,402602,60,65760,2,"""2""",67800,67860
5378,402602,403602,120,65760,2,"""2""",67860,67980
5378,403602,404700,120,65760,2,"""2""",67980,68100
5378,404700,404701,0,65760,2,"""2""",68100,68100
5378,407500,407503,60,66960,2,"""2""",66960,67020
5378,407503,408900,60,66960,2,"""2""",67020,67080
5378,408900,400802,60,66960,2,"""2""",67080,67140
5378,400802,400704,120,66960,2,"""2""",67140,67260
5378,400704,408503,60,66960,2,"""2""",67260,67320
5378,408503,405602,60,66960,2,"""2""",67320,67380
5378,405602,407102,60,66960,2,"""2""",67380,67440
5378,407102,404202,60,66960,2,"""2""",67440,67500
5378,404202,117000,60,66960,2,"""2""",67500,67560
5378,117000,112106,120,66960,2,"""2""",67560,67680
5378,112106,103003,120,66960,2,"""2""",67680,67800
5378,103003,118002,180,66960,2,"""2""",67800,67980
5378,118002,106002,60,66960,2,"""2""",67980,68040
5378,106002,118102,60,66960,2,"""2""",68040,68100
5378,118102,101002,120,66960,2,"""2""",68100,68220
5378,101002,102002,60,66960,2,"""2""",68220,68280
5378,102002,101101,120,66960,2,"""2""",68280,68400
5378,101101,403802,120,66960,2,"""2""",68400,68520
5378,403802,408300,120,66960,2,"""2""",68520,68640
5378,408300,406502,60,66960,2,"""2""",68640,68700
5378,406502,407702,60,66960,2,"""2""",68700,68760
5378,407702,408403,60,66960,2,"""2""",68760,68820
5378,408403,403502,60,66960,2,"""2""",68820,68880
5378,403502,403701,60,66960,2,"""2""",68880,68940
5378,403701,404600,60,66960,2,"""2""",68940,69000
5378,404600,402602,60,66960,2,"""2""",69000,69060
5378,402602,403602,120,66960,2,"""2""",69060,69180
5378,403602,404700,120,66960,2,"""2""",69180,69300
5378,404700,404701,0,66960,2,"""2""",69300,69300
5378,407500,407503,60,68520,2,"""2""",68520,68580
5378,407503,408900,60,68520,2,"""2""",68580,68640
5378,408900,400802,60,68520,2,"""2""",68640,68700
5378,400802,400704,120,68520,2,"""2""",68700,68820
5378,400704,408503,60,68520,2,"""2""",68820,68880
5378,408503,405602,60,68520,2,"""2""",68880,68940
5378,405602,407102,60,68520,2,"""2""",68940,69000
5378,407102,404202,60,68520,2,"""2""",69000,69060
5378,404202,117000,60,68520,2,"""2""",69060,69120
5378,117000,112106,120,68520,2,"""2""",69120,69240
5378,112106,103003,120,68520,2,"""2""",69240,69360
5378,103003,118002,180,68520,2,"""2""",69360,69540
5378,118002,106002,60,68520,2,"""2""",69540,69600
5378,106002,118102,60,68520,2,"""2""",69600,69660
5378,118102,101002,120,68520,2,"""2""",69660,69780
5378,101002,102002,60,68520,2,"""2""",69780,69840
5378,102002,101101,120,68520,2,"""2""",69840,69960
5378,101101,403802,120,68520,2,"""2""",69960,70080
5378,403802,408300,120,68520,2,"""2""",70080,70200
5378,408300,406502,60,68520,2,"""2""",70200,70260
5378,406502,407702,60,68520,2,"""2""",70260,70320
5378,407702,408403,60,68520,2,"""2""",70320,70380
5378,408403,403502,60,68520,2,"""2""",70380,70440
5378,403502,403701,60,68520,2,"""2""",70440,70500
5378,403701,404600,60,68520,2,"""2""",70500,70560
5378,404600,402602,60,68520,2,"""2""",70560,70620
5378,402602,403602,120,68520,2,"""2""",70620,70740
5378,403602,404700,120,68520,2,"""2""",70740,70860
5378,404700,404701,0,68520,2,"""2""",70860,70860
5379,407500,407503,60,20160,2,"""2""",20160,20220
5379,407503,408900,60,20160,2,"""2""",20220,20280
5379,408900,400802,60,20160,2,"""2""",20280,20340
5379,400802,400704,120,20160,2,"""2""",20340,20460
5379,400704,408503,60,20160,2,"""2""",20460,20520
5379,408503,405602,60,20160,2,"""2""",20520,20580
5379,405602,407102,60,20160,2,"""2""",20580,20640
5379,407102,404202,60,20160,2,"""2""",20640,20700
5379,404202,117000,60,20160,2,"""2""",20700,20760
5379,117000,112106,120,20160,2,"""2""",20760,20880
5379,112106,103003,120,20160,2,"""2""",20880,21000
5379,103003,118002,120,20160,2,"""2""",21000,21120
5379,118002,106002,60,20160,2,"""2""",21120,21180
5379,106002,118102,60,20160,2,"""2""",21180,21240
5379,118102,101002,120,20160,2,"""2""",21240,21360
5379,101002,102002,60,20160,2,"""2""",21360,21420
5379,102002,101101,120,20160,2,"""2""",21420,21540
5379,101101,403802,60,20160,2,"""2""",21540,21600
5379,403802,408300,60,20160,2,"""2""",21600,21660
5379,408300,406502,60,20160,2,"""2""",21660,21720
5379,406502,407702,60,20160,2,"""2""",21720,21780
5379,407702,408403,60,20160,2,"""2""",21780,21840
5379,408403,403502,60,20160,2,"""2""",21840,21900
5379,403502,403701,60,20160,2,"""2""",21900,21960
5379,403701,404600,60,20160,2,"""2""",21960,22020
5379,404600,402602,60,20160,2,"""2""",22020,22080
5379,402602,403602,120,20160,2,"""2""",22080,22200
5379,403602,404700,60,20160,2,"""2""",22200,22260
5379,404700,404701,0,20160,2,"""2""",22260,22260
5380,407500,407503,60,24360,2,"""6""",24360,24420
5380,407503,408900,60,24360,2,"""6""",24420,24480
5380,408900,400802,60,24360,2,"""6""",24480,24540
5380,400802,400704,120,24360,2,"""6""",24540,24660
5380,400704,408503,60,24360,2,"""6""",24660,24720
5380,408503,405602,60,24360,2,"""6""",24720,24780
5380,405602,407102,60,24360,2,"""6""",24780,24840
5380,407102,404202,60,24360,2,"""6""",24840,24900
5380,404202,117000,60,24360,2,"""6""",24900,24960
5380,117000,112106,120,24360,2,"""6""",24960,25080
5380,112106,103003,120,24360,2,"""6""",25080,25200
5380,103003,118002,180,24360,2,"""6""",25200,25380
5380,118002,106002,60,24360,2,"""6""",25380,25440
5380,106002,118102,60,24360,2,"""6""",25440,25500
5380,118102,101002,120,24360,2,"""6""",25500,25620
5380,101002,102002,60,24360,2,"""6""",25620,25680
5380,102002,101101,120,24360,2,"""6""",25680,25800
5380,101101,403802,120,24360,2,"""6""",25800,25920
5380,403802,408300,120,24360,2,"""6""",25920,26040
5380,408300,406502,60,24360,2,"""6""",26040,26100
5380,406502,407702,60,24360,2,"""6""",26100,26160
5380,407702,34201,60,24360,2,"""6""",26160,26220
5380,34201,408003,180,24360,2,"""6""",26220,26400
5380,408003,400501,60,24360,2,"""6""",26400,26460
5380,400501,409201,60,24360,2,"""6""",26460,26520
5380,409201,404603,120,24360,2,"""6""",26520,26640
5380,407500,407503,60,25560,2,"""6""",25560,25620
5380,407503,408900,60,25560,2,"""6""",25620,25680
5380,408900,400802,60,25560,2,"""6""",25680,25740
5380,400802,400704,120,25560,2,"""6""",25740,25860
5380,400704,408503,60,25560,2,"""6""",25860,25920
5380,408503,405602,60,25560,2,"""6""",25920,25980
5380,405602,407102,60,25560,2,"""6""",25980,26040
5380,407102,404202,60,25560,2,"""6""",26040,26100
5380,404202,117000,60,25560,2,"""6""",26100,26160
5380,117000,112106,120,25560,2,"""6""",26160,26280
5380,112106,103003,120,25560,2,"""6""",26280,26400
5380,103003,118002,180,25560,2,"""6""",26400,26580
5380,118002,106002,60,25560,2,"""6""",26580,26640
5380,106002,118102,60,25560,2,"""6""",26640,26700
5380,118102,101002,120,25560,2,"""6""",26700,26820
5380,101002,102002,60,25560,2,"""6""",26820,26880
5380,102002,101101,120,25560,2,"""6""",26880,27000
5380,101101,403802,120,25560,2,"""6""",27000,27120
5380,403802,408300,120,25560,2,"""6""",27120,27240
5380,408300,406502,60,25560,2,"""6""",27240,27300
5380,406502,407702,60,25560,2,"""6""",27300,27360
5380,407702,34201,60,25560,2,"""6""",27360,27420
5380,34201,408003,180,25560,2,"""6""",27420,27600
5380,408003,400501,60,25560,2,"""6""",27600,27660
5380,400501,409201,60,25560,2,"""6""",27660,27720
5380,409201,404603,120,25560,2,"""6""",27720,27840
5380,407500,407503,60,26760,2,"""6""",26760,26820
5380,407503,408900,60,26760,2,"""6""",26820,26880
5380,408900,400802,60,26760,2,"""6""",26880,26940
5380,400802,400704,120,26760,2,"""6""",26940,27060
5380,400704,408503,60,26760,2,"""6""",27060,27120
5380,408503,405602,60,26760,2,"""6""",27120,27180
5380,405602,407102,60,26760,2,"""6""",27180,27240
5380,407102,404202,60,26760,2,"""6""",27240,27300
5380,404202,117000,60,26760,2,"""6""",27300,27360
5380,117000,112106,120,26760,2,"""6""",27360,27480
5380,112106,103003,120,26760,2,"""6""",27480,27600
5380,103003,118002,180,26760,2,"""6""",27600,27780
5380,118002,106002,60,26760,2,"""6""",27780,27840
5380,106002,118102,60,26760,2,"""6""",27840,27900
5380,118102,101002,120,26760,2,"""6""",27900,28020
5380,101002,102002,60,26760,2,"""6""",28020,28080
5380,102002,101101,120,26760,2,"""6""",28080,28200
5380,101101,403802,120,26760,2,"""6""",28200,28320
5380,403802,408300,120,26760,2,"""6""",28320,28440
5380,408300,406502,60,26760,2,"""6""",28440,28500
5380,406502,407702,60,26760,2,"""6""",28500,28560
5380,407702,34201,60,26760,2,"""6""",28560,28620
5380,34201,408003,180,26760,2,"""6""",28620,28800
5380,408003,400501,60,26760,2,"""6""",28800,28860
5380,400501,409201,60,26760,2,"""6""",28860,28920
5380,409201,404603,120,26760,2,"""6""",28920,29040
5380,407500,407503,60,27960,2,"""6""",27960,28020
5380,407503,408900,60,27960,2,"""6""",28020,28080
5380,408900,400802,60,27960,2,"""6""",28080,28140
5380,400802,400704,120,27960,2,"""6""",28140,28260
5380,400704,408503,60,27960,2,"""6""",28260,28320
5380,408503,405602,60,27960,2,"""6""",28320,28380
5380,405602,407102,60,27960,2,"""6""",28380,28440
5380,407102,404202,60,27960,2,"""6""",28440,28500
5380,404202,117000,60,27960,2,"""6""",28500,28560
5380,117000,112106,120,27960,2,"""6""",28560,28680
5380,112106,103003,120,27960,2,"""6""",28680,28800
5380,103003,118002,180,27960,2,"""6""",28800,28980
5380,118002,106002,60,27960,2,"""6""",28980,29040
5380,106002,118102,60,27960,2,"""6""",29040,29100
5380,118102,101002,120,27960,2,"""6""",29100,29220
5380,101002,102002,60,27960,2,"""6""",29220,29280
5380,102002,101101,120,27960,2,"""6""",29280,29400
5380,101101,403802,120,27960,2,"""6""",29400,29520
5380,403802,408300,120,27960,2,"""6""",29520,29640
5380,408300,406502,60,27960,2,"""6""",29640,29700
5380,406502,407702,60,27960,2,"""6""",29700,29760
5380,407702,34201,60,27960,2,"""6""",29760,29820
5380,34201,408003,180,27960,2,"""6""",29820,30000
5380,408003,400501,60,27960,2,"""6""",30000,30060
5380,400501,409201,60,27960,2,"""6""",30060,30120
5380,409201,404603,120,27960,2,"""6""",30120,30240
5380,407500,407503,60,29160,2,"""6""",29160,29220
5380,407503,408900,60,29160,2,"""6""",29220,29280
5380,408900,400802,60,29160,2,"""6""",29280,29340
5380,400802,400704,120,29160,2,"""6""",29340,29460
5380,400704,408503,60,29160,2,"""6""",29460,29520
5380,408503,405602,60,29160,2,"""6""",29520,29580
5380,405602,407102,60,29160,2,"""6""",29580,29640
5380,407102,404202,60,29160,2,"""6""",29640,29700
5380,404202,117000,60,29160,2,"""6""",29700,29760
5380,117000,112106,120,29160,2,"""6""",29760,29880
5380,112106,103003,120,29160,2,"""6""",29880,30000
5380,103003,118002,180,29160,2,"""6""",30000,30180
5380,118002,106002,60,29160,2,"""6""",30180,30240
5380,106002,118102,60,29160,2,"""6""",30240,30300
5380,118102,101002,120,29160,2,"""6""",30300,30420
5380,101002,102002,60,29160,2,"""6""",30420,30480
5380,102002,101101,120,29160,2,"""6""",30480,30600
5380,101101,403802,120,29160,2,"""6""",30600,30720
5380,403802,408300,120,29160,2,"""6""",30720,30840
5380,408300,406502,60,29160,2,"""6""",30840,30900
5380,406502,407702,60,29160,2,"""6""",30900,30960
5380,407702,34201,60,29160,2,"""6""",30960,31020
5380,34201,408003,180,29160,2,"""6""",31020,31200
5380,408003,400501,60,29160,2,"""6""",31200,31260
5380,400501,409201,60,29160,2,"""6""",31260,31320
5380,409201,404603,120,29160,2,"""6""",31320,31440
5380,407500,407503,60,30360,2,"""6""",30360,30420
5380,407503,408900,60,30360,2,"""6""",30420,30480
5380,408900,400802,60,30360,2,"""6""",30480,30540
5380,400802,400704,120,30360,2,"""6""",30540,30660
5380,400704,408503,60,30360,2,"""6""",30660,30720
5380,408503,405602,60,30360,2,"""6""",30720,30780
5380,405602,407102,60,30360,2,"""6""",30780,30840
5380,407102,404202,60,30360,2,"""6""",30840,30900
5380,404202,117000,60,30360,2,"""6""",30900,30960
5380,117000,112106,120,30360,2,"""6""",30960,31080
5380,112106,103003,120,30360,2,"""6""",31080,31200
5380,103003,118002,180,30360,2,"""6""",31200,31380
5380,118002,106002,60,30360,2,"""6""",31380,31440
5380,106002,118102,60,30360,2,"""6""",31440,31500
5380,118102,101002,120,30360,2,"""6""",31500,31620
5380,101002,102002,60,30360,2,"""6""",31620,31680
5380,102002,101101,120,30360,2,"""6""",31680,31800
5380,101101,403802,120,30360,2,"""6""",31800,31920
5380,403802,408300,120,30360,2,"""6""",31920,32040
5380,408300,406502,60,30360,2,"""6""",32040,32100
5380,406502,407702,60,30360,2,"""6""",32100,32160
5380,407702,34201,60,30360,2,"""6""",32160,32220
5380,34201,408003,180,30360,2,"""6""",32220,32400
5380,408003,400501,60,30360,2,"""6""",32400,32460
5380,400501,409201,60,30360,2,"""6""",32460,32520
5380,409201,404603,120,30360,2,"""6""",32520,32640
5380,407500,407503,60,31560,2,"""6""",31560,31620
5380,407503,408900,60,31560,2,"""6""",31620,31680
5380,408900,400802,60,31560,2,"""6""",31680,31740
5380,400802,400704,120,31560,2,"""6""",31740,31860
5380,400704,408503,60,31560,2,"""6""",31860,31920
5380,408503,405602,60,31560,2,"""6""",31920,31980
5380,405602,407102,60,31560,2,"""6""",31980,32040
5380,407102,404202,60,31560,2,"""6""",32040,32100
5380,404202,117000,60,31560,2,"""6""",32100,32160
5380,117000,112106,120,31560,2,"""6""",32160,32280
5380,112106,103003,120,31560,2,"""6""",32280,32400
5380,103003,118002,180,31560,2,"""6""",32400,32580
5380,118002,106002,60,31560,2,"""6""",32580,32640
5380,106002,118102,60,31560,2,"""6""",32640,32700
5380,118102,101002,120,31560,2,"""6""",32700,32820
5380,101002,102002,60,31560,2,"""6""",32820,32880
5380,102002,101101,120,31560,2,"""6""",32880,33000
5380,101101,403802,120,31560,2,"""6""",33000,33120
5380,403802,408300,120,31560,2,"""6""",33120,33240
5380,408300,406502,60,31560,2,"""6""",33240,33300
5380,406502,407702,60,31560,2,"""6""",33300,33360
5380,407702,34201,60,31560,2,"""6""",33360,33420
5380,34201,408003,180,31560,2,"""6""",33420,33600
5380,408003,400501,60,31560,2,"""6""",33600,33660
5380,400501,409201,60,31560,2,"""6""",33660,33720
5380,409201,404603,120,31560,2,"""6""",33720,33840
5380,407500,407503,60,32760,2,"""6""",32760,32820
5380,407503,408900,60,32760,2,"""6""",32820,32880
5380,408900,400802,60,32760,2,"""6""",32880,32940
5380,400802,400704,120,32760,2,"""6""",32940,33060
5380,400704,408503,60,32760,2,"""6""",33060,33120
5380,408503,405602,60,32760,2,"""6""",33120,33180
5380,405602,407102,60,32760,2,"""6""",33180,33240
5380,407102,404202,60,32760,2,"""6""",33240,33300
5380,404202,117000,60,32760,2,"""6""",33300,33360
5380,117000,112106,120,32760,2,"""6""",33360,33480
5380,112106,103003,120,32760,2,"""6""",33480,33600
5380,103003,118002,180,32760,2,"""6""",33600,33780
5380,118002,106002,60,32760,2,"""6""",33780,33840
5380,106002,118102,60,32760,2,"""6""",33840,33900
5380,118102,101002,120,32760,2,"""6""",33900,34020
5380,101002,102002,60,32760,2,"""6""",34020,34080
5380,102002,101101,120,32760,2,"""6""",34080,34200
5380,101101,403802,120,32760,2,"""6""",34200,34320
5380,403802,408300,120,32760,2,"""6""",34320,34440
5380,408300,406502,60,32760,2,"""6""",34440,34500
5380,406502,407702,60,32760,2,"""6""",34500,34560
5380,407702,34201,60,32760,2,"""6""",34560,34620
5380,34201,408003,180,32760,2,"""6""",34620,34800
5380,408003,400501,60,32760,2,"""6""",34800,34860
5380,400501,409201,60,32760,2,"""6""",34860,34920
5380,409201,404603,120,32760,2,"""6""",34920,35040
5380,407500,407503,60,33960,2,"""6""",33960,34020
5380,407503,408900,60,33960,2,"""6""",34020,34080
5380,408900,400802,60,33960,2,"""6""",34080,34140
5380,400802,400704,120,33960,2,"""6""",34140,34260
5380,400704,408503,60,33960,2,"""6""",34260,34320
5380,408503,405602,60,33960,2,"""6""",34320,34380
5380,405602,407102,60,33960,2,"""6""",34380,34440
5380,407102,404202,60,33960,2,"""6""",34440,34500
5380,404202,117000,60,33960,2,"""6""",34500,34560
5380,117000,112106,120,33960,2,"""6""",34560,34680
5380,112106,103003,120,33960,2,"""6""",34680,34800
5380,103003,118002,180,33960,2,"""6""",34800,34980
5380,118002,106002,60,33960,2,"""6""",34980,35040
5380,106002,118102,60,33960,2,"""6""",35040,35100
5380,118102,101002,120,33960,2,"""6""",35100,35220
5380,101002,102002,60,33960,2,"""6""",35220,35280
5380,102002,101101,120,33960,2,"""6""",35280,35400
5380,101101,403802,120,33960,2,"""6""",35400,35520
5380,403802,408300,120,33960,2,"""6""",35520,35640
5380,408300,406502,60,33960,2,"""6""",35640,35700
5380,406502,407702,60,33960,2,"""6""",35700,35760
5380,407702,34201,60,33960,2,"""6""",35760,35820
5380,34201,408003,180,33960,2,"""6""",35820,36000
5380,408003,400501,60,33960,2,"""6""",36000,36060
5380,400501,409201,60,33960,2,"""6""",36060,36120
5380,409201,404603,120,33960,2,"""6""",36120,36240
5380,407500,407503,60,35160,2,"""6""",35160,35220
5380,407503,408900,60,35160,2,"""6""",35220,35280
5380,408900,400802,60,35160,2,"""6""",35280,35340
5380,400802,400704,120,35160,2,"""6""",35340,35460
5380,400704,408503,60,35160,2,"""6""",35460,35520
5380,408503,405602,60,35160,2,"""6""",35520,35580
5380,405602,407102,60,35160,2,"""6""",35580,35640
5380,407102,404202,60,35160,2,"""6""",35640,35700
5380,404202,117000,60,35160,2,"""6""",35700,35760
5380,117000,112106,120,35160,2,"""6""",35760,35880
5380,112106,103003,120,35160,2,"""6""",35880,36000
5380,103003,118002,180,35160,2,"""6""",36000,36180
5380,118002,106002,60,35160,2,"""6""",36180,36240
5380,106002,118102,60,35160,2,"""6""",36240,36300
5380,118102,101002,120,35160,2,"""6""",36300,36420
5380,101002,102002,60,35160,2,"""6""",36420,36480
5380,102002,101101,120,35160,2,"""6""",36480,36600
5380,101101,403802,120,35160,2,"""6""",36600,36720
5380,403802,408300,120,35160,2,"""6""",36720,36840
5380,408300,406502,60,35160,2,"""6""",36840,36900
5380,406502,407702,60,35160,2,"""6""",36900,36960
5380,407702,34201,60,35160,2,"""6""",36960,37020
5380,34201,408003,180,35160,2,"""6""",37020,37200
5380,408003,400501,60,35160,2,"""6""",37200,37260
5380,400501,409201,60,35160,2,"""6""",37260,37320
5380,409201,404603,120,35160,2,"""6""",37320,37440
5380,407500,407503,60,36360,2,"""6""",36360,36420
5380,407503,408900,60,36360,2,"""6""",36420,36480
5380,408900,400802,60,36360,2,"""6""",36480,36540
5380,400802,400704,120,36360,2,"""6""",36540,36660
5380,400704,408503,60,36360,2,"""6""",36660,36720
5380,408503,405602,60,36360,2,"""6""",36720,36780
5380,405602,407102,60,36360,2,"""6""",36780,36840
5380,407102,404202,60,36360,2,"""6""",36840,36900
5380,404202,117000,60,36360,2,"""6""",36900,36960
5380,117000,112106,120,36360,2,"""6""",36960,37080
5380,112106,103003,120,36360,2,"""6""",37080,37200
5380,103003,118002,180,36360,2,"""6""",37200,37380
5380,118002,106002,60,36360,2,"""6""",37380,37440
5380,106002,118102,60,36360,2,"""6""",37440,37500
5380,118102,101002,120,36360,2,"""6""",37500,37620
5380,101002,102002,60,36360,2,"""6""",37620,37680
5380,102002,101101,120,36360,2,"""6""",37680,37800
5380,101101,403802,120,36360,2,"""6""",37800,37920
5380,403802,408300,120,36360,2,"""6""",37920,38040
5380,408300,406502,60,36360,2,"""6""",38040,38100
5380,406502,407702,60,36360,2,"""6""",38100,38160
5380,407702,34201,60,36360,2,"""6""",38160,38220
5380,34201,408003,180,36360,2,"""6""",38220,38400
5380,408003,400501,60,36360,2,"""6""",38400,38460
5380,400501,409201,60,36360,2,"""6""",38460,38520
5380,409201,404603,120,36360,2,"""6""",38520,38640
5380,407500,407503,60,37560,2,"""6""",37560,37620
5380,407503,408900,60,37560,2,"""6""",37620,37680
5380,408900,400802,60,37560,2,"""6""",37680,37740
5380,400802,400704,120,37560,2,"""6""",37740,37860
5380,400704,408503,60,37560,2,"""6""",37860,37920
5380,408503,405602,60,37560,2,"""6""",37920,37980
5380,405602,407102,60,37560,2,"""6""",37980,38040
5380,407102,404202,60,37560,2,"""6""",38040,38100
5380,404202,117000,60,37560,2,"""6""",38100,38160
5380,117000,112106,120,37560,2,"""6""",38160,38280
5380,112106,103003,120,37560,2,"""6""",38280,38400
5380,103003,118002,180,37560,2,"""6""",38400,38580
5380,118002,106002,60,37560,2,"""6""",38580,38640
5380,106002,118102,60,37560,2,"""6""",38640,38700
5380,118102,101002,120,37560,2,"""6""",38700,38820
5380,101002,102002,60,37560,2,"""6""",38820,38880
5380,102002,101101,120,37560,2,"""6""",38880,39000
5380,101101,403802,120,37560,2,"""6""",39000,39120
5380,403802,408300,120,37560,2,"""6""",39120,39240
5380,408300,406502,60,37560,2,"""6""",39240,39300
5380,406502,407702,60,37560,2,"""6""",39300,39360
5380,407702,34201,60,37560,2,"""6""",39360,39420
5380,34201,408003,180,37560,2,"""6""",39420,39600
5380,408003,400501,60,37560,2,"""6""",39600,39660
5380,400501,409201,60,37560,2,"""6""",39660,39720
5380,409201,404603,120,37560,2,"""6""",39720,39840
5380,407500,407503,60,38760,2,"""6""",38760,38820
5380,407503,408900,60,38760,2,"""6""",38820,38880
5380,408900,400802,60,38760,2,"""6""",38880,38940
5380,400802,400704,120,38760,2,"""6""",38940,39060
5380,400704,408503,60,38760,2,"""6""",39060,39120
5380,408503,405602,60,38760,2,"""6""",39120,39180
5380,405602,407102,60,38760,2,"""6""",39180,39240
5380,407102,404202,60,38760,2,"""6""",39240,39300
5380,404202,117000,60,38760,2,"""6""",39300,39360
5380,117000,112106,120,38760,2,"""6""",39360,39480
5380,112106,103003,120,38760,2,"""6""",39480,39600
5380,103003,118002,180,38760,2,"""6""",39600,39780
5380,118002,106002,60,38760,2,"""6""",39780,39840
5380,106002,118102,60,38760,2,"""6""",39840,39900
5380,118102,101002,120,38760,2,"""6""",39900,40020
5380,101002,102002,60,38760,2,"""6""",40020,40080
5380,102002,101101,120,38760,2,"""6""",40080,40200
5380,101101,403802,120,38760,2,"""6""",40200,40320
5380,403802,408300,120,38760,2,"""6""",40320,40440
5380,408300,406502,60,38760,2,"""6""",40440,40500
5380,406502,407702,60,38760,2,"""6""",40500,40560
5380,407702,34201,60,38760,2,"""6""",40560,40620
5380,34201,408003,180,38760,2,"""6""",40620,40800
5380,408003,400501,60,38760,2,"""6""",40800,40860
5380,400501,409201,60,38760,2,"""6""",40860,40920
5380,409201,404603,120,38760,2,"""6""",40920,41040
5380,407500,407503,60,39960,2,"""6""",39960,40020
5380,407503,408900,60,39960,2,"""6""",40020,40080
5380,408900,400802,60,39960,2,"""6""",40080,40140
5380,400802,400704,120,39960,2,"""6""",40140,40260
5380,400704,408503,60,39960,2,"""6""",40260,40320
5380,408503,405602,60,39960,2,"""6""",40320,40380
5380,405602,407102,60,39960,2,"""6""",40380,40440
5380,407102,404202,60,39960,2,"""6""",40440,40500
5380,404202,117000,60,39960,2,"""6""",40500,40560
5380,117000,112106,120,39960,2,"""6""",40560,40680
5380,112106,103003,120,39960,2,"""6""",40680,40800
5380,103003,118002,180,39960,2,"""6""",40800,40980
5380,118002,106002,60,39960,2,"""6""",40980,41040
5380,106002,118102,60,39960,2,"""6""",41040,41100
5380,118102,101002,120,39960,2,"""6""",41100,41220
5380,101002,102002,60,39960,2,"""6""",41220,41280
5380,102002,101101,120,39960,2,"""6""",41280,41400
5380,101101,403802,120,39960,2,"""6""",41400,41520
5380,403802,408300,120,39960,2,"""6""",41520,41640
5380,408300,406502,60,39960,2,"""6""",41640,41700
5380,406502,407702,60,39960,2,"""6""",41700,41760
5380,407702,34201,60,39960,2,"""6""",41760,41820
5380,34201,408003,180,39960,2,"""6""",41820,42000
5380,408003,400501,60,39960,2,"""6""",42000,42060
5380,400501,409201,60,39960,2,"""6""",42060,42120
5380,409201,404603,120,39960,2,"""6""",42120,42240
5380,407500,407503,60,41160,2,"""6""",41160,41220
5380,407503,408900,60,41160,2,"""6""",41220,41280
5380,408900,400802,60,41160,2,"""6""",41280,41340
5380,400802,400704,120,41160,2,"""6""",41340,41460
5380,400704,408503,60,41160,2,"""6""",41460,41520
5380,408503,405602,60,41160,2,"""6""",41520,41580
5380,405602,407102,60,41160,2,"""6""",41580,41640
5380,407102,404202,60,41160,2,"""6""",41640,41700
5380,404202,117000,60,41160,2,"""6""",41700,41760
5380,117000,112106,120,41160,2,"""6""",41760,41880
5380,112106,103003,120,41160,2,"""6""",41880,42000
5380,103003,118002,180,41160,2,"""6""",42000,42180
5380,118002,106002,60,41160,2,"""6""",42180,42240
5380,106002,118102,60,41160,2,"""6""",42240,42300
5380,118102,101002,120,41160,2,"""6""",42300,42420
5380,101002,102002,60,41160,2,"""6""",42420,42480
5380,102002,101101,120,41160,2,"""6""",42480,42600
5380,101101,403802,120,41160,2,"""6""",42600,42720
5380,403802,408300,120,41160,2,"""6""",42720,42840
5380,408300,406502,60,41160,2,"""6""",42840,42900
5380,406502,407702,60,41160,2,"""6""",42900,42960
5380,407702,34201,60,41160,2,"""6""",42960,43020
5380,34201,408003,180,41160,2,"""6""",43020,43200
5380,408003,400501,60,41160,2,"""6""",43200,43260
5380,400501,409201,60,41160,2,"""6""",43260,43320
5380,409201,404603,120,41160,2,"""6""",43320,43440
5380,407500,407503,60,42360,2,"""6""",42360,42420
5380,407503,408900,60,42360,2,"""6""",42420,42480
5380,408900,400802,60,42360,2,"""6""",42480,42540
5380,400802,400704,120,42360,2,"""6""",42540,42660
5380,400704,408503,60,42360,2,"""6""",42660,42720
5380,408503,405602,60,42360,2,"""6""",42720,42780
5380,405602,407102,60,42360,2,"""6""",42780,42840
5380,407102,404202,60,42360,2,"""6""",42840,42900
5380,404202,117000,60,42360,2,"""6""",42900,42960
5380,117000,112106,120,42360,2,"""6""",42960,43080
5380,112106,103003,120,42360,2,"""6""",43080,43200
5380,103003,118002,180,42360,2,"""6""",43200,43380
5380,118002,106002,60,42360,2,"""6""",43380,43440
5380,106002,118102,60,42360,2,"""6""",43440,43500
5380,118102,101002,120,42360,2,"""6""",43500,43620
5380,101002,102002,60,42360,2,"""6""",43620,43680
5380,102002,101101,120,42360,2,"""6""",43680,43800
5380,101101,403802,120,42360,2,"""6""",43800,43920
5380,403802,408300,120,42360,2,"""6""",43920,44040
5380,408300,406502,60,42360,2,"""6""",44040,44100
5380,406502,407702,60,42360,2,"""6""",44100,44160
5380,407702,34201,60,42360,2,"""6""",44160,44220
5380,34201,408003,180,42360,2,"""6""",44220,44400
5380,408003,400501,60,42360,2,"""6""",44400,44460
5380,400501,409201,60,42360,2,"""6""",44460,44520
5380,409201,404603,120,42360,2,"""6""",44520,44640
5380,407500,407503,60,43560,2,"""6""",43560,43620
5380,407503,408900,60,43560,2,"""6""",43620,43680
5380,408900,400802,60,43560,2,"""6""",43680,43740
5380,400802,400704,120,43560,2,"""6""",43740,43860
5380,400704,408503,60,43560,2,"""6""",43860,43920
5380,408503,405602,60,43560,2,"""6""",43920,43980
5380,405602,407102,60,43560,2,"""6""",43980,44040
5380,407102,404202,60,43560,2,"""6""",44040,44100
5380,404202,117000,60,43560,2,"""6""",44100,44160
5380,117000,112106,120,43560,2,"""6""",44160,44280
5380,112106,103003,120,43560,2,"""6""",44280,44400
5380,103003,118002,180,43560,2,"""6""",44400,44580
5380,118002,106002,60,43560,2,"""6""",44580,44640
5380,106002,118102,60,43560,2,"""6""",44640,44700
5380,118102,101002,120,43560,2,"""6""",44700,44820
5380,101002,102002,60,43560,2,"""6""",44820,44880
5380,102002,101101,120,43560,2,"""6""",44880,45000
5380,101101,403802,120,43560,2,"""6""",45000,45120
5380,403802,408300,120,43560,2,"""6""",45120,45240
5380,408300,406502,60,43560,2,"""6""",45240,45300
5380,406502,407702,60,43560,2,"""6""",45300,45360
5380,407702,34201,60,43560,2,"""6""",45360,45420
5380,34201,408003,180,43560,2,"""6""",45420,45600
5380,408003,400501,60,43560,2,"""6""",45600,45660
5380,400501,409201,60,43560,2,"""6""",45660,45720
5380,409201,404603,120,43560,2,"""6""",45720,45840
5380,407500,407503,60,44760,2,"""6""",44760,44820
5380,407503,408900,60,44760,2,"""6""",44820,44880
5380,408900,400802,60,44760,2,"""6""",44880,44940
5380,400802,400704,120,44760,2,"""6""",44940,45060
5380,400704,408503,60,44760,2,"""6""",45060,45120
5380,408503,405602,60,44760,2,"""6""",45120,45180
5380,405602,407102,60,44760,2,"""6""",45180,45240
5380,407102,404202,60,44760,2,"""6""",45240,45300
5380,404202,117000,60,44760,2,"""6""",45300,45360
5380,117000,112106,120,44760,2,"""6""",45360,45480
5380,112106,103003,120,44760,2,"""6""",45480,45600
5380,103003,118002,180,44760,2,"""6""",45600,45780
5380,118002,106002,60,44760,2,"""6""",45780,45840
5380,106002,118102,60,44760,2,"""6""",45840,45900
5380,118102,101002,120,44760,2,"""6""",45900,46020
5380,101002,102002,60,44760,2,"""6""",46020,46080
5380,102002,101101,120,44760,2,"""6""",46080,46200
5380,101101,403802,120,44760,2,"""6""",46200,46320
5380,403802,408300,120,44760,2,"""6""",46320,46440
5380,408300,406502,60,44760,2,"""6""",46440,46500
5380,406502,407702,60,44760,2,"""6""",46500,46560
5380,407702,34201,60,44760,2,"""6""",46560,46620
5380,34201,408003,180,44760,2,"""6""",46620,46800
5380,408003,400501,60,44760,2,"""6""",46800,46860
5380,400501,409201,60,44760,2,"""6""",46860,46920
5380,409201,404603,120,44760,2,"""6""",46920,47040
5380,407500,407503,60,45960,2,"""6""",45960,46020
5380,407503,408900,60,45960,2,"""6""",46020,46080
5380,408900,400802,60,45960,2,"""6""",46080,46140
5380,400802,400704,120,45960,2,"""6""",46140,46260
5380,400704,408503,60,45960,2,"""6""",46260,46320
5380,408503,405602,60,45960,2,"""6""",46320,46380
5380,405602,407102,60,45960,2,"""6""",46380,46440
5380,407102,404202,60,45960,2,"""6""",46440,46500
5380,404202,117000,60,45960,2,"""6""",46500,46560
5380,117000,112106,120,45960,2,"""6""",46560,46680
5380,112106,103003,120,45960,2,"""6""",46680,46800
5380,103003,118002,180,45960,2,"""6""",46800,46980
5380,118002,106002,60,45960,2,"""6""",46980,47040
5380,106002,118102,60,45960,2,"""6""",47040,47100
5380,118102,101002,120,45960,2,"""6""",47100,47220
5380,101002,102002,60,45960,2,"""6""",47220,47280
5380,102002,101101,120,45960,2,"""6""",47280,47400
5380,101101,403802,120,45960,2,"""6""",47400,47520
5380,403802,408300,120,45960,2,"""6""",47520,47640
5380,408300,406502,60,45960,2,"""6""",47640,47700
5380,406502,407702,60,45960,2,"""6""",47700,47760
5380,407702,34201,60,45960,2,"""6""",47760,47820
5380,34201,408003,180,45960,2,"""6""",47820,48000
5380,408003,400501,60,45960,2,"""6""",48000,48060
5380,400501,409201,60,45960,2,"""6""",48060,48120
5380,409201,404603,120,45960,2,"""6""",48120,48240
5380,407500,407503,60,47160,2,"""6""",47160,47220
5380,407503,408900,60,47160,2,"""6""",47220,47280
5380,408900,400802,60,47160,2,"""6""",47280,47340
5380,400802,400704,120,47160,2,"""6""",47340,47460
5380,400704,408503,60,47160,2,"""6""",47460,47520
5380,408503,405602,60,47160,2,"""6""",47520,47580
5380,405602,407102,60,47160,2,"""6""",47580,47640
5380,407102,404202,60,47160,2,"""6""",47640,47700
5380,404202,117000,60,47160,2,"""6""",47700,47760
5380,117000,112106,120,47160,2,"""6""",47760,47880
5380,112106,103003,120,47160,2,"""6""",47880,48000
5380,103003,118002,180,47160,2,"""6""",48000,48180
5380,118002,106002,60,47160,2,"""6""",48180,48240
5380,106002,118102,60,47160,2,"""6""",48240,48300
5380,118102,101002,120,47160,2,"""6""",48300,48420
5380,101002,102002,60,47160,2,"""6""",48420,48480
5380,102002,101101,120,47160,2,"""6""",48480,48600
5380,101101,403802,120,47160,2,"""6""",48600,48720
5380,403802,408300,120,47160,2,"""6""",48720,48840
5380,408300,406502,60,47160,2,"""6""",48840,48900
5380,406502,407702,60,47160,2,"""6""",48900,48960
5380,407702,34201,60,47160,2,"""6""",48960,49020
5380,34201,408003,180,47160,2,"""6""",49020,49200
5380,408003,400501,60,47160,2,"""6""",49200,49260
5380,400501,409201,60,47160,2,"""6""",49260,49320
5380,409201,404603,120,47160,2,"""6""",49320,49440
5380,407500,407503,60,48360,2,"""6""",48360,48420
5380,407503,408900,60,48360,2,"""6""",48420,48480
5380,408900,400802,60,48360,2,"""6""",48480,48540
5380,400802,400704,120,48360,2,"""6""",48540,48660
5380,400704,408503,60,48360,2,"""6""",48660,48720
5380,408503,405602,60,48360,2,"""6""",48720,48780
5380,405602,407102,60,48360,2,"""6""",48780,48840
5380,407102,404202,60,48360,2,"""6""",48840,48900
5380,404202,117000,60,48360,2,"""6""",48900,48960
5380,117000,112106,120,48360,2,"""6""",48960,49080
5380,112106,103003,120,48360,2,"""6""",49080,49200
5380,103003,118002,180,48360,2,"""6""",49200,49380
5380,118002,106002,60,48360,2,"""6""",49380,49440
5380,106002,118102,60,48360,2,"""6""",49440,49500
5380,118102,101002,120,48360,2,"""6""",49500,49620
5380,101002,102002,60,48360,2,"""6""",49620,49680
5380,102002,101101,120,48360,2,"""6""",49680,49800
5380,101101,403802,120,48360,2,"""6""",49800,49920
5380,403802,408300,120,48360,2,"""6""",49920,50040
5380,408300,406502,60,48360,2,"""6""",50040,50100
5380,406502,407702,60,48360,2,"""6""",50100,50160
5380,407702,34201,60,48360,2,"""6""",50160,50220
5380,34201,408003,180,48360,2,"""6""",50220,50400
5380,408003,400501,60,48360,2,"""6""",50400,50460
5380,400501,409201,60,48360,2,"""6""",50460,50520
5380,409201,404603,120,48360,2,"""6""",50520,50640
5380,407500,407503,60,49560,2,"""6""",49560,49620
5380,407503,408900,60,49560,2,"""6""",49620,49680
5380,408900,400802,60,49560,2,"""6""",49680,49740
5380,400802,400704,120,49560,2,"""6""",49740,49860
5380,400704,408503,60,49560,2,"""6""",49860,49920
5380,408503,405602,60,49560,2,"""6""",49920,49980
5380,405602,407102,60,49560,2,"""6""",49980,50040
5380,407102,404202,60,49560,2,"""6""",50040,50100
5380,404202,117000,60,49560,2,"""6""",50100,50160
5380,117000,112106,120,49560,2,"""6""",50160,50280
5380,112106,103003,120,49560,2,"""6""",50280,50400
5380,103003,118002,180,49560,2,"""6""",50400,50580
5380,118002,106002,60,49560,2,"""6""",50580,50640
5380,106002,118102,60,49560,2,"""6""",50640,50700
5380,118102,101002,120,49560,2,"""6""",50700,50820
5380,101002,102002,60,49560,2,"""6""",50820,50880
5380,102002,101101,120,49560,2,"""6""",50880,51000
5380,101101,403802,120,49560,2,"""6""",51000,51120
5380,403802,408300,120,49560,2,"""6""",51120,51240
5380,408300,406502,60,49560,2,"""6""",51240,51300
5380,406502,407702,60,49560,2,"""6""",51300,51360
5380,407702,34201,60,49560,2,"""6""",51360,51420
5380,34201,408003,180,49560,2,"""6""",51420,51600
5380,408003,400501,60,49560,2,"""6""",51600,51660
5380,400501,409201,60,49560,2,"""6""",51660,51720
5380,409201,404603,120,49560,2,"""6""",51720,51840
5380,407500,407503,60,50760,2,"""6""",50760,50820
5380,407503,408900,60,50760,2,"""6""",50820,50880
5380,408900,400802,60,50760,2,"""6""",50880,50940
5380,400802,400704,120,50760,2,"""6""",50940,51060
5380,400704,408503,60,50760,2,"""6""",51060,51120
5380,408503,405602,60,50760,2,"""6""",51120,51180
5380,405602,407102,60,50760,2,"""6""",51180,51240
5380,407102,404202,60,50760,2,"""6""",51240,51300
5380,404202,117000,60,50760,2,"""6""",51300,51360
5380,117000,112106,120,50760,2,"""6""",51360,51480
5380,112106,103003,120,50760,2,"""6""",51480,51600
5380,103003,118002,180,50760,2,"""6""",51600,51780
5380,118002,106002,60,50760,2,"""6""",51780,51840
5380,106002,118102,60,50760,2,"""6""",51840,51900
5380,118102,101002,120,50760,2,"""6""",51900,52020
5380,101002,102002,60,50760,2,"""6""",52020,52080
5380,102002,101101,120,50760,2,"""6""",52080,52200
5380,101101,403802,120,50760,2,"""6""",52200,52320
5380,403802,408300,120,50760,2,"""6""",52320,52440
5380,408300,406502,60,50760,2,"""6""",52440,52500
5380,406502,407702,60,50760,2,"""6""",52500,52560
5380,407702,34201,60,50760,2,"""6""",52560,52620
5380,34201,408003,180,50760,2,"""6""",52620,52800
5380,408003,400501,60,50760,2,"""6""",52800,52860
5380,400501,409201,60,50760,2,"""6""",52860,52920
5380,409201,404603,120,50760,2,"""6""",52920,53040
5380,407500,407503,60,51960,2,"""6""",51960,52020
5380,407503,408900,60,51960,2,"""6""",52020,52080
5380,408900,400802,60,51960,2,"""6""",52080,52140
5380,400802,400704,120,51960,2,"""6""",52140,52260
5380,400704,408503,60,51960,2,"""6""",52260,52320
5380,408503,405602,60,51960,2,"""6""",52320,52380
5380,405602,407102,60,51960,2,"""6""",52380,52440
5380,407102,404202,60,51960,2,"""6""",52440,52500
5380,404202,117000,60,51960,2,"""6""",52500,52560
5380,117000,112106,120,51960,2,"""6""",52560,52680
5380,112106,103003,120,51960,2,"""6""",52680,52800
5380,103003,118002,180,51960,2,"""6""",52800,52980
5380,118002,106002,60,51960,2,"""6""",52980,53040
5380,106002,118102,60,51960,2,"""6""",53040,53100
5380,118102,101002,120,51960,2,"""6""",53100,53220
5380,101002,102002,60,51960,2,"""6""",53220,53280
5380,102002,101101,120,51960,2,"""6""",53280,53400
5380,101101,403802,120,51960,2,"""6""",53400,53520
5380,403802,408300,120,51960,2,"""6""",53520,53640
5380,408300,406502,60,51960,2,"""6""",53640,53700
5380,406502,407702,60,51960,2,"""6""",53700,53760
5380,407702,34201,60,51960,2,"""6""",53760,53820
5380,34201,408003,180,51960,2,"""6""",53820,54000
5380,408003,400501,60,51960,2,"""6""",54000,54060
5380,400501,409201,60,51960,2,"""6""",54060,54120
5380,409201,404603,120,51960,2,"""6""",54120,54240
5380,407500,407503,60,53160,2,"""6""",53160,53220
5380,407503,408900,60,53160,2,"""6""",53220,53280
5380,408900,400802,60,53160,2,"""6""",53280,53340
5380,400802,400704,120,53160,2,"""6""",53340,53460
5380,400704,408503,60,53160,2,"""6""",53460,53520
5380,408503,405602,60,53160,2,"""6""",53520,53580
5380,405602,407102,60,53160,2,"""6""",53580,53640
5380,407102,404202,60,53160,2,"""6""",53640,53700
5380,404202,117000,60,53160,2,"""6""",53700,53760
5380,117000,112106,120,53160,2,"""6""",53760,53880
5380,112106,103003,120,53160,2,"""6""",53880,54000
5380,103003,118002,180,53160,2,"""6""",54000,54180
5380,118002,106002,60,53160,2,"""6""",54180,54240
5380,106002,118102,60,53160,2,"""6""",54240,54300
5380,118102,101002,120,53160,2,"""6""",54300,54420
5380,101002,102002,60,53160,2,"""6""",54420,54480
5380,102002,101101,120,53160,2,"""6""",54480,54600
5380,101101,403802,120,53160,2,"""6""",54600,54720
5380,403802,408300,120,53160,2,"""6""",54720,54840
5380,408300,406502,60,53160,2,"""6""",54840,54900
5380,406502,407702,60,53160,2,"""6""",54900,54960
5380,407702,34201,60,53160,2,"""6""",54960,55020
5380,34201,408003,180,53160,2,"""6""",55020,55200
5380,408003,400501,60,53160,2,"""6""",55200,55260
5380,400501,409201,60,53160,2,"""6""",55260,55320
5380,409201,404603,120,53160,2,"""6""",55320,55440
5380,407500,407503,60,54360,2,"""6""",54360,54420
5380,407503,408900,60,54360,2,"""6""",54420,54480
5380,408900,400802,60,54360,2,"""6""",54480,54540
5380,400802,400704,120,54360,2,"""6""",54540,54660
5380,400704,408503,60,54360,2,"""6""",54660,54720
5380,408503,405602,60,54360,2,"""6""",54720,54780
5380,405602,407102,60,54360,2,"""6""",54780,54840
5380,407102,404202,60,54360,2,"""6""",54840,54900
5380,404202,117000,60,54360,2,"""6""",54900,54960
5380,117000,112106,120,54360,2,"""6""",54960,55080
5380,112106,103003,120,54360,2,"""6""",55080,55200
5380,103003,118002,180,54360,2,"""6""",55200,55380
5380,118002,106002,60,54360,2,"""6""",55380,55440
5380,106002,118102,60,54360,2,"""6""",55440,55500
5380,118102,101002,120,54360,2,"""6""",55500,55620
5380,101002,102002,60,54360,2,"""6""",55620,55680
5380,102002,101101,120,54360,2,"""6""",55680,55800
5380,101101,403802,120,54360,2,"""6""",55800,55920
5380,403802,408300,120,54360,2,"""6""",55920,56040
5380,408300,406502,60,54360,2,"""6""",56040,56100
5380,406502,407702,60,54360,2,"""6""",56100,56160
5380,407702,34201,60,54360,2,"""6""",56160,56220
5380,34201,408003,180,54360,2,"""6""",56220,56400
5380,408003,400501,60,54360,2,"""6""",56400,56460
5380,400501,409201,60,54360,2,"""6""",56460,56520
5380,409201,404603,120,54360,2,"""6""",56520,56640
5380,407500,407503,60,55560,2,"""6""",55560,55620
5380,407503,408900,60,55560,2,"""6""",55620,55680
5380,408900,400802,60,55560,2,"""6""",55680,55740
5380,400802,400704,120,55560,2,"""6""",55740,55860
5380,400704,408503,60,55560,2,"""6""",55860,55920
5380,408503,405602,60,55560,2,"""6""",55920,55980
5380,405602,407102,60,55560,2,"""6""",55980,56040
5380,407102,404202,60,55560,2,"""6""",56040,56100
5380,404202,117000,60,55560,2,"""6""",56100,56160
5380,117000,112106,120,55560,2,"""6""",56160,56280
5380,112106,103003,120,55560,2,"""6""",56280,56400
5380,103003,118002,180,55560,2,"""6""",56400,56580
5380,118002,106002,60,55560,2,"""6""",56580,56640
5380,106002,118102,60,55560,2,"""6""",56640,56700
5380,118102,101002,120,55560,2,"""6""",56700,56820
5380,101002,102002,60,55560,2,"""6""",56820,56880
5380,102002,101101,120,55560,2,"""6""",56880,57000
5380,101101,403802,120,55560,2,"""6""",57000,57120
5380,403802,408300,120,55560,2,"""6""",57120,57240
5380,408300,406502,60,55560,2,"""6""",57240,57300
5380,406502,407702,60,55560,2,"""6""",57300,57360
5380,407702,34201,60,55560,2,"""6""",57360,57420
5380,34201,408003,180,55560,2,"""6""",57420,57600
5380,408003,400501,60,55560,2,"""6""",57600,57660
5380,400501,409201,60,55560,2,"""6""",57660,57720
5380,409201,404603,120,55560,2,"""6""",57720,57840
5380,407500,407503,60,56760,2,"""6""",56760,56820
5380,407503,408900,60,56760,2,"""6""",56820,56880
5380,408900,400802,60,56760,2,"""6""",56880,56940
5380,400802,400704,120,56760,2,"""6""",56940,57060
5380,400704,408503,60,56760,2,"""6""",57060,57120
5380,408503,405602,60,56760,2,"""6""",57120,57180
5380,405602,407102,60,56760,2,"""6""",57180,57240
5380,407102,404202,60,56760,2,"""6""",57240,57300
5380,404202,117000,60,56760,2,"""6""",57300,57360
5380,117000,112106,120,56760,2,"""6""",57360,57480
5380,112106,103003,120,56760,2,"""6""",57480,57600
5380,103003,118002,180,56760,2,"""6""",57600,57780
5380,118002,106002,60,56760,2,"""6""",57780,57840
5380,106002,118102,60,56760,2,"""6""",57840,57900
5380,118102,101002,120,56760,2,"""6""",57900,58020
5380,101002,102002,60,56760,2,"""6""",58020,58080
5380,102002,101101,120,56760,2,"""6""",58080,58200
5380,101101,403802,120,56760,2,"""6""",58200,58320
5380,403802,408300,120,56760,2,"""6""",58320,58440
5380,408300,406502,60,56760,2,"""6""",58440,58500
5380,406502,407702,60,56760,2,"""6""",58500,58560
5380,407702,34201,60,56760,2,"""6""",58560,58620
5380,34201,408003,180,56760,2,"""6""",58620,58800
5380,408003,400501,60,56760,2,"""6""",58800,58860
5380,400501,409201,60,56760,2,"""6""",58860,58920
5380,409201,404603,120,56760,2,"""6""",58920,59040
5380,407500,407503,60,57960,2,"""6""",57960,58020
5380,407503,408900,60,57960,2,"""6""",58020,58080
5380,408900,400802,60,57960,2,"""6""",58080,58140
5380,400802,400704,120,57960,2,"""6""",58140,58260
5380,400704,408503,60,57960,2,"""6""",58260,58320
5380,408503,405602,60,57960,2,"""6""",58320,58380
5380,405602,407102,60,57960,2,"""6""",58380,58440
5380,407102,404202,60,57960,2,"""6""",58440,58500
5380,404202,117000,60,57960,2,"""6""",58500,58560
5380,117000,112106,120,57960,2,"""6""",58560,58680
5380,112106,103003,120,57960,2,"""6""",58680,58800
5380,103003,118002,180,57960,2,"""6""",58800,58980
5380,118002,106002,60,57960,2,"""6""",58980,59040
5380,106002,118102,60,57960,2,"""6""",59040,59100
5380,118102,101002,120,57960,2,"""6""",59100,59220
5380,101002,102002,60,57960,2,"""6""",59220,59280
5380,102002,101101,120,57960,2,"""6""",59280,59400
5380,101101,403802,120,57960,2,"""6""",59400,59520
5380,403802,408300,120,57960,2,"""6""",59520,59640
5380,408300,406502,60,57960,2,"""6""",59640,59700
5380,406502,407702,60,57960,2,"""6""",59700,59760
5380,407702,34201,60,57960,2,"""6""",59760,59820
5380,34201,408003,180,57960,2,"""6""",59820,60000
5380,408003,400501,60,57960,2,"""6""",60000,60060
5380,400501,409201,60,57960,2,"""6""",60060,60120
5380,409201,404603,120,57960,2,"""6""",60120,60240
5380,407500,407503,60,59160,2,"""6""",59160,59220
5380,407503,408900,60,59160,2,"""6""",59220,59280
5380,408900,400802,60,59160,2,"""6""",59280,59340
5380,400802,400704,120,59160,2,"""6""",59340,59460
5380,400704,408503,60,59160,2,"""6""",59460,59520
5380,408503,405602,60,59160,2,"""6""",59520,59580
5380,405602,407102,60,59160,2,"""6""",59580,59640
5380,407102,404202,60,59160,2,"""6""",59640,59700
5380,404202,117000,60,59160,2,"""6""",59700,59760
5380,117000,112106,120,59160,2,"""6""",59760,59880
5380,112106,103003,120,59160,2,"""6""",59880,60000
5380,103003,118002,180,59160,2,"""6""",60000,60180
5380,118002,106002,60,59160,2,"""6""",60180,60240
5380,106002,118102,60,59160,2,"""6""",60240,60300
5380,118102,101002,120,59160,2,"""6""",60300,60420
5380,101002,102002,60,59160,2,"""6""",60420,60480
5380,102002,101101,120,59160,2,"""6""",60480,60600
5380,101101,403802,120,59160,2,"""6""",60600,60720
5380,403802,408300,120,59160,2,"""6""",60720,60840
5380,408300,406502,60,59160,2,"""6""",60840,60900
5380,406502,407702,60,59160,2,"""6""",60900,60960
5380,407702,34201,60,59160,2,"""6""",60960,61020
5380,34201,408003,180,59160,2,"""6""",61020,61200
5380,408003,400501,60,59160,2,"""6""",61200,61260
5380,400501,409201,60,59160,2,"""6""",61260,61320
5380,409201,404603,120,59160,2,"""6""",61320,61440
5380,407500,407503,60,60360,2,"""6""",60360,60420
5380,407503,408900,60,60360,2,"""6""",60420,60480
5380,408900,400802,60,60360,2,"""6""",60480,60540
5380,400802,400704,120,60360,2,"""6""",60540,60660
5380,400704,408503,60,60360,2,"""6""",60660,60720
5380,408503,405602,60,60360,2,"""6""",60720,60780
5380,405602,407102,60,60360,2,"""6""",60780,60840
5380,407102,404202,60,60360,2,"""6""",60840,60900
5380,404202,117000,60,60360,2,"""6""",60900,60960
5380,117000,112106,120,60360,2,"""6""",60960,61080
5380,112106,103003,120,60360,2,"""6""",61080,61200
5380,103003,118002,180,60360,2,"""6""",61200,61380
5380,118002,106002,60,60360,2,"""6""",61380,61440
5380,106002,118102,60,60360,2,"""6""",61440,61500
5380,118102,101002,120,60360,2,"""6""",61500,61620
5380,101002,102002,60,60360,2,"""6""",61620,61680
5380,102002,101101,120,60360,2,"""6""",61680,61800
5380,101101,403802,120,60360,2,"""6""",61800,61920
5380,403802,408300,120,60360,2,"""6""",61920,62040
5380,408300,406502,60,60360,2,"""6""",62040,62100
5380,406502,407702,60,60360,2,"""6""",62100,62160
5380,407702,34201,60,60360,2,"""6""",62160,62220
5380,34201,408003,180,60360,2,"""6""",62220,62400
5380,408003,400501,60,60360,2,"""6""",62400,62460
5380,400501,409201,60,60360,2,"""6""",62460,62520
5380,409201,404603,120,60360,2,"""6""",62520,62640
5380,407500,407503,60,61560,2,"""6""",61560,61620
5380,407503,408900,60,61560,2,"""6""",61620,61680
5380,408900,400802,60,61560,2,"""6""",61680,61740
5380,400802,400704,120,61560,2,"""6""",61740,61860
5380,400704,408503,60,61560,2,"""6""",61860,61920
5380,408503,405602,60,61560,2,"""6""",61920,61980
5380,405602,407102,60,61560,2,"""6""",61980,62040
5380,407102,404202,60,61560,2,"""6""",62040,62100
5380,404202,117000,60,61560,2,"""6""",62100,62160
5380,117000,112106,120,61560,2,"""6""",62160,62280
5380,112106,103003,120,61560,2,"""6""",62280,62400
5380,103003,118002,180,61560,2,"""6""",62400,62580
5380,118002,106002,60,61560,2,"""6""",62580,62640
5380,106002,118102,60,61560,2,"""6""",62640,62700
5380,118102,101002,120,61560,2,"""6""",62700,62820
5380,101002,102002,60,61560,2,"""6""",62820,62880
5380,102002,101101,120,61560,2,"""6""",62880,63000
5380,101101,403802,120,61560,2,"""6""",63000,63120
5380,403802,408300,120,61560,2,"""6""",63120,63240
5380,408300,406502,60,61560,2,"""6""",63240,63300
5380,406502,407702,60,61560,2,"""6""",63300,63360
5380,407702,34201,60,61560,2,"""6""",63360,63420
5380,34201,408003,180,61560,2,"""6""",63420,63600
5380,408003,400501,60,61560,2,"""6""",63600,63660
5380,400501,409201,60,61560,2,"""6""",63660,63720
5380,409201,404603,120,61560,2,"""6""",63720,63840
5380,407500,407503,60,62760,2,"""6""",62760,62820
5380,407503,408900,60,62760,2,"""6""",62820,62880
5380,408900,400802,60,62760,2,"""6""",62880,62940
5380,400802,400704,120,62760,2,"""6""",62940,63060
5380,400704,408503,60,62760,2,"""6""",63060,63120
5380,408503,405602,60,62760,2,"""6""",63120,63180
5380,405602,407102,60,62760,2,"""6""",63180,63240
5380,407102,404202,60,62760,2,"""6""",63240,63300
5380,404202,117000,60,62760,2,"""6""",63300,63360
5380,117000,112106,120,62760,2,"""6""",63360,63480
5380,112106,103003,120,62760,2,"""6""",63480,63600
5380,103003,118002,180,62760,2,"""6""",63600,63780
5380,118002,106002,60,62760,2,"""6""",63780,63840
5380,106002,118102,60,62760,2,"""6""",63840,63900
5380,118102,101002,120,62760,2,"""6""",63900,64020
5380,101002,102002,60,62760,2,"""6""",64020,64080
5380,102002,101101,120,62760,2,"""6""",64080,64200
5380,101101,403802,120,62760,2,"""6""",64200,64320
5380,403802,408300,120,62760,2,"""6""",64320,64440
5380,408300,406502,60,62760,2,"""6""",64440,64500
5380,406502,407702,60,62760,2,"""6""",64500,64560
5380,407702,34201,60,62760,2,"""6""",64560,64620
5380,34201,408003,180,62760,2,"""6""",64620,64800
5380,408003,400501,60,62760,2,"""6""",64800,64860
5380,400501,409201,60,62760,2,"""6""",64860,64920
5380,409201,404603,120,62760,2,"""6""",64920,65040
5380,407500,407503,60,63960,2,"""6""",63960,64020
5380,407503,408900,60,63960,2,"""6""",64020,64080
5380,408900,400802,60,63960,2,"""6""",64080,64140
5380,400802,400704,120,63960,2,"""6""",64140,64260
5380,400704,408503,60,63960,2,"""6""",64260,64320
5380,408503,405602,60,63960,2,"""6""",64320,64380
5380,405602,407102,60,63960,2,"""6""",64380,64440
5380,407102,404202,60,63960,2,"""6""",64440,64500
5380,404202,117000,60,63960,2,"""6""",64500,64560
5380,117000,112106,120,63960,2,"""6""",64560,64680
5380,112106,103003,120,63960,2,"""6""",64680,64800
5380,103003,118002,180,63960,2,"""6""",64800,64980
5380,118002,106002,60,63960,2,"""6""",64980,65040
5380,106002,118102,60,63960,2,"""6""",65040,65100
5380,118102,101002,120,63960,2,"""6""",65100,65220
5380,101002,102002,60,63960,2,"""6""",65220,65280
5380,102002,101101,120,63960,2,"""6""",65280,65400
5380,101101,403802,120,63960,2,"""6""",65400,65520
5380,403802,408300,120,63960,2,"""6""",65520,65640
5380,408300,406502,60,63960,2,"""6""",65640,65700
5380,406502,407702,60,63960,2,"""6""",65700,65760
5380,407702,34201,60,63960,2,"""6""",65760,65820
5380,34201,408003,180,63960,2,"""6""",65820,66000
5380,408003,400501,60,63960,2,"""6""",66000,66060
5380,400501,409201,60,63960,2,"""6""",66060,66120
5380,409201,404603,120,63960,2,"""6""",66120,66240
5380,407500,407503,60,65160,2,"""6""",65160,65220
5380,407503,408900,60,65160,2,"""6""",65220,65280
5380,408900,400802,60,65160,2,"""6""",65280,65340
5380,400802,400704,120,65160,2,"""6""",65340,65460
5380,400704,408503,60,65160,2,"""6""",65460,65520
5380,408503,405602,60,65160,2,"""6""",65520,65580
5380,405602,407102,60,65160,2,"""6""",65580,65640
5380,407102,404202,60,65160,2,"""6""",65640,65700
5380,404202,117000,60,65160,2,"""6""",65700,65760
5380,117000,112106,120,65160,2,"""6""",65760,65880
5380,112106,103003,120,65160,2,"""6""",65880,66000
5380,103003,118002,180,65160,2,"""6""",66000,66180
5380,118002,106002,60,65160,2,"""6""",66180,66240
5380,106002,118102,60,65160,2,"""6""",66240,66300
5380,118102,101002,120,65160,2,"""6""",66300,66420
5380,101002,102002,60,65160,2,"""6""",66420,66480
5380,102002,101101,120,65160,2,"""6""",66480,66600
5380,101101,403802,120,65160,2,"""6""",66600,66720
5380,403802,408300,120,65160,2,"""6""",66720,66840
5380,408300,406502,60,65160,2,"""6""",66840,66900
5380,406502,407702,60,65160,2,"""6""",66900,66960
5380,407702,34201,60,65160,2,"""6""",66960,67020
5380,34201,408003,180,65160,2,"""6""",67020,67200
5380,408003,400501,60,65160,2,"""6""",67200,67260
5380,400501,409201,60,65160,2,"""6""",67260,67320
5380,409201,404603,120,65160,2,"""6""",67320,67440
5380,407500,407503,60,66360,2,"""6""",66360,66420
5380,407503,408900,60,66360,2,"""6""",66420,66480
5380,408900,400802,60,66360,2,"""6""",66480,66540
5380,400802,400704,120,66360,2,"""6""",66540,66660
5380,400704,408503,60,66360,2,"""6""",66660,66720
5380,408503,405602,60,66360,2,"""6""",66720,66780
5380,405602,407102,60,66360,2,"""6""",66780,66840
5380,407102,404202,60,66360,2,"""6""",66840,66900
5380,404202,117000,60,66360,2,"""6""",66900,66960
5380,117000,112106,120,66360,2,"""6""",66960,67080
5380,112106,103003,120,66360,2,"""6""",67080,67200
5380,103003,118002,180,66360,2,"""6""",67200,67380
5380,118002,106002,60,66360,2,"""6""",67380,67440
5380,106002,118102,60,66360,2,"""6""",67440,67500
5380,118102,101002,120,66360,2,"""6""",67500,67620
5380,101002,102002,60,66360,2,"""6""",67620,67680
5380,102002,101101,120,66360,2,"""6""",67680,67800
5380,101101,403802,120,66360,2,"""6""",67800,67920
5380,403802,408300,120,66360,2,"""6""",67920,68040
5380,408300,406502,60,66360,2,"""6""",68040,68100
5380,406502,407702,60,66360,2,"""6""",68100,68160
5380,407702,34201,60,66360,2,"""6""",68160,68220
5380,34201,408003,180,66360,2,"""6""",68220,68400
5380,408003,400501,60,66360,2,"""6""",68400,68460
5380,400501,409201,60,66360,2,"""6""",68460,68520
5380,409201,404603,120,66360,2,"""6""",68520,68640
5380,407500,407503,60,67560,2,"""6""",67560,67620
5380,407503,408900,60,67560,2,"""6""",67620,67680
5380,408900,400802,60,67560,2,"""6""",67680,67740
5380,400802,400704,120,67560,2,"""6""",67740,67860
5380,400704,408503,60,67560,2,"""6""",67860,67920
5380,408503,405602,60,67560,2,"""6""",67920,67980
5380,405602,407102,60,67560,2,"""6""",67980,68040
5380,407102,404202,60,67560,2,"""6""",68040,68100
5380,404202,117000,60,67560,2,"""6""",68100,68160
5380,117000,112106,120,67560,2,"""6""",68160,68280
5380,112106,103003,120,67560,2,"""6""",68280,68400
5380,103003,118002,180,67560,2,"""6""",68400,68580
5380,118002,106002,60,67560,2,"""6""",68580,68640
5380,106002,118102,60,67560,2,"""6""",68640,68700
5380,118102,101002,120,67560,2,"""6""",68700,68820
5380,101002,102002,60,67560,2,"""6""",68820,68880
5380,102002,101101,120,67560,2,"""6""",68880,69000
5380,101101,403802,120,67560,2,"""6""",69000,69120
5380,403802,408300,120,67560,2,"""6""",69120,69240
5380,408300,406502,60,67560,2,"""6""",69240,69300
5380,406502,407702,60,67560,2,"""6""",69300,69360
5380,407702,34201,60,67560,2,"""6""",69360,69420
5380,34201,408003,180,67560,2,"""6""",69420,69600
5380,408003,400501,60,67560,2,"""6""",69600,69660
5380,400501,409201,60,67560,2,"""6""",69660,69720
5380,409201,404603,120,67560,2,"""6""",69720,69840
5381,407500,407503,60,21960,2,"""4""",21960,22020
5381,407503,408900,60,21960,2,"""4""",22020,22080
5381,408900,400802,60,21960,2,"""4""",22080,22140
5381,400802,400704,120,21960,2,"""4""",22140,22260
5381,400704,408503,60,21960,2,"""4""",22260,22320
5381,408503,405602,60,21960,2,"""4""",22320,22380
5381,405602,407102,60,21960,2,"""4""",22380,22440
5381,407102,404202,60,21960,2,"""4""",22440,22500
5381,404202,117000,60,21960,2,"""4""",22500,22560
5381,117000,112106,120,21960,2,"""4""",22560,22680
5381,112106,103003,120,21960,2,"""4""",22680,22800
5381,103003,118002,180,21960,2,"""4""",22800,22980
5381,118002,106002,60,21960,2,"""4""",22980,23040
5381,106002,118102,60,21960,2,"""4""",23040,23100
5381,118102,101002,120,21960,2,"""4""",23100,23220
5381,101002,102002,60,21960,2,"""4""",23220,23280
5381,102002,101101,120,21960,2,"""4""",23280,23400
5381,101101,403802,120,21960,2,"""4""",23400,23520
5381,403802,408300,120,21960,2,"""4""",23520,23640
5381,408300,406502,60,21960,2,"""4""",23640,23700
5381,406502,407702,60,21960,2,"""4""",23700,23760
5381,407702,408403,60,21960,2,"""4""",23760,23820
5381,408403,403502,60,21960,2,"""4""",23820,23880
5381,403502,403701,60,21960,2,"""4""",23880,23940
5381,403701,404601,60,21960,2,"""4""",23940,24000
5381,407500,407503,60,23160,2,"""4""",23160,23220
5381,407503,408900,60,23160,2,"""4""",23220,23280
5381,408900,400802,60,23160,2,"""4""",23280,23340
5381,400802,400704,120,23160,2,"""4""",23340,23460
5381,400704,408503,60,23160,2,"""4""",23460,23520
5381,408503,405602,60,23160,2,"""4""",23520,23580
5381,405602,407102,60,23160,2,"""4""",23580,23640
5381,407102,404202,60,23160,2,"""4""",23640,23700
5381,404202,117000,60,23160,2,"""4""",23700,23760
5381,117000,112106,120,23160,2,"""4""",23760,23880
5381,112106,103003,120,23160,2,"""4""",23880,24000
5381,103003,118002,180,23160,2,"""4""",24000,24180
5381,118002,106002,60,23160,2,"""4""",24180,24240
5381,106002,118102,60,23160,2,"""4""",24240,24300
5381,118102,101002,120,23160,2,"""4""",24300,24420
5381,101002,102002,60,23160,2,"""4""",24420,24480
5381,102002,101101,120,23160,2,"""4""",24480,24600
5381,101101,403802,120,23160,2,"""4""",24600,24720
5381,403802,408300,120,23160,2,"""4""",24720,24840
5381,408300,406502,60,23160,2,"""4""",24840,24900
5381,406502,407702,60,23160,2,"""4""",24900,24960
5381,407702,408403,60,23160,2,"""4""",24960,25020
5381,408403,403502,60,23160,2,"""4""",25020,25080
5381,403502,403701,60,23160,2,"""4""",25080,25140
5381,403701,404601,60,23160,2,"""4""",25140,25200
5382,407500,407503,60,18960,2,"""4""",18960,19020
5382,407503,408900,60,18960,2,"""4""",19020,19080
5382,408900,400802,60,18960,2,"""4""",19080,19140
5382,400802,400704,120,18960,2,"""4""",19140,19260
5382,400704,408503,60,18960,2,"""4""",19260,19320
5382,408503,405602,60,18960,2,"""4""",19320,19380
5382,405602,407102,60,18960,2,"""4""",19380,19440
5382,407102,404202,60,18960,2,"""4""",19440,19500
5382,404202,117000,60,18960,2,"""4""",19500,19560
5382,117000,112106,120,18960,2,"""4""",19560,19680
5382,112106,103003,120,18960,2,"""4""",19680,19800
5382,103003,118002,120,18960,2,"""4""",19800,19920
5382,118002,106002,60,18960,2,"""4""",19920,19980
5382,106002,118102,60,18960,2,"""4""",19980,20040
5382,118102,101002,120,18960,2,"""4""",20040,20160
5382,101002,102002,60,18960,2,"""4""",20160,20220
5382,102002,101101,120,18960,2,"""4""",20220,20340
5382,101101,403802,60,18960,2,"""4""",20340,20400
5382,403802,408300,60,18960,2,"""4""",20400,20460
5382,408300,406502,60,18960,2,"""4""",20460,20520
5382,406502,407702,60,18960,2,"""4""",20520,20580
5382,407702,408403,60,18960,2,"""4""",20580,20640
5382,408403,403502,60,18960,2,"""4""",20640,20700
5382,403502,403701,60,18960,2,"""4""",20700,20760
5382,403701,404601,60,18960,2,"""4""",20760,20820
5382,407500,407503,60,20880,2,"""4""",20880,20940
5382,407503,408900,60,20880,2,"""4""",20940,21000
5382,408900,400802,60,20880,2,"""4""",21000,21060
5382,400802,400704,120,20880,2,"""4""",21060,21180
5382,400704,408503,60,20880,2,"""4""",21180,21240
5382,408503,405602,60,20880,2,"""4""",21240,21300
5382,405602,407102,60,20880,2,"""4""",21300,21360
5382,407102,404202,60,20880,2,"""4""",21360,21420
5382,404202,117000,60,20880,2,"""4""",21420,21480
5382,117000,112106,120,20880,2,"""4""",21480,21600
5382,112106,103003,120,20880,2,"""4""",21600,21720
5382,103003,118002,120,20880,2,"""4""",21720,21840
5382,118002,106002,60,20880,2,"""4""",21840,21900
5382,106002,118102,60,20880,2,"""4""",21900,21960
5382,118102,101002,120,20880,2,"""4""",21960,22080
5382,101002,102002,60,20880,2,"""4""",22080,22140
5382,102002,101101,120,20880,2,"""4""",22140,22260
5382,101101,403802,60,20880,2,"""4""",22260,22320
5382,403802,408300,60,20880,2,"""4""",22320,22380
5382,408300,406502,60,20880,2,"""4""",22380,22440
5382,406502,407702,60,20880,2,"""4""",22440,22500
5382,407702,408403,60,20880,2,"""4""",22500,22560
5382,408403,403502,60,20880,2,"""4""",22560,22620
5382,403502,403701,60,20880,2,"""4""",22620,22680
5382,403701,404601,60,20880,2,"""4""",22680,22740
5401,208103,409301,600,27900,3,"""76""",27900,28500
5424,409301,408002,360,47220,4,"""92""",47220,47580
5424,408002,34202,120,47220,4,"""92""",47580,47700
5424,34202,407701,60,47220,4,"""92""",47700,47760
5424,407701,406501,60,47220,4,"""92""",47760,47820
5424,406501,405901,60,47220,4,"""92""",47820,47880
5424,405901,405101,60,47220,4,"""92""",47880,47940
5424,405101,402203,120,47220,4,"""92""",47940,48060
5424,402203,500701,60,47220,4,"""92""",48060,48120
5424,500701,402001,60,47220,4,"""92""",48120,48180
5424,402001,400401,120,47220,4,"""92""",48180,48300
5424,400401,501702,120,47220,4,"""92""",48300,48420
5424,501702,501801,120,47220,4,"""92""",48420,48540
5424,501801,501601,60,47220,4,"""92""",48540,48600
5424,501601,500903,120,47220,4,"""92""",48600,48720
5424,500903,502801,60,47220,4,"""92""",48720,48780
5424,502801,101001,180,47220,4,"""92""",48780,48960
5424,101001,118101,60,47220,4,"""92""",48960,49020
5424,118101,106001,60,47220,4,"""92""",49020,49080
5424,106001,118001,120,47220,4,"""92""",49080,49200
5424,118001,105001,180,47220,4,"""92""",49200,49380
5424,105001,34103,60,47220,4,"""92""",49380,49440
5424,34103,208102,120,47220,4,"""92""",49440,49560
5424,208102,201502,120,47220,4,"""92""",49560,49680
5424,201502,203903,60,47220,4,"""92""",49680,49740
5424,203903,201902,60,47220,4,"""92""",49740,49800
5424,201902,203601,60,47220,4,"""92""",49800,49860
5424,203601,204102,120,47220,4,"""92""",49860,49980
5424,204102,202001,120,47220,4,"""92""",49980,50100
5424,202001,200900,120,47220,4,"""92""",50100,50220
5425,408002,34202,120,25980,4,"""1""",25980,26100
5425,34202,407701,60,25980,4,"""1""",26100,26160
5425,407701,406501,60,25980,4,"""1""",26160,26220
5425,406501,405901,60,25980,4,"""1""",26220,26280
5425,405901,405101,60,25980,4,"""1""",26280,26340
5425,405101,402203,120,25980,4,"""1""",26340,26460
5425,402203,500701,60,25980,4,"""1""",26460,26520
5425,500701,402001,60,25980,4,"""1""",26520,26580
5425,402001,400401,120,25980,4,"""1""",26580,26700
5425,400401,501702,120,25980,4,"""1""",26700,26820
5425,501702,501801,120,25980,4,"""1""",26820,26940
5425,501801,501601,60,25980,4,"""1""",26940,27000
5425,501601,500903,120,25980,4,"""1""",27000,27120
5425,500903,502801,60,25980,4,"""1""",27120,27180
5425,502801,101001,180,25980,4,"""1""",27180,27360
5425,101001,118101,60,25980,4,"""1""",27360,27420
5425,118101,106001,60,25980,4,"""1""",27420,27480
5425,106001,118001,120,25980,4,"""1""",27480,27600
5425,118001,105001,180,25980,4,"""1""",27600,27780
5425,105001,34103,60,25980,4,"""1""",27780,27840
5425,34103,208102,120,25980,4,"""1""",27840,27960
5425,208102,201502,120,25980,4,"""1""",27960,28080
5425,201502,203903,60,25980,4,"""1""",28080,28140
5425,203903,201902,60,25980,4,"""1""",28140,28200
5425,201902,203601,60,25980,4,"""1""",28200,28260
5425,203601,204102,120,25980,4,"""1""",28260,28380
5425,204102,202001,120,25980,4,"""1""",28380,28500
5425,202001,200900,120,25980,4,"""1""",28500,28620
5425,408002,34202,120,27180,4,"""1""",27180,27300
5425,34202,407701,60,27180,4,"""1""",27300,27360
5425,407701,406501,60,27180,4,"""1""",27360,27420
5425,406501,405901,60,27180,4,"""1""",27420,27480
5425,405901,405101,60,27180,4,"""1""",27480,27540
5425,405101,402203,120,27180,4,"""1""",27540,27660
5425,402203,500701,60,27180,4,"""1""",27660,27720
5425,500701,402001,60,27180,4,"""1""",27720,27780
5425,402001,400401,120,27180,4,"""1""",27780,27900
5425,400401,501702,120,27180,4,"""1""",27900,28020
5425,501702,501801,120,27180,4,"""1""",28020,28140
5425,501801,501601,60,27180,4,"""1""",28140,28200
5425,501601,500903,120,27180,4,"""1""",28200,28320
5425,500903,502801,60,27180,4,"""1""",28320,28380
5425,502801,101001,180,27180,4,"""1""",28380,28560
5425,101001,118101,60,27180,4,"""1""",28560,28620
5425,118101,106001,60,27180,4,"""1""",28620,28680
5425,106001,118001,120,27180,4,"""1""",28680,28800
5425,118001,105001,180,27180,4,"""1""",28800,28980
5425,105001,34103,60,27180,4,"""1""",28980,29040
5425,34103,208102,120,27180,4,"""1""",29040,29160
5425,208102,201502,120,27180,4,"""1""",29160,29280
5425,201502,203903,60,27180,4,"""1""",29280,29340
5425,203903,201902,60,27180,4,"""1""",29340,29400
5425,201902,203601,60,27180,4,"""1""",29400,29460
5425,203601,204102,120,27180,4,"""1""",29460,29580
5425,204102,202001,120,27180,4,"""1""",29580,29700
5425,202001,200900,120,27180,4,"""1""",29700,29820
5425,408002,34202,120,28380,4,"""1""",28380,28500
5425,34202,407701,60,28380,4,"""1""",28500,28560
5425,407701,406501,60,28380,4,"""1""",28560,28620
5425,406501,405901,60,28380,4,"""1""",28620,28680
5425,405901,405101,60,28380,4,"""1""",28680,28740
5425,405101,402203,120,28380,4,"""1""",28740,28860
5425,402203,500701,60,28380,4,"""1""",28860,28920
5425,500701,402001,60,28380,4,"""1""",28920,28980
5425,402001,400401,120,28380,4,"""1""",28980,29100
5425,400401,501702,120,28380,4,"""1""",29100,29220
5425,501702,501801,120,28380,4,"""1""",29220,29340
5425,501801,501601,60,28380,4,"""1""",29340,29400
5425,501601,500903,120,28380,4,"""1""",29400,29520
5425,500903,502801,60,28380,4,"""1""",29520,29580
5425,502801,101001,180,28380,4,"""1""",29580,29760
5425,101001,118101,60,28380,4,"""1""",29760,29820
5425,118101,106001,60,28380,4,"""1""",29820,29880
5425,106001,118001,120,28380,4,"""1""",29880,30000
5425,118001,105001,180,28380,4,"""1""",30000,30180
5425,105001,34103,60,28380,4,"""1""",30180,30240
5425,34103,208102,120,28380,4,"""1""",30240,30360
5425,208102,201502,120,28380,4,"""1""",30360,30480
5425,201502,203903,60,28380,4,"""1""",30480,30540
5425,203903,201902,60,28380,4,"""1""",30540,30600
5425,201902,203601,60,28380,4,"""1""",30600,30660
5425,203601,204102,120,28380,4,"""1""",30660,30780
5425,204102,202001,120,28380,4,"""1""",30780,30900
5425,202001,200900,120,28380,4,"""1""",30900,31020
5425,408002,34202,120,29580,4,"""1""",29580,29700
5425,34202,407701,60,29580,4,"""1""",29700,29760
5425,407701,406501,60,29580,4,"""1""",29760,29820
5425,406501,405901,60,29580,4,"""1""",29820,29880
5425,405901,405101,60,29580,4,"""1""",29880,29940
5425,405101,402203,120,29580,4,"""1""",29940,30060
5425,402203,500701,60,29580,4,"""1""",30060,30120
5425,500701,402001,60,29580,4,"""1""",30120,30180
5425,402001,400401,120,29580,4,"""1""",30180,30300
5425,400401,501702,120,29580,4,"""1""",30300,30420
5425,501702,501801,120,29580,4,"""1""",30420,30540
5425,501801,501601,60,29580,4,"""1""",30540,30600
5425,501601,500903,120,29580,4,"""1""",30600,30720
5425,500903,502801,60,29580,4,"""1""",30720,30780
5425,502801,101001,180,29580,4,"""1""",30780,30960
5425,101001,118101,60,29580,4,"""1""",30960,31020
5425,118101,106001,60,29580,4,"""1""",31020,31080
5425,106001,118001,120,29580,4,"""1""",31080,31200
5425,118001,105001,180,29580,4,"""1""",31200,31380
5425,105001,34103,60,29580,4,"""1""",31380,31440
5425,34103,208102,120,29580,4,"""1""",31440,31560
5425,208102,201502,120,29580,4,"""1""",31560,31680
5425,201502,203903,60,29580,4,"""1""",31680,31740
5425,203903,201902,60,29580,4,"""1""",31740,31800
5425,201902,203601,60,29580,4,"""1""",31800,31860
5425,203601,204102,120,29580,4,"""1""",31860,31980
5425,204102,202001,120,29580,4,"""1""",31980,32100
5425,202001,200900,120,29580,4,"""1""",32100,32220
5425,408002,34202,120,30780,4,"""1""",30780,30900
5425,34202,407701,60,30780,4,"""1""",30900,30960
5425,407701,406501,60,30780,4,"""1""",30960,31020
5425,406501,405901,60,30780,4,"""1""",31020,31080
5425,405901,405101,60,30780,4,"""1""",31080,31140
5425,405101,402203,120,30780,4,"""1""",31140,31260
5425,402203,500701,60,30780,4,"""1""",31260,31320
5425,500701,402001,60,30780,4,"""1""",31320,31380
5425,402001,400401,120,30780,4,"""1""",31380,31500
5425,400401,501702,120,30780,4,"""1""",31500,31620
5425,501702,501801,120,30780,4,"""1""",31620,31740
5425,501801,501601,60,30780,4,"""1""",31740,31800
5425,501601,500903,120,30780,4,"""1""",31800,31920
5425,500903,502801,60,30780,4,"""1""",31920,31980
5425,502801,101001,180,30780,4,"""1""",31980,32160
5425,101001,118101,60,30780,4,"""1""",32160,32220
5425,118101,106001,60,30780,4,"""1""",32220,32280
5425,106001,118001,120,30780,4,"""1""",32280,32400
5425,118001,105001,180,30780,4,"""1""",32400,32580
5425,105001,34103,60,30780,4,"""1""",32580,32640
5425,34103,208102,120,30780,4,"""1""",32640,32760
5425,208102,201502,120,30780,4,"""1""",32760,32880
5425,201502,203903,60,30780,4,"""1""",32880,32940
5425,203903,201902,60,30780,4,"""1""",32940,33000
5425,201902,203601,60,30780,4,"""1""",33000,33060
5425,203601,204102,120,30780,4,"""1""",33060,33180
5425,204102,202001,120,30780,4,"""1""",33180,33300
5425,202001,200900,120,30780,4,"""1""",33300,33420
5425,408002,34202,120,31980,4,"""1""",31980,32100
5425,34202,407701,60,31980,4,"""1""",32100,32160
5425,407701,406501,60,31980,4,"""1""",32160,32220
5425,406501,405901,60,31980,4,"""1""",32220,32280
5425,405901,405101,60,31980,4,"""1""",32280,32340
5425,405101,402203,120,31980,4,"""1""",32340,32460
5425,402203,500701,60,31980,4,"""1""",32460,32520
5425,500701,402001,60,31980,4,"""1""",32520,32580
5425,402001,400401,120,31980,4,"""1""",32580,32700
5425,400401,501702,120,31980,4,"""1""",32700,32820
5425,501702,501801,120,31980,4,"""1""",32820,32940
5425,501801,501601,60,31980,4,"""1""",32940,33000
5425,501601,500903,120,31980,4,"""1""",33000,33120
5425,500903,502801,60,31980,4,"""1""",33120,33180
5425,502801,101001,180,31980,4,"""1""",33180,33360
5425,101001,118101,60,31980,4,"""1""",33360,33420
5425,118101,106001,60,31980,4,"""1""",33420,33480
5425,106001,118001,120,31980,4,"""1""",33480,33600
5425,118001,105001,180,31980,4,"""1""",33600,33780
5425,105001,34103,60,31980,4,"""1""",33780,33840
5425,34103,208102,120,31980,4,"""1""",33840,33960
5425,208102,201502,120,31980,4,"""1""",33960,34080
5425,201502,203903,60,31980,4,"""1""",34080,34140
5425,203903,201902,60,31980,4,"""1""",34140,34200
5425,201902,203601,60,31980,4,"""1""",34200,34260
5425,203601,204102,120,31980,4,"""1""",34260,34380
5425,204102,202001,120,31980,4,"""1""",34380,34500
5425,202001,200900,120,31980,4,"""1""",34500,34620
5425,408002,34202,120,33180,4,"""1""",33180,33300
5425,34202,407701,60,33180,4,"""1""",33300,33360
5425,407701,406501,60,33180,4,"""1""",33360,33420
5425,406501,405901,60,33180,4,"""1""",33420,33480
5425,405901,405101,60,33180,4,"""1""",33480,33540
5425,405101,402203,120,33180,4,"""1""",33540,33660
5425,402203,500701,60,33180,4,"""1""",33660,33720
5425,500701,402001,60,33180,4,"""1""",33720,33780
5425,402001,400401,120,33180,4,"""1""",33780,33900
5425,400401,501702,120,33180,4,"""1""",33900,34020
5425,501702,501801,120,33180,4,"""1""",34020,34140
5425,501801,501601,60,33180,4,"""1""",34140,34200
5425,501601,500903,120,33180,4,"""1""",34200,34320
5425,500903,502801,60,33180,4,"""1""",34320,34380
5425,502801,101001,180,33180,4,"""1""",34380,34560
5425,101001,118101,60,33180,4,"""1""",34560,34620
5425,118101,106001,60,33180,4,"""1""",34620,34680
5425,106001,118001,120,33180,4,"""1""",34680,34800
5425,118001,105001,180,33180,4,"""1""",34800,34980
5425,105001,34103,60,33180,4,"""1""",34980,35040
5425,34103,208102,120,33180,4,"""1""",35040,35160
5425,208102,201502,120,33180,4,"""1""",35160,35280
5425,201502,203903,60,33180,4,"""1""",35280,35340
5425,203903,201902,60,33180,4,"""1""",35340,35400
5425,201902,203601,60,33180,4,"""1""",35400,35460
5425,203601,204102,120,33180,4,"""1""",35460,35580
5425,204102,202001,120,33180,4,"""1""",35580,35700
5425,202001,200900,120,33180,4,"""1""",35700,35820
5425,408002,34202,120,34380,4,"""1""",34380,34500
5425,34202,407701,60,34380,4,"""1""",34500,34560
5425,407701,406501,60,34380,4,"""1""",34560,34620
5425,406501,405901,60,34380,4,"""1""",34620,34680
5425,405901,405101,60,34380,4,"""1""",34680,34740
5425,405101,402203,120,34380,4,"""1""",34740,34860
5425,402203,500701,60,34380,4,"""1""",34860,34920
5425,500701,402001,60,34380,4,"""1""",34920,34980
5425,402001,400401,120,34380,4,"""1""",34980,35100
5425,400401,501702,120,34380,4,"""1""",35100,35220
5425,501702,501801,120,34380,4,"""1""",35220,35340
5425,501801,501601,60,34380,4,"""1""",35340,35400
5425,501601,500903,120,34380,4,"""1""",35400,35520
5425,500903,502801,60,34380,4,"""1""",35520,35580
5425,502801,101001,180,34380,4,"""1""",35580,35760
5425,101001,118101,60,34380,4,"""1""",35760,35820
5425,118101,106001,60,34380,4,"""1""",35820,35880
5425,106001,118001,120,34380,4,"""1""",35880,36000
5425,118001,105001,180,34380,4,"""1""",36000,36180
5425,105001,34103,60,34380,4,"""1""",36180,36240
5425,34103,208102,120,34380,4,"""1""",36240,36360
5425,208102,201502,120,34380,4,"""1""",36360,36480
5425,201502,203903,60,34380,4,"""1""",36480,36540
5425,203903,201902,60,34380,4,"""1""",36540,36600
5425,201902,203601,60,34380,4,"""1""",36600,36660
5425,203601,204102,120,34380,4,"""1""",36660,36780
5425,204102,202001,120,34380,4,"""1""",36780,36900
5425,202001,200900,120,34380,4,"""1""",36900,37020
5425,408002,34202,120,35580,4,"""1""",35580,35700
5425,34202,407701,60,35580,4,"""1""",35700,35760
5425,407701,406501,60,35580,4,"""1""",35760,35820
5425,406501,405901,60,35580,4,"""1""",35820,35880
5425,405901,405101,60,35580,4,"""1""",35880,35940
5425,405101,402203,120,35580,4,"""1""",35940,36060
5425,402203,500701,60,35580,4,"""1""",36060,36120
5425,500701,402001,60,35580,4,"""1""",36120,36180
5425,402001,400401,120,35580,4,"""1""",36180,36300
5425,400401,501702,120,35580,4,"""1""",36300,36420
5425,501702,501801,120,35580,4,"""1""",36420,36540
5425,501801,501601,60,35580,4,"""1""",36540,36600
5425,501601,500903,120,35580,4,"""1""",36600,36720
5425,500903,502801,60,35580,4,"""1""",36720,36780
5425,502801,101001,180,35580,4,"""1""",36780,36960
5425,101001,118101,60,35580,4,"""1""",36960,37020
5425,118101,106001,60,35580,4,"""1""",37020,37080
5425,106001,118001,120,35580,4,"""1""",37080,37200
5425,118001,105001,180,35580,4,"""1""",37200,37380
5425,105001,34103,60,35580,4,"""1""",37380,37440
5425,34103,208102,120,35580,4,"""1""",37440,37560
5425,208102,201502,120,35580,4,"""1""",37560,37680
5425,201502,203903,60,35580,4,"""1""",37680,37740
5425,203903,201902,60,35580,4,"""1""",37740,37800
5425,201902,203601,60,35580,4,"""1""",37800,37860
5425,203601,204102,120,35580,4,"""1""",37860,37980
5425,204102,202001,120,35580,4,"""1""",37980,38100
5425,202001,200900,120,35580,4,"""1""",38100,38220
5425,408002,34202,120,36780,4,"""1""",36780,36900
5425,34202,407701,60,36780,4,"""1""",36900,36960
5425,407701,406501,60,36780,4,"""1""",36960,37020
5425,406501,405901,60,36780,4,"""1""",37020,37080
5425,405901,405101,60,36780,4,"""1""",37080,37140
5425,405101,402203,120,36780,4,"""1""",37140,37260
5425,402203,500701,60,36780,4,"""1""",37260,37320
5425,500701,402001,60,36780,4,"""1""",37320,37380
5425,402001,400401,120,36780,4,"""1""",37380,37500
5425,400401,501702,120,36780,4,"""1""",37500,37620
5425,501702,501801,120,36780,4,"""1""",37620,37740
5425,501801,501601,60,36780,4,"""1""",37740,37800
5425,501601,500903,120,36780,4,"""1""",37800,37920
5425,500903,502801,60,36780,4,"""1""",37920,37980
5425,502801,101001,180,36780,4,"""1""",37980,38160
5425,101001,118101,60,36780,4,"""1""",38160,38220
5425,118101,106001,60,36780,4,"""1""",38220,38280
5425,106001,118001,120,36780,4,"""1""",38280,38400
5425,118001,105001,180,36780,4,"""1""",38400,38580
5425,105001,34103,60,36780,4,"""1""",38580,38640
5425,34103,208102,120,36780,4,"""1""",38640,38760
5425,208102,201502,120,36780,4,"""1""",38760,38880
5425,201502,203903,60,36780,4,"""1""",38880,38940
5425,203903,201902,60,36780,4,"""1""",38940,39000
5425,201902,203601,60,36780,4,"""1""",39000,39060
5425,203601,204102,120,36780,4,"""1""",39060,39180
5425,204102,202001,120,36780,4,"""1""",39180,39300
5425,202001,200900,120,36780,4,"""1""",39300,39420
5425,408002,34202,120,37980,4,"""1""",37980,38100
5425,34202,407701,60,37980,4,"""1""",38100,38160
5425,407701,406501,60,37980,4,"""1""",38160,38220
5425,406501,405901,60,37980,4,"""1""",38220,38280
5425,405901,405101,60,37980,4,"""1""",38280,38340
5425,405101,402203,120,37980,4,"""1""",38340,38460
5425,402203,500701,60,37980,4,"""1""",38460,38520
5425,500701,402001,60,37980,4,"""1""",38520,38580
5425,402001,400401,120,37980,4,"""1""",38580,38700
5425,400401,501702,120,37980,4,"""1""",38700,38820
5425,501702,501801,120,37980,4,"""1""",38820,38940
5425,501801,501601,60,37980,4,"""1""",38940,39000
5425,501601,500903,120,37980,4,"""1""",39000,39120
5425,500903,502801,60,37980,4,"""1""",39120,39180
5425,502801,101001,180,37980,4,"""1""",39180,39360
5425,101001,118101,60,37980,4,"""1""",39360,39420
5425,118101,106001,60,37980,4,"""1""",39420,39480
5425,106001,118001,120,37980,4,"""1""",39480,39600
5425,118001,105001,180,37980,4,"""1""",39600,39780
5425,105001,34103,60,37980,4,"""1""",39780,39840
5425,34103,208102,120,37980,4,"""1""",39840,39960
5425,208102,201502,120,37980,4,"""1""",39960,40080
5425,201502,203903,60,37980,4,"""1""",40080,40140
5425,203903,201902,60,37980,4,"""1""",40140,40200
5425,201902,203601,60,37980,4,"""1""",40200,40260
5425,203601,204102,120,37980,4,"""1""",40260,40380
5425,204102,202001,120,37980,4,"""1""",40380,40500
5425,202001,200900,120,37980,4,"""1""",40500,40620
5425,408002,34202,120,39180,4,"""1""",39180,39300
5425,34202,407701,60,39180,4,"""1""",39300,39360
5425,407701,406501,60,39180,4,"""1""",39360,39420
5425,406501,405901,60,39180,4,"""1""",39420,39480
5425,405901,405101,60,39180,4,"""1""",39480,39540
5425,405101,402203,120,39180,4,"""1""",39540,39660
5425,402203,500701,60,39180,4,"""1""",39660,39720
5425,500701,402001,60,39180,4,"""1""",39720,39780
5425,402001,400401,120,39180,4,"""1""",39780,39900
5425,400401,501702,120,39180,4,"""1""",39900,40020
5425,501702,501801,120,39180,4,"""1""",40020,40140
5425,501801,501601,60,39180,4,"""1""",40140,40200
5425,501601,500903,120,39180,4,"""1""",40200,40320
5425,500903,502801,60,39180,4,"""1""",40320,40380
5425,502801,101001,180,39180,4,"""1""",40380,40560
5425,101001,118101,60,39180,4,"""1""",40560,40620
5425,118101,106001,60,39180,4,"""1""",40620,40680
5425,106001,118001,120,39180,4,"""1""",40680,40800
5425,118001,105001,180,39180,4,"""1""",40800,40980
5425,105001,34103,60,39180,4,"""1""",40980,41040
5425,34103,208102,120,39180,4,"""1""",41040,41160
5425,208102,201502,120,39180,4,"""1""",41160,41280
5425,201502,203903,60,39180,4,"""1""",41280,41340
5425,203903,201902,60,39180,4,"""1""",41340,41400
5425,201902,203601,60,39180,4,"""1""",41400,41460
5425,203601,204102,120,39180,4,"""1""",41460,41580
5425,204102,202001,120,39180,4,"""1""",41580,41700
5425,202001,200900,120,39180,4,"""1""",41700,41820
5425,408002,34202,120,40380,4,"""1""",40380,40500
5425,34202,407701,60,40380,4,"""1""",40500,40560
5425,407701,406501,60,40380,4,"""1""",40560,40620
5425,406501,405901,60,40380,4,"""1""",40620,40680
5425,405901,405101,60,40380,4,"""1""",40680,40740
5425,405101,402203,120,40380,4,"""1""",40740,40860
5425,402203,500701,60,40380,4,"""1""",40860,40920
5425,500701,402001,60,40380,4,"""1""",40920,40980
5425,402001,400401,120,40380,4,"""1""",40980,41100
5425,400401,501702,120,40380,4,"""1""",41100,41220
5425,501702,501801,120,40380,4,"""1""",41220,41340
5425,501801,501601,60,40380,4,"""1""",41340,41400
5425,501601,500903,120,40380,4,"""1""",41400,41520
5425,500903,502801,60,40380,4,"""1""",41520,41580
5425,502801,101001,180,40380,4,"""1""",41580,41760
5425,101001,118101,60,40380,4,"""1""",41760,41820
5425,118101,106001,60,40380,4,"""1""",41820,41880
5425,106001,118001,120,40380,4,"""1""",41880,42000
5425,118001,105001,180,40380,4,"""1""",42000,42180
5425,105001,34103,60,40380,4,"""1""",42180,42240
5425,34103,208102,120,40380,4,"""1""",42240,42360
5425,208102,201502,120,40380,4,"""1""",42360,42480
5425,201502,203903,60,40380,4,"""1""",42480,42540
5425,203903,201902,60,40380,4,"""1""",42540,42600
5425,201902,203601,60,40380,4,"""1""",42600,42660
5425,203601,204102,120,40380,4,"""1""",42660,42780
5425,204102,202001,120,40380,4,"""1""",42780,42900
5425,202001,200900,120,40380,4,"""1""",42900,43020
5425,408002,34202,120,41580,4,"""1""",41580,41700
5425,34202,407701,60,41580,4,"""1""",41700,41760
5425,407701,406501,60,41580,4,"""1""",41760,41820
5425,406501,405901,60,41580,4,"""1""",41820,41880
5425,405901,405101,60,41580,4,"""1""",41880,41940
5425,405101,402203,120,41580,4,"""1""",41940,42060
5425,402203,500701,60,41580,4,"""1""",42060,42120
5425,500701,402001,60,41580,4,"""1""",42120,42180
5425,402001,400401,120,41580,4,"""1""",42180,42300
5425,400401,501702,120,41580,4,"""1""",42300,42420
5425,501702,501801,120,41580,4,"""1""",42420,42540
5425,501801,501601,60,41580,4,"""1""",42540,42600
5425,501601,500903,120,41580,4,"""1""",42600,42720
5425,500903,502801,60,41580,4,"""1""",42720,42780
5425,502801,101001,180,41580,4,"""1""",42780,42960
5425,101001,118101,60,41580,4,"""1""",42960,43020
5425,118101,106001,60,41580,4,"""1""",43020,43080
5425,106001,118001,120,41580,4,"""1""",43080,43200
5425,118001,105001,180,41580,4,"""1""",43200,43380
5425,105001,34103,60,41580,4,"""1""",43380,43440
5425,34103,208102,120,41580,4,"""1""",43440,43560
5425,208102,201502,120,41580,4,"""1""",43560,43680
5425,201502,203903,60,41580,4,"""1""",43680,43740
5425,203903,201902,60,41580,4,"""1""",43740,43800
5425,201902,203601,60,41580,4,"""1""",43800,43860
5425,203601,204102,120,41580,4,"""1""",43860,43980
5425,204102,202001,120,41580,4,"""1""",43980,44100
5425,202001,200900,120,41580,4,"""1""",44100,44220
5425,408002,34202,120,42780,4,"""1""",42780,42900
5425,34202,407701,60,42780,4,"""1""",42900,42960
5425,407701,406501,60,42780,4,"""1""",42960,43020
5425,406501,405901,60,42780,4,"""1""",43020,43080
5425,405901,405101,60,42780,4,"""1""",43080,43140
5425,405101,402203,120,42780,4,"""1""",43140,43260
5425,402203,500701,60,42780,4,"""1""",43260,43320
5425,500701,402001,60,42780,4,"""1""",43320,43380
5425,402001,400401,120,42780,4,"""1""",43380,43500
5425,400401,501702,120,42780,4,"""1""",43500,43620
5425,501702,501801,120,42780,4,"""1""",43620,43740
5425,501801,501601,60,42780,4,"""1""",43740,43800
5425,501601,500903,120,42780,4,"""1""",43800,43920
5425,500903,502801,60,42780,4,"""1""",43920,43980
5425,502801,101001,180,42780,4,"""1""",43980,44160
5425,101001,118101,60,42780,4,"""1""",44160,44220
5425,118101,106001,60,42780,4,"""1""",44220,44280
5425,106001,118001,120,42780,4,"""1""",44280,44400
5425,118001,105001,180,42780,4,"""1""",44400,44580
5425,105001,34103,60,42780,4,"""1""",44580,44640
5425,34103,208102,120,42780,4,"""1""",44640,44760
5425,208102,201502,120,42780,4,"""1""",44760,44880
5425,201502,203903,60,42780,4,"""1""",44880,44940
5425,203903,201902,60,42780,4,"""1""",44940,45000
5425,201902,203601,60,42780,4,"""1""",45000,45060
5425,203601,204102,120,42780,4,"""1""",45060,45180
5425,204102,202001,120,42780,4,"""1""",45180,45300
5425,202001,200900,120,42780,4,"""1""",45300,45420
5425,408002,34202,120,43980,4,"""1""",43980,44100
5425,34202,407701,60,43980,4,"""1""",44100,44160
5425,407701,406501,60,43980,4,"""1""",44160,44220
5425,406501,405901,60,43980,4,"""1""",44220,44280
5425,405901,405101,60,43980,4,"""1""",44280,44340
5425,405101,402203,120,43980,4,"""1""",44340,44460
5425,402203,500701,60,43980,4,"""1""",44460,44520
5425,500701,402001,60,43980,4,"""1""",44520,44580
5425,402001,400401,120,43980,4,"""1""",44580,44700
5425,400401,501702,120,43980,4,"""1""",44700,44820
5425,501702,501801,120,43980,4,"""1""",44820,44940
5425,501801,501601,60,43980,4,"""1""",44940,45000
5425,501601,500903,120,43980,4,"""1""",45000,45120
5425,500903,502801,60,43980,4,"""1""",45120,45180
5425,502801,101001,180,43980,4,"""1""",45180,45360
5425,101001,118101,60,43980,4,"""1""",45360,45420
5425,118101,106001,60,43980,4,"""1""",45420,45480
5425,106001,118001,120,43980,4,"""1""",45480,45600
5425,118001,105001,180,43980,4,"""1""",45600,45780
5425,105001,34103,60,43980,4,"""1""",45780,45840
5425,34103,208102,120,43980,4,"""1""",45840,45960
5425,208102,201502,120,43980,4,"""1""",45960,46080
5425,201502,203903,60,43980,4,"""1""",46080,46140
5425,203903,201902,60,43980,4,"""1""",46140,46200
5425,201902,203601,60,43980,4,"""1""",46200,46260
5425,203601,204102,120,43980,4,"""1""",46260,46380
5425,204102,202001,120,43980,4,"""1""",46380,46500
5425,202001,200900,120,43980,4,"""1""",46500,46620
5425,408002,34202,120,45180,4,"""1""",45180,45300
5425,34202,407701,60,45180,4,"""1""",45300,45360
5425,407701,406501,60,45180,4,"""1""",45360,45420
5425,406501,405901,60,45180,4,"""1""",45420,45480
5425,405901,405101,60,45180,4,"""1""",45480,45540
5425,405101,402203,120,45180,4,"""1""",45540,45660
5425,402203,500701,60,45180,4,"""1""",45660,45720
5425,500701,402001,60,45180,4,"""1""",45720,45780
5425,402001,400401,120,45180,4,"""1""",45780,45900
5425,400401,501702,120,45180,4,"""1""",45900,46020
5425,501702,501801,120,45180,4,"""1""",46020,46140
5425,501801,501601,60,45180,4,"""1""",46140,46200
5425,501601,500903,120,45180,4,"""1""",46200,46320
5425,500903,502801,60,45180,4,"""1""",46320,46380
5425,502801,101001,180,45180,4,"""1""",46380,46560
5425,101001,118101,60,45180,4,"""1""",46560,46620
5425,118101,106001,60,45180,4,"""1""",46620,46680
5425,106001,118001,120,45180,4,"""1""",46680,46800
5425,118001,105001,180,45180,4,"""1""",46800,46980
5425,105001,34103,60,45180,4,"""1""",46980,47040
5425,34103,208102,120,45180,4,"""1""",47040,47160
5425,208102,201502,120,45180,4,"""1""",47160,47280
5425,201502,203903,60,45180,4,"""1""",47280,47340
5425,203903,201902,60,45180,4,"""1""",47340,47400
5425,201902,203601,60,45180,4,"""1""",47400,47460
5425,203601,204102,120,45180,4,"""1""",47460,47580
5425,204102,202001,120,45180,4,"""1""",47580,47700
5425,202001,200900,120,45180,4,"""1""",47700,47820
5425,408002,34202,120,46380,4,"""1""",46380,46500
5425,34202,407701,60,46380,4,"""1""",46500,46560
5425,407701,406501,60,46380,4,"""1""",46560,46620
5425,406501,405901,60,46380,4,"""1""",46620,46680
5425,405901,405101,60,46380,4,"""1""",46680,46740
5425,405101,402203,120,46380,4,"""1""",46740,46860
5425,402203,500701,60,46380,4,"""1""",46860,46920
5425,500701,402001,60,46380,4,"""1""",46920,46980
5425,402001,400401,120,46380,4,"""1""",46980,47100
5425,400401,501702,120,46380,4,"""1""",47100,47220
5425,501702,501801,120,46380,4,"""1""",47220,47340
5425,501801,501601,60,46380,4,"""1""",47340,47400
5425,501601,500903,120,46380,4,"""1""",47400,47520
5425,500903,502801,60,46380,4,"""1""",47520,47580
5425,502801,101001,180,46380,4,"""1""",47580,47760
5425,101001,118101,60,46380,4,"""1""",47760,47820
5425,118101,106001,60,46380,4,"""1""",47820,47880
5425,106001,118001,120,46380,4,"""1""",47880,48000
5425,118001,105001,180,46380,4,"""1""",48000,48180
5425,105001,34103,60,46380,4,"""1""",48180,48240
5425,34103,208102,120,46380,4,"""1""",48240,48360
5425,208102,201502,120,46380,4,"""1""",48360,48480
5425,201502,203903,60,46380,4,"""1""",48480,48540
5425,203903,201902,60,46380,4,"""1""",48540,48600
5425,201902,203601,60,46380,4,"""1""",48600,48660
5425,203601,204102,120,46380,4,"""1""",48660,48780
5425,204102,202001,120,46380,4,"""1""",48780,48900
5425,202001,200900,120,46380,4,"""1""",48900,49020
5425,408002,34202,120,48780,4,"""1""",48780,48900
5425,34202,407701,60,48780,4,"""1""",48900,48960
5425,407701,406501,60,48780,4,"""1""",48960,49020
5425,406501,405901,60,48780,4,"""1""",49020,49080
5425,405901,405101,60,48780,4,"""1""",49080,49140
5425,405101,402203,120,48780,4,"""1""",49140,49260
5425,402203,500701,60,48780,4,"""1""",49260,49320
5425,500701,402001,60,48780,4,"""1""",49320,49380
5425,402001,400401,120,48780,4,"""1""",49380,49500
5425,400401,501702,120,48780,4,"""1""",49500,49620
5425,501702,501801,120,48780,4,"""1""",49620,49740
5425,501801,501601,60,48780,4,"""1""",49740,49800
5425,501601,500903,120,48780,4,"""1""",49800,49920
5425,500903,502801,60,48780,4,"""1""",49920,49980
5425,502801,101001,180,48780,4,"""1""",49980,50160
5425,101001,118101,60,48780,4,"""1""",50160,50220
5425,118101,106001,60,48780,4,"""1""",50220,50280
5425,106001,118001,120,48780,4,"""1""",50280,50400
5425,118001,105001,180,48780,4,"""1""",50400,50580
5425,105001,34103,60,48780,4,"""1""",50580,50640
5425,34103,208102,120,48780,4,"""1""",50640,50760
5425,208102,201502,120,48780,4,"""1""",50760,50880
5425,201502,203903,60,48780,4,"""1""",50880,50940
5425,203903,201902,60,48780,4,"""1""",50940,51000
5425,201902,203601,60,48780,4,"""1""",51000,51060
5425,203601,204102,120,48780,4,"""1""",51060,51180
5425,204102,202001,120,48780,4,"""1""",51180,51300
5425,202001,200900,120,48780,4,"""1""",51300,51420
5425,408002,34202,120,49980,4,"""1""",49980,50100
5425,34202,407701,60,49980,4,"""1""",50100,50160
5425,407701,406501,60,49980,4,"""1""",50160,50220
5425,406501,405901,60,49980,4,"""1""",50220,50280
5425,405901,405101,60,49980,4,"""1""",50280,50340
5425,405101,402203,120,49980,4,"""1""",50340,50460
5425,402203,500701,60,49980,4,"""1""",50460,50520
5425,500701,402001,60,49980,4,"""1""",50520,50580
5425,402001,400401,120,49980,4,"""1""",50580,50700
5425,400401,501702,120,49980,4,"""1""",50700,50820
5425,501702,501801,120,49980,4,"""1""",50820,50940
5425,501801,501601,60,49980,4,"""1""",50940,51000
5425,501601,500903,120,49980,4,"""1""",51000,51120
5425,500903,502801,60,49980,4,"""1""",51120,51180
5425,502801,101001,180,49980,4,"""1""",51180,51360
5425,101001,118101,60,49980,4,"""1""",51360,51420
5425,118101,106001,60,49980,4,"""1""",51420,51480
5425,106001,118001,120,49980,4,"""1""",51480,51600
5425,118001,105001,180,49980,4,"""1""",51600,51780
5425,105001,34103,60,49980,4,"""1""",51780,51840
5425,34103,208102,120,49980,4,"""1""",51840,51960
5425,208102,201502,120,49980,4,"""1""",51960,52080
5425,201502,203903,60,49980,4,"""1""",52080,52140
5425,203903,201902,60,49980,4,"""1""",52140,52200
5425,201902,203601,60,49980,4,"""1""",52200,52260
5425,203601,204102,120,49980,4,"""1""",52260,52380
5425,204102,202001,120,49980,4,"""1""",52380,52500
5425,202001,200900,120,49980,4,"""1""",52500,52620
5425,408002,34202,120,51180,4,"""1""",51180,51300
5425,34202,407701,60,51180,4,"""1""",51300,51360
5425,407701,406501,60,51180,4,"""1""",51360,51420
5425,406501,405901,60,51180,4,"""1""",51420,51480
5425,405901,405101,60,51180,4,"""1""",51480,51540
5425,405101,402203,120,51180,4,"""1""",51540,51660
5425,402203,500701,60,51180,4,"""1""",51660,51720
5425,500701,402001,60,51180,4,"""1""",51720,51780
5425,402001,400401,120,51180,4,"""1""",51780,51900
5425,400401,501702,120,51180,4,"""1""",51900,52020
5425,501702,501801,120,51180,4,"""1""",52020,52140
5425,501801,501601,60,51180,4,"""1""",52140,52200
5425,501601,500903,120,51180,4,"""1""",52200,52320
5425,500903,502801,60,51180,4,"""1""",52320,52380
5425,502801,101001,180,51180,4,"""1""",52380,52560
5425,101001,118101,60,51180,4,"""1""",52560,52620
5425,118101,106001,60,51180,4,"""1""",52620,52680
5425,106001,118001,120,51180,4,"""1""",52680,52800
5425,118001,105001,180,51180,4,"""1""",52800,52980
5425,105001,34103,60,51180,4,"""1""",52980,53040
5425,34103,208102,120,51180,4,"""1""",53040,53160
5425,208102,201502,120,51180,4,"""1""",53160,53280
5425,201502,203903,60,51180,4,"""1""",53280,53340
5425,203903,201902,60,51180,4,"""1""",53340,53400
5425,201902,203601,60,51180,4,"""1""",53400,53460
5425,203601,204102,120,51180,4,"""1""",53460,53580
5425,204102,202001,120,51180,4,"""1""",53580,53700
5425,202001,200900,120,51180,4,"""1""",53700,53820
5425,408002,34202,120,52380,4,"""1""",52380,52500
5425,34202,407701,60,52380,4,"""1""",52500,52560
5425,407701,406501,60,52380,4,"""1""",52560,52620
5425,406501,405901,60,52380,4,"""1""",52620,52680
5425,405901,405101,60,52380,4,"""1""",52680,52740
5425,405101,402203,120,52380,4,"""1""",52740,52860
5425,402203,500701,60,52380,4,"""1""",52860,52920
5425,500701,402001,60,52380,4,"""1""",52920,52980
5425,402001,400401,120,52380,4,"""1""",52980,53100
5425,400401,501702,120,52380,4,"""1""",53100,53220
5425,501702,501801,120,52380,4,"""1""",53220,53340
5425,501801,501601,60,52380,4,"""1""",53340,53400
5425,501601,500903,120,52380,4,"""1""",53400,53520
5425,500903,502801,60,52380,4,"""1""",53520,53580
5425,502801,101001,180,52380,4,"""1""",53580,53760
5425,101001,118101,60,52380,4,"""1""",53760,53820
5425,118101,106001,60,52380,4,"""1""",53820,53880
5425,106001,118001,120,52380,4,"""1""",53880,54000
5425,118001,105001,180,52380,4,"""1""",54000,54180
5425,105001,34103,60,52380,4,"""1""",54180,54240
5425,34103,208102,120,52380,4,"""1""",54240,54360
5425,208102,201502,120,52380,4,"""1""",54360,54480
5425,201502,203903,60,52380,4,"""1""",54480,54540
5425,203903,201902,60,52380,4,"""1""",54540,54600
5425,201902,203601,60,52380,4,"""1""",54600,54660
5425,203601,204102,120,52380,4,"""1""",54660,54780
5425,204102,202001,120,52380,4,"""1""",54780,54900
5425,202001,200900,120,52380,4,"""1""",54900,55020
5425,408002,34202,120,53580,4,"""1""",53580,53700
5425,34202,407701,60,53580,4,"""1""",53700,53760
5425,407701,406501,60,53580,4,"""1""",53760,53820
5425,406501,405901,60,53580,4,"""1""",53820,53880
5425,405901,405101,60,53580,4,"""1""",53880,53940
5425,405101,402203,120,53580,4,"""1""",53940,54060
5425,402203,500701,60,53580,4,"""1""",54060,54120
5425,500701,402001,60,53580,4,"""1""",54120,54180
5425,402001,400401,120,53580,4,"""1""",54180,54300
5425,400401,501702,120,53580,4,"""1""",54300,54420
5425,501702,501801,120,53580,4,"""1""",54420,54540
5425,501801,501601,60,53580,4,"""1""",54540,54600
5425,501601,500903,120,53580,4,"""1""",54600,54720
5425,500903,502801,60,53580,4,"""1""",54720,54780
5425,502801,101001,180,53580,4,"""1""",54780,54960
5425,101001,118101,60,53580,4,"""1""",54960,55020
5425,118101,106001,60,53580,4,"""1""",55020,55080
5425,106001,118001,120,53580,4,"""1""",55080,55200
5425,118001,105001,180,53580,4,"""1""",55200,55380
5425,105001,34103,60,53580,4,"""1""",55380,55440
5425,34103,208102,120,53580,4,"""1""",55440,55560
5425,208102,201502,120,53580,4,"""1""",55560,55680
5425,201502,203903,60,53580,4,"""1""",55680,55740
5425,203903,201902,60,53580,4,"""1""",55740,55800
5425,201902,203601,60,53580,4,"""1""",55800,55860
5425,203601,204102,120,53580,4,"""1""",55860,55980
5425,204102,202001,120,53580,4,"""1""",55980,56100
5425,202001,200900,120,53580,4,"""1""",56100,56220
5425,408002,34202,120,54780,4,"""1""",54780,54900
5425,34202,407701,60,54780,4,"""1""",54900,54960
5425,407701,406501,60,54780,4,"""1""",54960,55020
5425,406501,405901,60,54780,4,"""1""",55020,55080
5425,405901,405101,60,54780,4,"""1""",55080,55140
5425,405101,402203,120,54780,4,"""1""",55140,55260
5425,402203,500701,60,54780,4,"""1""",55260,55320
5425,500701,402001,60,54780,4,"""1""",55320,55380
5425,402001,400401,120,54780,4,"""1""",55380,55500
5425,400401,501702,120,54780,4,"""1""",55500,55620
5425,501702,501801,120,54780,4,"""1""",55620,55740
5425,501801,501601,60,54780,4,"""1""",55740,55800
5425,501601,500903,120,54780,4,"""1""",55800,55920
5425,500903,502801,60,54780,4,"""1""",55920,55980
5425,502801,101001,180,54780,4,"""1""",55980,56160
5425,101001,118101,60,54780,4,"""1""",56160,56220
5425,118101,106001,60,54780,4,"""1""",56220,56280
5425,106001,118001,120,54780,4,"""1""",56280,56400
5425,118001,105001,180,54780,4,"""1""",56400,56580
5425,105001,34103,60,54780,4,"""1""",56580,56640
5425,34103,208102,120,54780,4,"""1""",56640,56760
5425,208102,201502,120,54780,4,"""1""",56760,56880
5425,201502,203903,60,54780,4,"""1""",56880,56940
5425,203903,201902,60,54780,4,"""1""",56940,57000
5425,201902,203601,60,54780,4,"""1""",57000,57060
5425,203601,204102,120,54780,4,"""1""",57060,57180
5425,204102,202001,120,54780,4,"""1""",57180,57300
5425,202001,200900,120,54780,4,"""1""",57300,57420
5425,408002,34202,120,55980,4,"""1""",55980,56100
5425,34202,407701,60,55980,4,"""1""",56100,56160
5425,407701,406501,60,55980,4,"""1""",56160,56220
5425,406501,405901,60,55980,4,"""1""",56220,56280
5425,405901,405101,60,55980,4,"""1""",56280,56340
5425,405101,402203,120,55980,4,"""1""",56340,56460
5425,402203,500701,60,55980,4,"""1""",56460,56520
5425,500701,402001,60,55980,4,"""1""",56520,56580
5425,402001,400401,120,55980,4,"""1""",56580,56700
5425,400401,501702,120,55980,4,"""1""",56700,56820
5425,501702,501801,120,55980,4,"""1""",56820,56940
5425,501801,501601,60,55980,4,"""1""",56940,57000
5425,501601,500903,120,55980,4,"""1""",57000,57120
5425,500903,502801,60,55980,4,"""1""",57120,57180
5425,502801,101001,180,55980,4,"""1""",57180,57360
5425,101001,118101,60,55980,4,"""1""",57360,57420
5425,118101,106001,60,55980,4,"""1""",57420,57480
5425,106001,118001,120,55980,4,"""1""",57480,57600
5425,118001,105001,180,55980,4,"""1""",57600,57780
5425,105001,34103,60,55980,4,"""1""",57780,57840
5425,34103,208102,120,55980,4,"""1""",57840,57960
5425,208102,201502,120,55980,4,"""1""",57960,58080
5425,201502,203903,60,55980,4,"""1""",58080,58140
5425,203903,201902,60,55980,4,"""1""",58140,58200
5425,201902,203601,60,55980,4,"""1""",58200,58260
5425,203601,204102,120,55980,4,"""1""",58260,58380
5425,204102,202001,120,55980,4,"""1""",58380,58500
5425,202001,200900,120,55980,4,"""1""",58500,58620
5425,408002,34202,120,57180,4,"""1""",57180,57300
5425,34202,407701,60,57180,4,"""1""",57300,57360
5425,407701,406501,60,57180,4,"""1""",57360,57420
5425,406501,405901,60,57180,4,"""1""",57420,57480
5425,405901,405101,60,57180,4,"""1""",57480,57540
5425,405101,402203,120,57180,4,"""1""",57540,57660
5425,402203,500701,60,57180,4,"""1""",57660,57720
5425,500701,402001,60,57180,4,"""1""",57720,57780
5425,402001,400401,120,57180,4,"""1""",57780,57900
5425,400401,501702,120,57180,4,"""1""",57900,58020
5425,501702,501801,120,57180,4,"""1""",58020,58140
5425,501801,501601,60,57180,4,"""1""",58140,58200
5425,501601,500903,120,57180,4,"""1""",58200,58320
5425,500903,502801,60,57180,4,"""1""",58320,58380
5425,502801,101001,180,57180,4,"""1""",58380,58560
5425,101001,118101,60,57180,4,"""1""",58560,58620
5425,118101,106001,60,57180,4,"""1""",58620,58680
5425,106001,118001,120,57180,4,"""1""",58680,58800
5425,118001,105001,180,57180,4,"""1""",58800,58980
5425,105001,34103,60,57180,4,"""1""",58980,59040
5425,34103,208102,120,57180,4,"""1""",59040,59160
5425,208102,201502,120,57180,4,"""1""",59160,59280
5425,201502,203903,60,57180,4,"""1""",59280,59340
5425,203903,201902,60,57180,4,"""1""",59340,59400
5425,201902,203601,60,57180,4,"""1""",59400,59460
5425,203601,204102,120,57180,4,"""1""",59460,59580
5425,204102,202001,120,57180,4,"""1""",59580,59700
5425,202001,200900,120,57180,4,"""1""",59700,59820
5425,408002,34202,120,58380,4,"""1""",58380,58500
5425,34202,407701,60,58380,4,"""1""",58500,58560
5425,407701,406501,60,58380,4,"""1""",58560,58620
5425,406501,405901,60,58380,4,"""1""",58620,58680
5425,405901,405101,60,58380,4,"""1""",58680,58740
5425,405101,402203,120,58380,4,"""1""",58740,58860
5425,402203,500701,60,58380,4,"""1""",58860,58920
5425,500701,402001,60,58380,4,"""1""",58920,58980
5425,402001,400401,120,58380,4,"""1""",58980,59100
5425,400401,501702,120,58380,4,"""1""",59100,59220
5425,501702,501801,120,58380,4,"""1""",59220,59340
5425,501801,501601,60,58380,4,"""1""",59340,59400
5425,501601,500903,120,58380,4,"""1""",59400,59520
5425,500903,502801,60,58380,4,"""1""",59520,59580
5425,502801,101001,180,58380,4,"""1""",59580,59760
5425,101001,118101,60,58380,4,"""1""",59760,59820
5425,118101,106001,60,58380,4,"""1""",59820,59880
5425,106001,118001,120,58380,4,"""1""",59880,60000
5425,118001,105001,180,58380,4,"""1""",60000,60180
5425,105001,34103,60,58380,4,"""1""",60180,60240
5425,34103,208102,120,58380,4,"""1""",60240,60360
5425,208102,201502,120,58380,4,"""1""",60360,60480
5425,201502,203903,60,58380,4,"""1""",60480,60540
5425,203903,201902,60,58380,4,"""1""",60540,60600
5425,201902,203601,60,58380,4,"""1""",60600,60660
5425,203601,204102,120,58380,4,"""1""",60660,60780
5425,204102,202001,120,58380,4,"""1""",60780,60900
5425,202001,200900,120,58380,4,"""1""",60900,61020
5425,408002,34202,120,59580,4,"""1""",59580,59700
5425,34202,407701,60,59580,4,"""1""",59700,59760
5425,407701,406501,60,59580,4,"""1""",59760,59820
5425,406501,405901,60,59580,4,"""1""",59820,59880
5425,405901,405101,60,59580,4,"""1""",59880,59940
5425,405101,402203,120,59580,4,"""1""",59940,60060
5425,402203,500701,60,59580,4,"""1""",60060,60120
5425,500701,402001,60,59580,4,"""1""",60120,60180
5425,402001,400401,120,59580,4,"""1""",60180,60300
5425,400401,501702,120,59580,4,"""1""",60300,60420
5425,501702,501801,120,59580,4,"""1""",60420,60540
5425,501801,501601,60,59580,4,"""1""",60540,60600
5425,501601,500903,120,59580,4,"""1""",60600,60720
5425,500903,502801,60,59580,4,"""1""",60720,60780
5425,502801,101001,180,59580,4,"""1""",60780,60960
5425,101001,118101,60,59580,4,"""1""",60960,61020
5425,118101,106001,60,59580,4,"""1""",61020,61080
5425,106001,118001,120,59580,4,"""1""",61080,61200
5425,118001,105001,180,59580,4,"""1""",61200,61380
5425,105001,34103,60,59580,4,"""1""",61380,61440
5425,34103,208102,120,59580,4,"""1""",61440,61560
5425,208102,201502,120,59580,4,"""1""",61560,61680
5425,201502,203903,60,59580,4,"""1""",61680,61740
5425,203903,201902,60,59580,4,"""1""",61740,61800
5425,201902,203601,60,59580,4,"""1""",61800,61860
5425,203601,204102,120,59580,4,"""1""",61860,61980
5425,204102,202001,120,59580,4,"""1""",61980,62100
5425,202001,200900,120,59580,4,"""1""",62100,62220
5425,408002,34202,120,60780,4,"""1""",60780,60900
5425,34202,407701,60,60780,4,"""1""",60900,60960
5425,407701,406501,60,60780,4,"""1""",60960,61020
5425,406501,405901,60,60780,4,"""1""",61020,61080
5425,405901,405101,60,60780,4,"""1""",61080,61140
5425,405101,402203,120,60780,4,"""1""",61140,61260
5425,402203,500701,60,60780,4,"""1""",61260,61320
5425,500701,402001,60,60780,4,"""1""",61320,61380
5425,402001,400401,120,60780,4,"""1""",61380,61500
5425,400401,501702,120,60780,4,"""1""",61500,61620
5425,501702,501801,120,60780,4,"""1""",61620,61740
5425,501801,501601,60,60780,4,"""1""",61740,61800
5425,501601,500903,120,60780,4,"""1""",61800,61920
5425,500903,502801,60,60780,4,"""1""",61920,61980
5425,502801,101001,180,60780,4,"""1""",61980,62160
5425,101001,118101,60,60780,4,"""1""",62160,62220
5425,118101,106001,60,60780,4,"""1""",62220,62280
5425,106001,118001,120,60780,4,"""1""",62280,62400
5425,118001,105001,180,60780,4,"""1""",62400,62580
5425,105001,34103,60,60780,4,"""1""",62580,62640
5425,34103,208102,120,60780,4,"""1""",62640,62760
5425,208102,201502,120,60780,4,"""1""",62760,62880
5425,201502,203903,60,60780,4,"""1""",62880,62940
5425,203903,201902,60,60780,4,"""1""",62940,63000
5425,201902,203601,60,60780,4,"""1""",63000,63060
5425,203601,204102,120,60780,4,"""1""",63060,63180
5425,204102,202001,120,60780,4,"""1""",63180,63300
5425,202001,200900,120,60780,4,"""1""",63300,63420
5425,408002,34202,120,61980,4,"""1""",61980,62100
5425,34202,407701,60,61980,4,"""1""",62100,62160
5425,407701,406501,60,61980,4,"""1""",62160,62220
5425,406501,405901,60,61980,4,"""1""",62220,62280
5425,405901,405101,60,61980,4,"""1""",62280,62340
5425,405101,402203,120,61980,4,"""1""",62340,62460
5425,402203,500701,60,61980,4,"""1""",62460,62520
5425,500701,402001,60,61980,4,"""1""",62520,62580
5425,402001,400401,120,61980,4,"""1""",62580,62700
5425,400401,501702,120,61980,4,"""1""",62700,62820
5425,501702,501801,120,61980,4,"""1""",62820,62940
5425,501801,501601,60,61980,4,"""1""",62940,63000
5425,501601,500903,120,61980,4,"""1""",63000,63120
5425,500903,502801,60,61980,4,"""1""",63120,63180
5425,502801,101001,180,61980,4,"""1""",63180,63360
5425,101001,118101,60,61980,4,"""1""",63360,63420
5425,118101,106001,60,61980,4,"""1""",63420,63480
5425,106001,118001,120,61980,4,"""1""",63480,63600
5425,118001,105001,180,61980,4,"""1""",63600,63780
5425,105001,34103,60,61980,4,"""1""",63780,63840
5425,34103,208102,120,61980,4,"""1""",63840,63960
5425,208102,201502,120,61980,4,"""1""",63960,64080
5425,201502,203903,60,61980,4,"""1""",64080,64140
5425,203903,201902,60,61980,4,"""1""",64140,64200
5425,201902,203601,60,61980,4,"""1""",64200,64260
5425,203601,204102,120,61980,4,"""1""",64260,64380
5425,204102,202001,120,61980,4,"""1""",64380,64500
5425,202001,200900,120,61980,4,"""1""",64500,64620
5425,408002,34202,120,63180,4,"""1""",63180,63300
5425,34202,407701,60,63180,4,"""1""",63300,63360
5425,407701,406501,60,63180,4,"""1""",63360,63420
5425,406501,405901,60,63180,4,"""1""",63420,63480
5425,405901,405101,60,63180,4,"""1""",63480,63540
5425,405101,402203,120,63180,4,"""1""",63540,63660
5425,402203,500701,60,63180,4,"""1""",63660,63720
5425,500701,402001,60,63180,4,"""1""",63720,63780
5425,402001,400401,120,63180,4,"""1""",63780,63900
5425,400401,501702,120,63180,4,"""1""",63900,64020
5425,501702,501801,120,63180,4,"""1""",64020,64140
5425,501801,501601,60,63180,4,"""1""",64140,64200
5425,501601,500903,120,63180,4,"""1""",64200,64320
5425,500903,502801,60,63180,4,"""1""",64320,64380
5425,502801,101001,180,63180,4,"""1""",64380,64560
5425,101001,118101,60,63180,4,"""1""",64560,64620
5425,118101,106001,60,63180,4,"""1""",64620,64680
5425,106001,118001,120,63180,4,"""1""",64680,64800
5425,118001,105001,180,63180,4,"""1""",64800,64980
5425,105001,34103,60,63180,4,"""1""",64980,65040
5425,34103,208102,120,63180,4,"""1""",65040,65160
5425,208102,201502,120,63180,4,"""1""",65160,65280
5425,201502,203903,60,63180,4,"""1""",65280,65340
5425,203903,201902,60,63180,4,"""1""",65340,65400
5425,201902,203601,60,63180,4,"""1""",65400,65460
5425,203601,204102,120,63180,4,"""1""",65460,65580
5425,204102,202001,120,63180,4,"""1""",65580,65700
5425,202001,200900,120,63180,4,"""1""",65700,65820
5425,408002,34202,120,64380,4,"""1""",64380,64500
5425,34202,407701,60,64380,4,"""1""",64500,64560
5425,407701,406501,60,64380,4,"""1""",64560,64620
5425,406501,405901,60,64380,4,"""1""",64620,64680
5425,405901,405101,60,64380,4,"""1""",64680,64740
5425,405101,402203,120,64380,4,"""1""",64740,64860
5425,402203,500701,60,64380,4,"""1""",64860,64920
5425,500701,402001,60,64380,4,"""1""",64920,64980
5425,402001,400401,120,64380,4,"""1""",64980,65100
5425,400401,501702,120,64380,4,"""1""",65100,65220
5425,501702,501801,120,64380,4,"""1""",65220,65340
5425,501801,501601,60,64380,4,"""1""",65340,65400
5425,501601,500903,120,64380,4,"""1""",65400,65520
5425,500903,502801,60,64380,4,"""1""",65520,65580
5425,502801,101001,180,64380,4,"""1""",65580,65760
5425,101001,118101,60,64380,4,"""1""",65760,65820
5425,118101,106001,60,64380,4,"""1""",65820,65880
5425,106001,118001,120,64380,4,"""1""",65880,66000
5425,118001,105001,180,64380,4,"""1""",66000,66180
5425,105001,34103,60,64380,4,"""1""",66180,66240
5425,34103,208102,120,64380,4,"""1""",66240,66360
5425,208102,201502,120,64380,4,"""1""",66360,66480
5425,201502,203903,60,64380,4,"""1""",66480,66540
5425,203903,201902,60,64380,4,"""1""",66540,66600
5425,201902,203601,60,64380,4,"""1""",66600,66660
5425,203601,204102,120,64380,4,"""1""",66660,66780
5425,204102,202001,120,64380,4,"""1""",66780,66900
5425,202001,200900,120,64380,4,"""1""",66900,67020
5425,408002,34202,120,65580,4,"""1""",65580,65700
5425,34202,407701,60,65580,4,"""1""",65700,65760
5425,407701,406501,60,65580,4,"""1""",65760,65820
5425,406501,405901,60,65580,4,"""1""",65820,65880
5425,405901,405101,60,65580,4,"""1""",65880,65940
5425,405101,402203,120,65580,4,"""1""",65940,66060
5425,402203,500701,60,65580,4,"""1""",66060,66120
5425,500701,402001,60,65580,4,"""1""",66120,66180
5425,402001,400401,120,65580,4,"""1""",66180,66300
5425,400401,501702,120,65580,4,"""1""",66300,66420
5425,501702,501801,120,65580,4,"""1""",66420,66540
5425,501801,501601,60,65580,4,"""1""",66540,66600
5425,501601,500903,120,65580,4,"""1""",66600,66720
5425,500903,502801,60,65580,4,"""1""",66720,66780
5425,502801,101001,180,65580,4,"""1""",66780,66960
5425,101001,118101,60,65580,4,"""1""",66960,67020
5425,118101,106001,60,65580,4,"""1""",67020,67080
5425,106001,118001,120,65580,4,"""1""",67080,67200
5425,118001,105001,180,65580,4,"""1""",67200,67380
5425,105001,34103,60,65580,4,"""1""",67380,67440
5425,34103,208102,120,65580,4,"""1""",67440,67560
5425,208102,201502,120,65580,4,"""1""",67560,67680
5425,201502,203903,60,65580,4,"""1""",67680,67740
5425,203903,201902,60,65580,4,"""1""",67740,67800
5425,201902,203601,60,65580,4,"""1""",67800,67860
5425,203601,204102,120,65580,4,"""1""",67860,67980
5425,204102,202001,120,65580,4,"""1""",67980,68100
5425,202001,200900,120,65580,4,"""1""",68100,68220
5425,408002,34202,120,66780,4,"""1""",66780,66900
5425,34202,407701,60,66780,4,"""1""",66900,66960
5425,407701,406501,60,66780,4,"""1""",66960,67020
5425,406501,405901,60,66780,4,"""1""",67020,67080
5425,405901,405101,60,66780,4,"""1""",67080,67140
5425,405101,402203,120,66780,4,"""1""",67140,67260
5425,402203,500701,60,66780,4,"""1""",67260,67320
5425,500701,402001,60,66780,4,"""1""",67320,67380
5425,402001,400401,120,66780,4,"""1""",67380,67500
5425,400401,501702,120,66780,4,"""1""",67500,67620
5425,501702,501801,120,66780,4,"""1""",67620,67740
5425,501801,501601,60,66780,4,"""1""",67740,67800
5425,501601,500903,120,66780,4,"""1""",67800,67920
5425,500903,502801,60,66780,4,"""1""",67920,67980
5425,502801,101001,180,66780,4,"""1""",67980,68160
5425,101001,118101,60,66780,4,"""1""",68160,68220
5425,118101,106001,60,66780,4,"""1""",68220,68280
5425,106001,118001,120,66780,4,"""1""",68280,68400
5425,118001,105001,180,66780,4,"""1""",68400,68580
5425,105001,34103,60,66780,4,"""1""",68580,68640
5425,34103,208102,120,66780,4,"""1""",68640,68760
5425,208102,201502,120,66780,4,"""1""",68760,68880
5425,201502,203903,60,66780,4,"""1""",68880,68940
5425,203903,201902,60,66780,4,"""1""",68940,69000
5425,201902,203601,60,66780,4,"""1""",69000,69060
5425,203601,204102,120,66780,4,"""1""",69060,69180
5425,204102,202001,120,66780,4,"""1""",69180,69300
5425,202001,200900,120,66780,4,"""1""",69300,69420
5425,408002,34202,120,67980,4,"""1""",67980,68100
5425,34202,407701,60,67980,4,"""1""",68100,68160
5425,407701,406501,60,67980,4,"""1""",68160,68220
5425,406501,405901,60,67980,4,"""1""",68220,68280
5425,405901,405101,60,67980,4,"""1""",68280,68340
5425,405101,402203,120,67980,4,"""1""",68340,68460
5425,402203,500701,60,67980,4,"""1""",68460,68520
5425,500701,402001,60,67980,4,"""1""",68520,68580
5425,402001,400401,120,67980,4,"""1""",68580,68700
5425,400401,501702,120,67980,4,"""1""",68700,68820
5425,501702,501801,120,67980,4,"""1""",68820,68940
5425,501801,501601,60,67980,4,"""1""",68940,69000
5425,501601,500903,120,67980,4,"""1""",69000,69120
5425,500903,502801,60,67980,4,"""1""",69120,69180
5425,502801,101001,180,67980,4,"""1""",69180,69360
5425,101001,118101,60,67980,4,"""1""",69360,69420
5425,118101,106001,60,67980,4,"""1""",69420,69480
5425,106001,118001,120,67980,4,"""1""",69480,69600
5425,118001,105001,180,67980,4,"""1""",69600,69780
5425,105001,34103,60,67980,4,"""1""",69780,69840
5425,34103,208102,120,67980,4,"""1""",69840,69960
5425,208102,201502,120,67980,4,"""1""",69960,70080
5425,201502,203903,60,67980,4,"""1""",70080,70140
5425,203903,201902,60,67980,4,"""1""",70140,70200
5425,201902,203601,60,67980,4,"""1""",70200,70260
5425,203601,204102,120,67980,4,"""1""",70260,70380
5425,204102,202001,120,67980,4,"""1""",70380,70500
5425,202001,200900,120,67980,4,"""1""",70500,70620
5425,408002,34202,120,69180,4,"""1""",69180,69300
5425,34202,407701,60,69180,4,"""1""",69300,69360
5425,407701,406501,60,69180,4,"""1""",69360,69420
5425,406501,405901,60,69180,4,"""1""",69420,69480
5425,405901,405101,60,69180,4,"""1""",69480,69540
5425,405101,402203,120,69180,4,"""1""",69540,69660
5425,402203,500701,60,69180,4,"""1""",69660,69720
5425,500701,402001,60,69180,4,"""1""",69720,69780
5425,402001,400401,120,69180,4,"""1""",69780,69900
5425,400401,501702,120,69180,4,"""1""",69900,70020
5425,501702,501801,120,69180,4,"""1""",70020,70140
5425,501801,501601,60,69180,4,"""1""",70140,70200
5425,501601,500903,120,69180,4,"""1""",70200,70320
5425,500903,502801,60,69180,4,"""1""",70320,70380
5425,502801,101001,180,69180,4,"""1""",70380,70560
5425,101001,118101,60,69180,4,"""1""",70560,70620
5425,118101,106001,60,69180,4,"""1""",70620,70680
5425,106001,118001,120,69180,4,"""1""",70680,70800
5425,118001,105001,180,69180,4,"""1""",70800,70980
5425,105001,34103,60,69180,4,"""1""",70980,71040
5425,34103,208102,120,69180,4,"""1""",71040,71160
5425,208102,201502,120,69180,4,"""1""",71160,71280
5425,201502,203903,60,69180,4,"""1""",71280,71340
5425,203903,201902,60,69180,4,"""1""",71340,71400
5425,201902,203601,60,69180,4,"""1""",71400,71460
5425,203601,204102,120,69180,4,"""1""",71460,71580
5425,204102,202001,120,69180,4,"""1""",71580,71700
5425,202001,200900,120,69180,4,"""1""",71700,71820
5426,408002,34202,120,23580,4,"""1""",23580,23700
5426,34202,407701,60,23580,4,"""1""",23700,23760
5426,407701,406501,60,23580,4,"""1""",23760,23820
5426,406501,405901,60,23580,4,"""1""",23820,23880
5426,405901,405101,60,23580,4,"""1""",23880,23940
5426,405101,402203,120,23580,4,"""1""",23940,24060
5426,402203,500701,60,23580,4,"""1""",24060,24120
5426,500701,402001,60,23580,4,"""1""",24120,24180
5426,402001,400401,120,23580,4,"""1""",24180,24300
5426,400401,501702,120,23580,4,"""1""",24300,24420
5426,501702,501801,120,23580,4,"""1""",24420,24540
5426,501801,501601,60,23580,4,"""1""",24540,24600
5426,501601,500903,60,23580,4,"""1""",24600,24660
5426,500903,502801,60,23580,4,"""1""",24660,24720
5426,502801,101001,180,23580,4,"""1""",24720,24900
5426,101001,118101,60,23580,4,"""1""",24900,24960
5426,118101,106001,60,23580,4,"""1""",24960,25020
5426,106001,118001,120,23580,4,"""1""",25020,25140
5426,118001,105001,180,23580,4,"""1""",25140,25320
5426,105001,34103,60,23580,4,"""1""",25320,25380
5426,34103,208102,120,23580,4,"""1""",25380,25500
5426,208102,201502,120,23580,4,"""1""",25500,25620
5426,201502,203903,60,23580,4,"""1""",25620,25680
5426,203903,201902,60,23580,4,"""1""",25680,25740
5426,201902,203601,60,23580,4,"""1""",25740,25800
5426,203601,204102,120,23580,4,"""1""",25800,25920
5426,204102,202001,120,23580,4,"""1""",25920,26040
5426,202001,200900,120,23580,4,"""1""",26040,26160
5426,408002,34202,120,24780,4,"""1""",24780,24900
5426,34202,407701,60,24780,4,"""1""",24900,24960
5426,407701,406501,60,24780,4,"""1""",24960,25020
5426,406501,405901,60,24780,4,"""1""",25020,25080
5426,405901,405101,60,24780,4,"""1""",25080,25140
5426,405101,402203,120,24780,4,"""1""",25140,25260
5426,402203,500701,60,24780,4,"""1""",25260,25320
5426,500701,402001,60,24780,4,"""1""",25320,25380
5426,402001,400401,120,24780,4,"""1""",25380,25500
5426,400401,501702,120,24780,4,"""1""",25500,25620
5426,501702,501801,120,24780,4,"""1""",25620,25740
5426,501801,501601,60,24780,4,"""1""",25740,25800
5426,501601,500903,60,24780,4,"""1""",25800,25860
5426,500903,502801,60,24780,4,"""1""",25860,25920
5426,502801,101001,180,24780,4,"""1""",25920,26100
5426,101001,118101,60,24780,4,"""1""",26100,26160
5426,118101,106001,60,24780,4,"""1""",26160,26220
5426,106001,118001,120,24780,4,"""1""",26220,26340
5426,118001,105001,180,24780,4,"""1""",26340,26520
5426,105001,34103,60,24780,4,"""1""",26520,26580
5426,34103,208102,120,24780,4,"""1""",26580,26700
5426,208102,201502,120,24780,4,"""1""",26700,26820
5426,201502,203903,60,24780,4,"""1""",26820,26880
5426,203903,201902,60,24780,4,"""1""",26880,26940
5426,201902,203601,60,24780,4,"""1""",26940,27000
5426,203601,204102,120,24780,4,"""1""",27000,27120
5426,204102,202001,120,24780,4,"""1""",27120,27240
5426,202001,200900,120,24780,4,"""1""",27240,27360
5427,408402,405101,240,47100,4,"""13""",47100,47340
5427,405101,402203,120,47100,4,"""13""",47340,47460
5427,402203,500701,60,47100,4,"""13""",47460,47520
5427,500701,402001,60,47100,4,"""13""",47520,47580
5427,402001,400401,120,47100,4,"""13""",47580,47700
5427,400401,400200,60,47100,4,"""13""",47700,47760
5428,405101,402203,120,41340,4,"""19""",41340,41460
5428,402203,500701,60,41340,4,"""19""",41460,41520
5428,500701,402001,60,41340,4,"""19""",41520,41580
5428,402001,400401,120,41340,4,"""19""",41580,41700
5428,400401,400200,60,41340,4,"""19""",41700,41760
5428,405101,402203,120,44940,4,"""19""",44940,45060
5428,402203,500701,60,44940,4,"""19""",45060,45120
5428,500701,402001,60,44940,4,"""19""",45120,45180
5428,402001,400401,120,44940,4,"""19""",45180,45300
5428,400401,400200,60,44940,4,"""19""",45300,45360
5429,408002,34202,120,72000,4,"""7""",72000,72120
5429,34202,407701,60,72000,4,"""7""",72120,72180
5429,407701,406501,60,72000,4,"""7""",72180,72240
5429,406501,405901,60,72000,4,"""7""",72240,72300
5429,405901,405101,60,72000,4,"""7""",72300,72360
5429,408002,34202,120,73800,4,"""7""",73800,73920
5429,34202,407701,60,73800,4,"""7""",73920,73980
5429,407701,406501,60,73800,4,"""7""",73980,74040
5429,406501,405901,60,73800,4,"""7""",74040,74100
5429,405901,405101,60,73800,4,"""7""",74100,74160
5429,408002,34202,120,75600,4,"""7""",75600,75720
5429,34202,407701,60,75600,4,"""7""",75720,75780
5429,407701,406501,60,75600,4,"""7""",75780,75840
5429,406501,405901,60,75600,4,"""7""",75840,75900
5429,405901,405101,60,75600,4,"""7""",75900,75960
5429,408002,34202,120,77400,4,"""7""",77400,77520
5429,34202,407701,60,77400,4,"""7""",77520,77580
5429,407701,406501,60,77400,4,"""7""",77580,77640
5429,406501,405901,60,77400,4,"""7""",77640,77700
5429,405901,405101,60,77400,4,"""7""",77700,77760
5429,408002,34202,120,79200,4,"""7""",79200,79320
5429,34202,407701,60,79200,4,"""7""",79320,79380
5429,407701,406501,60,79200,4,"""7""",79380,79440
5429,406501,405901,60,79200,4,"""7""",79440,79500
5429,405901,405101,60,79200,4,"""7""",79500,79560
5429,408002,34202,120,81000,4,"""7""",81000,81120
5429,34202,407701,60,81000,4,"""7""",81120,81180
5429,407701,406501,60,81000,4,"""7""",81180,81240
5429,406501,405901,60,81000,4,"""7""",81240,81300
5429,405901,405101,60,81000,4,"""7""",81300,81360
5430,200900,202002,60,22800,4,"""2""",22800,22860
5430,202002,204103,120,22800,4,"""2""",22860,22980
5430,204103,203604,60,22800,4,"""2""",22980,23040
5430,203604,201903,60,22800,4,"""2""",23040,23100
5430,201903,203900,120,22800,4,"""2""",23100,23220
5430,203900,201503,60,22800,4,"""2""",23220,23280
5430,201503,208103,120,22800,4,"""2""",23280,23400
5430,208103,34104,60,22800,4,"""2""",23400,23460
5430,34104,105002,60,22800,4,"""2""",23460,23520
5430,105002,118002,120,22800,4,"""2""",23520,23640
5430,118002,106002,60,22800,4,"""2""",23640,23700
5430,106002,118102,60,22800,4,"""2""",23700,23760
5430,118102,101004,120,22800,4,"""2""",23760,23880
5430,101004,502802,120,22800,4,"""2""",23880,24000
5430,502802,500904,120,22800,4,"""2""",24000,24120
5430,500904,501602,60,22800,4,"""2""",24120,24180
5430,501602,501802,60,22800,4,"""2""",24180,24240
5430,501802,502000,60,22800,4,"""2""",24240,24300
5430,502000,501701,120,22800,4,"""2""",24300,24420
5430,501701,400402,120,22800,4,"""2""",24420,24540
5430,400402,402002,60,22800,4,"""2""",24540,24600
5430,402002,500702,120,22800,4,"""2""",24600,24720
5430,500702,402204,60,22800,4,"""2""",24720,24780
5430,402204,405100,120,22800,4,"""2""",24780,24900
5430,405100,405902,60,22800,4,"""2""",24900,24960
5430,405902,406502,120,22800,4,"""2""",24960,25080
5430,406502,407702,60,22800,4,"""2""",25080,25140
5430,407702,34201,60,22800,4,"""2""",25140,25200
5430,34201,408004,180,22800,4,"""2""",25200,25380
5430,200900,202002,60,24000,4,"""2""",24000,24060
5430,202002,204103,120,24000,4,"""2""",24060,24180
5430,204103,203604,60,24000,4,"""2""",24180,24240
5430,203604,201903,60,24000,4,"""2""",24240,24300
5430,201903,203900,120,24000,4,"""2""",24300,24420
5430,203900,201503,60,24000,4,"""2""",24420,24480
5430,201503,208103,120,24000,4,"""2""",24480,24600
5430,208103,34104,60,24000,4,"""2""",24600,24660
5430,34104,105002,60,24000,4,"""2""",24660,24720
5430,105002,118002,120,24000,4,"""2""",24720,24840
5430,118002,106002,60,24000,4,"""2""",24840,24900
5430,106002,118102,60,24000,4,"""2""",24900,24960
5430,118102,101004,120,24000,4,"""2""",24960,25080
5430,101004,502802,120,24000,4,"""2""",25080,25200
5430,502802,500904,120,24000,4,"""2""",25200,25320
5430,500904,501602,60,24000,4,"""2""",25320,25380
5430,501602,501802,60,24000,4,"""2""",25380,25440
5430,501802,502000,60,24000,4,"""2""",25440,25500
5430,502000,501701,120,24000,4,"""2""",25500,25620
5430,501701,400402,120,24000,4,"""2""",25620,25740
5430,400402,402002,60,24000,4,"""2""",25740,25800
5430,402002,500702,120,24000,4,"""2""",25800,25920
5430,500702,402204,60,24000,4,"""2""",25920,25980
5430,402204,405100,120,24000,4,"""2""",25980,26100
5430,405100,405902,60,24000,4,"""2""",26100,26160
5430,405902,406502,120,24000,4,"""2""",26160,26280
5430,406502,407702,60,24000,4,"""2""",26280,26340
5430,407702,34201,60,24000,4,"""2""",26340,26400
5430,34201,408004,180,24000,4,"""2""",26400,26580
5430,200900,202002,60,25200,4,"""2""",25200,25260
5430,202002,204103,120,25200,4,"""2""",25260,25380
5430,204103,203604,60,25200,4,"""2""",25380,25440
5430,203604,201903,60,25200,4,"""2""",25440,25500
5430,201903,203900,120,25200,4,"""2""",25500,25620
5430,203900,201503,60,25200,4,"""2""",25620,25680
5430,201503,208103,120,25200,4,"""2""",25680,25800
5430,208103,34104,60,25200,4,"""2""",25800,25860
5430,34104,105002,60,25200,4,"""2""",25860,25920
5430,105002,118002,120,25200,4,"""2""",25920,26040
5430,118002,106002,60,25200,4,"""2""",26040,26100
5430,106002,118102,60,25200,4,"""2""",26100,26160
5430,118102,101004,120,25200,4,"""2""",26160,26280
5430,101004,502802,120,25200,4,"""2""",26280,26400
5430,502802,500904,120,25200,4,"""2""",26400,26520
5430,500904,501602,60,25200,4,"""2""",26520,26580
5430,501602,501802,60,25200,4,"""2""",26580,26640
5430,501802,502000,60,25200,4,"""2""",26640,26700
5430,502000,501701,120,25200,4,"""2""",26700,26820
5430,501701,400402,120,25200,4,"""2""",26820,26940
5430,400402,402002,60,25200,4,"""2""",26940,27000
5430,402002,500702,120,25200,4,"""2""",27000,27120
5430,500702,402204,60,25200,4,"""2""",27120,27180
5430,402204,405100,120,25200,4,"""2""",27180,27300
5430,405100,405902,60,25200,4,"""2""",27300,27360
5430,405902,406502,120,25200,4,"""2""",27360,27480
5430,406502,407702,60,25200,4,"""2""",27480,27540
5430,407702,34201,60,25200,4,"""2""",27540,27600
5430,34201,408004,180,25200,4,"""2""",27600,27780
5430,200900,202002,60,26400,4,"""2""",26400,26460
5430,202002,204103,120,26400,4,"""2""",26460,26580
5430,204103,203604,60,26400,4,"""2""",26580,26640
5430,203604,201903,60,26400,4,"""2""",26640,26700
5430,201903,203900,120,26400,4,"""2""",26700,26820
5430,203900,201503,60,26400,4,"""2""",26820,26880
5430,201503,208103,120,26400,4,"""2""",26880,27000
5430,208103,34104,60,26400,4,"""2""",27000,27060
5430,34104,105002,60,26400,4,"""2""",27060,27120
5430,105002,118002,120,26400,4,"""2""",27120,27240
5430,118002,106002,60,26400,4,"""2""",27240,27300
5430,106002,118102,60,26400,4,"""2""",27300,27360
5430,118102,101004,120,26400,4,"""2""",27360,27480
5430,101004,502802,120,26400,4,"""2""",27480,27600
5430,502802,500904,120,26400,4,"""2""",27600,27720
5430,500904,501602,60,26400,4,"""2""",27720,27780
5430,501602,501802,60,26400,4,"""2""",27780,27840
5430,501802,502000,60,26400,4,"""2""",27840,27900
5430,502000,501701,120,26400,4,"""2""",27900,28020
5430,501701,400402,120,26400,4,"""2""",28020,28140
5430,400402,402002,60,26400,4,"""2""",28140,28200
5430,402002,500702,120,26400,4,"""2""",28200,28320
5430,500702,402204,60,26400,4,"""2""",28320,28380
5430,402204,405100,120,26400,4,"""2""",28380,28500
5430,405100,405902,60,26400,4,"""2""",28500,28560
5430,405902,406502,120,26400,4,"""2""",28560,28680
5430,406502,407702,60,26400,4,"""2""",28680,28740
5430,407702,34201,60,26400,4,"""2""",28740,28800
5430,34201,408004,180,26400,4,"""2""",28800,28980
5430,200900,202002,60,27600,4,"""2""",27600,27660
5430,202002,204103,120,27600,4,"""2""",27660,27780
5430,204103,203604,60,27600,4,"""2""",27780,27840
5430,203604,201903,60,27600,4,"""2""",27840,27900
5430,201903,203900,120,27600,4,"""2""",27900,28020
5430,203900,201503,60,27600,4,"""2""",28020,28080
5430,201503,208103,120,27600,4,"""2""",28080,28200
5430,208103,34104,60,27600,4,"""2""",28200,28260
5430,34104,105002,60,27600,4,"""2""",28260,28320
5430,105002,118002,120,27600,4,"""2""",28320,28440
5430,118002,106002,60,27600,4,"""2""",28440,28500
5430,106002,118102,60,27600,4,"""2""",28500,28560
5430,118102,101004,120,27600,4,"""2""",28560,28680
5430,101004,502802,120,27600,4,"""2""",28680,28800
5430,502802,500904,120,27600,4,"""2""",28800,28920
5430,500904,501602,60,27600,4,"""2""",28920,28980
5430,501602,501802,60,27600,4,"""2""",28980,29040
5430,501802,502000,60,27600,4,"""2""",29040,29100
5430,502000,501701,120,27600,4,"""2""",29100,29220
5430,501701,400402,120,27600,4,"""2""",29220,29340
5430,400402,402002,60,27600,4,"""2""",29340,29400
5430,402002,500702,120,27600,4,"""2""",29400,29520
5430,500702,402204,60,27600,4,"""2""",29520,29580
5430,402204,405100,120,27600,4,"""2""",29580,29700
5430,405100,405902,60,27600,4,"""2""",29700,29760
5430,405902,406502,120,27600,4,"""2""",29760,29880
5430,406502,407702,60,27600,4,"""2""",29880,29940
5430,407702,34201,60,27600,4,"""2""",29940,30000
5430,34201,408004,180,27600,4,"""2""",30000,30180
5430,200900,202002,60,28800,4,"""2""",28800,28860
5430,202002,204103,120,28800,4,"""2""",28860,28980
5430,204103,203604,60,28800,4,"""2""",28980,29040
5430,203604,201903,60,28800,4,"""2""",29040,29100
5430,201903,203900,120,28800,4,"""2""",29100,29220
5430,203900,201503,60,28800,4,"""2""",29220,29280
5430,201503,208103,120,28800,4,"""2""",29280,29400
5430,208103,34104,60,28800,4,"""2""",29400,29460
5430,34104,105002,60,28800,4,"""2""",29460,29520
5430,105002,118002,120,28800,4,"""2""",29520,29640
5430,118002,106002,60,28800,4,"""2""",29640,29700
5430,106002,118102,60,28800,4,"""2""",29700,29760
5430,118102,101004,120,28800,4,"""2""",29760,29880
5430,101004,502802,120,28800,4,"""2""",29880,30000
5430,502802,500904,120,28800,4,"""2""",30000,30120
5430,500904,501602,60,28800,4,"""2""",30120,30180
5430,501602,501802,60,28800,4,"""2""",30180,30240
5430,501802,502000,60,28800,4,"""2""",30240,30300
5430,502000,501701,120,28800,4,"""2""",30300,30420
5430,501701,400402,120,28800,4,"""2""",30420,30540
5430,400402,402002,60,28800,4,"""2""",30540,30600
5430,402002,500702,120,28800,4,"""2""",30600,30720
5430,500702,402204,60,28800,4,"""2""",30720,30780
5430,402204,405100,120,28800,4,"""2""",30780,30900
5430,405100,405902,60,28800,4,"""2""",30900,30960
5430,405902,406502,120,28800,4,"""2""",30960,31080
5430,406502,407702,60,28800,4,"""2""",31080,31140
5430,407702,34201,60,28800,4,"""2""",31140,31200
5430,34201,408004,180,28800,4,"""2""",31200,31380
5430,200900,202002,60,30000,4,"""2""",30000,30060
5430,202002,204103,120,30000,4,"""2""",30060,30180
5430,204103,203604,60,30000,4,"""2""",30180,30240
5430,203604,201903,60,30000,4,"""2""",30240,30300
5430,201903,203900,120,30000,4,"""2""",30300,30420
5430,203900,201503,60,30000,4,"""2""",30420,30480
5430,201503,208103,120,30000,4,"""2""",30480,30600
5430,208103,34104,60,30000,4,"""2""",30600,30660
5430,34104,105002,60,30000,4,"""2""",30660,30720
5430,105002,118002,120,30000,4,"""2""",30720,30840
5430,118002,106002,60,30000,4,"""2""",30840,30900
5430,106002,118102,60,30000,4,"""2""",30900,30960
5430,118102,101004,120,30000,4,"""2""",30960,31080
5430,101004,502802,120,30000,4,"""2""",31080,31200
5430,502802,500904,120,30000,4,"""2""",31200,31320
5430,500904,501602,60,30000,4,"""2""",31320,31380
5430,501602,501802,60,30000,4,"""2""",31380,31440
5430,501802,502000,60,30000,4,"""2""",31440,31500
5430,502000,501701,120,30000,4,"""2""",31500,31620
5430,501701,400402,120,30000,4,"""2""",31620,31740
5430,400402,402002,60,30000,4,"""2""",31740,31800
5430,402002,500702,120,30000,4,"""2""",31800,31920
5430,500702,402204,60,30000,4,"""2""",31920,31980
5430,402204,405100,120,30000,4,"""2""",31980,32100
5430,405100,405902,60,30000,4,"""2""",32100,32160
5430,405902,406502,120,30000,4,"""2""",32160,32280
5430,406502,407702,60,30000,4,"""2""",32280,32340
5430,407702,34201,60,30000,4,"""2""",32340,32400
5430,34201,408004,180,30000,4,"""2""",32400,32580
5430,200900,202002,60,31200,4,"""2""",31200,31260
5430,202002,204103,120,31200,4,"""2""",31260,31380
5430,204103,203604,60,31200,4,"""2""",31380,31440
5430,203604,201903,60,31200,4,"""2""",31440,31500
5430,201903,203900,120,31200,4,"""2""",31500,31620
5430,203900,201503,60,31200,4,"""2""",31620,31680
5430,201503,208103,120,31200,4,"""2""",31680,31800
5430,208103,34104,60,31200,4,"""2""",31800,31860
5430,34104,105002,60,31200,4,"""2""",31860,31920
5430,105002,118002,120,31200,4,"""2""",31920,32040
5430,118002,106002,60,31200,4,"""2""",32040,32100
5430,106002,118102,60,31200,4,"""2""",32100,32160
5430,118102,101004,120,31200,4,"""2""",32160,32280
5430,101004,502802,120,31200,4,"""2""",32280,32400
5430,502802,500904,120,31200,4,"""2""",32400,32520
5430,500904,501602,60,31200,4,"""2""",32520,32580
5430,501602,501802,60,31200,4,"""2""",32580,32640
5430,501802,502000,60,31200,4,"""2""",32640,32700
5430,502000,501701,120,31200,4,"""2""",32700,32820
5430,501701,400402,120,31200,4,"""2""",32820,32940
5430,400402,402002,60,31200,4,"""2""",32940,33000
5430,402002,500702,120,31200,4,"""2""",33000,33120
5430,500702,402204,60,31200,4,"""2""",33120,33180
5430,402204,405100,120,31200,4,"""2""",33180,33300
5430,405100,405902,60,31200,4,"""2""",33300,33360
5430,405902,406502,120,31200,4,"""2""",33360,33480
5430,406502,407702,60,31200,4,"""2""",33480,33540
5430,407702,34201,60,31200,4,"""2""",33540,33600
5430,34201,408004,180,31200,4,"""2""",33600,33780
5430,200900,202002,60,32400,4,"""2""",32400,32460
5430,202002,204103,120,32400,4,"""2""",32460,32580
5430,204103,203604,60,32400,4,"""2""",32580,32640
5430,203604,201903,60,32400,4,"""2""",32640,32700
5430,201903,203900,120,32400,4,"""2""",32700,32820
5430,203900,201503,60,32400,4,"""2""",32820,32880
5430,201503,208103,120,32400,4,"""2""",32880,33000
5430,208103,34104,60,32400,4,"""2""",33000,33060
5430,34104,105002,60,32400,4,"""2""",33060,33120
5430,105002,118002,120,32400,4,"""2""",33120,33240
5430,118002,106002,60,32400,4,"""2""",33240,33300
5430,106002,118102,60,32400,4,"""2""",33300,33360
5430,118102,101004,120,32400,4,"""2""",33360,33480
5430,101004,502802,120,32400,4,"""2""",33480,33600
5430,502802,500904,120,32400,4,"""2""",33600,33720
5430,500904,501602,60,32400,4,"""2""",33720,33780
5430,501602,501802,60,32400,4,"""2""",33780,33840
5430,501802,502000,60,32400,4,"""2""",33840,33900
5430,502000,501701,120,32400,4,"""2""",33900,34020
5430,501701,400402,120,32400,4,"""2""",34020,34140
5430,400402,402002,60,32400,4,"""2""",34140,34200
5430,402002,500702,120,32400,4,"""2""",34200,34320
5430,500702,402204,60,32400,4,"""2""",34320,34380
5430,402204,405100,120,32400,4,"""2""",34380,34500
5430,405100,405902,60,32400,4,"""2""",34500,34560
5430,405902,406502,120,32400,4,"""2""",34560,34680
5430,406502,407702,60,32400,4,"""2""",34680,34740
5430,407702,34201,60,32400,4,"""2""",34740,34800
5430,34201,408004,180,32400,4,"""2""",34800,34980
5430,200900,202002,60,33600,4,"""2""",33600,33660
5430,202002,204103,120,33600,4,"""2""",33660,33780
5430,204103,203604,60,33600,4,"""2""",33780,33840
5430,203604,201903,60,33600,4,"""2""",33840,33900
5430,201903,203900,120,33600,4,"""2""",33900,34020
5430,203900,201503,60,33600,4,"""2""",34020,34080
5430,201503,208103,120,33600,4,"""2""",34080,34200
5430,208103,34104,60,33600,4,"""2""",34200,34260
5430,34104,105002,60,33600,4,"""2""",34260,34320
5430,105002,118002,120,33600,4,"""2""",34320,34440
5430,118002,106002,60,33600,4,"""2""",34440,34500
5430,106002,118102,60,33600,4,"""2""",34500,34560
5430,118102,101004,120,33600,4,"""2""",34560,34680
5430,101004,502802,120,33600,4,"""2""",34680,34800
5430,502802,500904,120,33600,4,"""2""",34800,34920
5430,500904,501602,60,33600,4,"""2""",34920,34980
5430,501602,501802,60,33600,4,"""2""",34980,35040
5430,501802,502000,60,33600,4,"""2""",35040,35100
5430,502000,501701,120,33600,4,"""2""",35100,35220
5430,501701,400402,120,33600,4,"""2""",35220,35340
5430,400402,402002,60,33600,4,"""2""",35340,35400
5430,402002,500702,120,33600,4,"""2""",35400,35520
5430,500702,402204,60,33600,4,"""2""",35520,35580
5430,402204,405100,120,33600,4,"""2""",35580,35700
5430,405100,405902,60,33600,4,"""2""",35700,35760
5430,405902,406502,120,33600,4,"""2""",35760,35880
5430,406502,407702,60,33600,4,"""2""",35880,35940
5430,407702,34201,60,33600,4,"""2""",35940,36000
5430,34201,408004,180,33600,4,"""2""",36000,36180
5430,200900,202002,60,34800,4,"""2""",34800,34860
5430,202002,204103,120,34800,4,"""2""",34860,34980
5430,204103,203604,60,34800,4,"""2""",34980,35040
5430,203604,201903,60,34800,4,"""2""",35040,35100
5430,201903,203900,120,34800,4,"""2""",35100,35220
5430,203900,201503,60,34800,4,"""2""",35220,35280
5430,201503,208103,120,34800,4,"""2""",35280,35400
5430,208103,34104,60,34800,4,"""2""",35400,35460
5430,34104,105002,60,34800,4,"""2""",35460,35520
5430,105002,118002,120,34800,4,"""2""",35520,35640
5430,118002,106002,60,34800,4,"""2""",35640,35700
5430,106002,118102,60,34800,4,"""2""",35700,35760
5430,118102,101004,120,34800,4,"""2""",35760,35880
5430,101004,502802,120,34800,4,"""2""",35880,36000
5430,502802,500904,120,34800,4,"""2""",36000,36120
5430,500904,501602,60,34800,4,"""2""",36120,36180
5430,501602,501802,60,34800,4,"""2""",36180,36240
5430,501802,502000,60,34800,4,"""2""",36240,36300
5430,502000,501701,120,34800,4,"""2""",36300,36420
5430,501701,400402,120,34800,4,"""2""",36420,36540
5430,400402,402002,60,34800,4,"""2""",36540,36600
5430,402002,500702,120,34800,4,"""2""",36600,36720
5430,500702,402204,60,34800,4,"""2""",36720,36780
5430,402204,405100,120,34800,4,"""2""",36780,36900
5430,405100,405902,60,34800,4,"""2""",36900,36960
5430,405902,406502,120,34800,4,"""2""",36960,37080
5430,406502,407702,60,34800,4,"""2""",37080,37140
5430,407702,34201,60,34800,4,"""2""",37140,37200
5430,34201,408004,180,34800,4,"""2""",37200,37380
5430,200900,202002,60,36000,4,"""2""",36000,36060
5430,202002,204103,120,36000,4,"""2""",36060,36180
5430,204103,203604,60,36000,4,"""2""",36180,36240
5430,203604,201903,60,36000,4,"""2""",36240,36300
5430,201903,203900,120,36000,4,"""2""",36300,36420
5430,203900,201503,60,36000,4,"""2""",36420,36480
5430,201503,208103,120,36000,4,"""2""",36480,36600
5430,208103,34104,60,36000,4,"""2""",36600,36660
5430,34104,105002,60,36000,4,"""2""",36660,36720
5430,105002,118002,120,36000,4,"""2""",36720,36840
5430,118002,106002,60,36000,4,"""2""",36840,36900
5430,106002,118102,60,36000,4,"""2""",36900,36960
5430,118102,101004,120,36000,4,"""2""",36960,37080
5430,101004,502802,120,36000,4,"""2""",37080,37200
5430,502802,500904,120,36000,4,"""2""",37200,37320
5430,500904,501602,60,36000,4,"""2""",37320,37380
5430,501602,501802,60,36000,4,"""2""",37380,37440
5430,501802,502000,60,36000,4,"""2""",37440,37500
5430,502000,501701,120,36000,4,"""2""",37500,37620
5430,501701,400402,120,36000,4,"""2""",37620,37740
5430,400402,402002,60,36000,4,"""2""",37740,37800
5430,402002,500702,120,36000,4,"""2""",37800,37920
5430,500702,402204,60,36000,4,"""2""",37920,37980
5430,402204,405100,120,36000,4,"""2""",37980,38100
5430,405100,405902,60,36000,4,"""2""",38100,38160
5430,405902,406502,120,36000,4,"""2""",38160,38280
5430,406502,407702,60,36000,4,"""2""",38280,38340
5430,407702,34201,60,36000,4,"""2""",38340,38400
5430,34201,408004,180,36000,4,"""2""",38400,38580
5430,200900,202002,60,37200,4,"""2""",37200,37260
5430,202002,204103,120,37200,4,"""2""",37260,37380
5430,204103,203604,60,37200,4,"""2""",37380,37440
5430,203604,201903,60,37200,4,"""2""",37440,37500
5430,201903,203900,120,37200,4,"""2""",37500,37620
5430,203900,201503,60,37200,4,"""2""",37620,37680
5430,201503,208103,120,37200,4,"""2""",37680,37800
5430,208103,34104,60,37200,4,"""2""",37800,37860
5430,34104,105002,60,37200,4,"""2""",37860,37920
5430,105002,118002,120,37200,4,"""2""",37920,38040
5430,118002,106002,60,37200,4,"""2""",38040,38100
5430,106002,118102,60,37200,4,"""2""",38100,38160
5430,118102,101004,120,37200,4,"""2""",38160,38280
5430,101004,502802,120,37200,4,"""2""",38280,38400
5430,502802,500904,120,37200,4,"""2""",38400,38520
5430,500904,501602,60,37200,4,"""2""",38520,38580
5430,501602,501802,60,37200,4,"""2""",38580,38640
5430,501802,502000,60,37200,4,"""2""",38640,38700
5430,502000,501701,120,37200,4,"""2""",38700,38820
5430,501701,400402,120,37200,4,"""2""",38820,38940
5430,400402,402002,60,37200,4,"""2""",38940,39000
5430,402002,500702,120,37200,4,"""2""",39000,39120
5430,500702,402204,60,37200,4,"""2""",39120,39180
5430,402204,405100,120,37200,4,"""2""",39180,39300
5430,405100,405902,60,37200,4,"""2""",39300,39360
5430,405902,406502,120,37200,4,"""2""",39360,39480
5430,406502,407702,60,37200,4,"""2""",39480,39540
5430,407702,34201,60,37200,4,"""2""",39540,39600
5430,34201,408004,180,37200,4,"""2""",39600,39780
5430,200900,202002,60,38400,4,"""2""",38400,38460
5430,202002,204103,120,38400,4,"""2""",38460,38580
5430,204103,203604,60,38400,4,"""2""",38580,38640
5430,203604,201903,60,38400,4,"""2""",38640,38700
5430,201903,203900,120,38400,4,"""2""",38700,38820
5430,203900,201503,60,38400,4,"""2""",38820,38880
5430,201503,208103,120,38400,4,"""2""",38880,39000
5430,208103,34104,60,38400,4,"""2""",39000,39060
5430,34104,105002,60,38400,4,"""2""",39060,39120
5430,105002,118002,120,38400,4,"""2""",39120,39240
5430,118002,106002,60,38400,4,"""2""",39240,39300
5430,106002,118102,60,38400,4,"""2""",39300,39360
5430,118102,101004,120,38400,4,"""2""",39360,39480
5430,101004,502802,120,38400,4,"""2""",39480,39600
5430,502802,500904,120,38400,4,"""2""",39600,39720
5430,500904,501602,60,38400,4,"""2""",39720,39780
5430,501602,501802,60,38400,4,"""2""",39780,39840
5430,501802,502000,60,38400,4,"""2""",39840,39900
5430,502000,501701,120,38400,4,"""2""",39900,40020
5430,501701,400402,120,38400,4,"""2""",40020,40140
5430,400402,402002,60,38400,4,"""2""",40140,40200
5430,402002,500702,120,38400,4,"""2""",40200,40320
5430,500702,402204,60,38400,4,"""2""",40320,40380
5430,402204,405100,120,38400,4,"""2""",40380,40500
5430,405100,405902,60,38400,4,"""2""",40500,40560
5430,405902,406502,120,38400,4,"""2""",40560,40680
5430,406502,407702,60,38400,4,"""2""",40680,40740
5430,407702,34201,60,38400,4,"""2""",40740,40800
5430,34201,408004,180,38400,4,"""2""",40800,40980
5430,200900,202002,60,39600,4,"""2""",39600,39660
5430,202002,204103,120,39600,4,"""2""",39660,39780
5430,204103,203604,60,39600,4,"""2""",39780,39840
5430,203604,201903,60,39600,4,"""2""",39840,39900
5430,201903,203900,120,39600,4,"""2""",39900,40020
5430,203900,201503,60,39600,4,"""2""",40020,40080
5430,201503,208103,120,39600,4,"""2""",40080,40200
5430,208103,34104,60,39600,4,"""2""",40200,40260
5430,34104,105002,60,39600,4,"""2""",40260,40320
5430,105002,118002,120,39600,4,"""2""",40320,40440
5430,118002,106002,60,39600,4,"""2""",40440,40500
5430,106002,118102,60,39600,4,"""2""",40500,40560
5430,118102,101004,120,39600,4,"""2""",40560,40680
5430,101004,502802,120,39600,4,"""2""",40680,40800
5430,502802,500904,120,39600,4,"""2""",40800,40920
5430,500904,501602,60,39600,4,"""2""",40920,40980
5430,501602,501802,60,39600,4,"""2""",40980,41040
5430,501802,502000,60,39600,4,"""2""",41040,41100
5430,502000,501701,120,39600,4,"""2""",41100,41220
5430,501701,400402,120,39600,4,"""2""",41220,41340
5430,400402,402002,60,39600,4,"""2""",41340,41400
5430,402002,500702,120,39600,4,"""2""",41400,41520
5430,500702,402204,60,39600,4,"""2""",41520,41580
5430,402204,405100,120,39600,4,"""2""",41580,41700
5430,405100,405902,60,39600,4,"""2""",41700,41760
5430,405902,406502,120,39600,4,"""2""",41760,41880
5430,406502,407702,60,39600,4,"""2""",41880,41940
5430,407702,34201,60,39600,4,"""2""",41940,42000
5430,34201,408004,180,39600,4,"""2""",42000,42180
5430,200900,202002,60,40800,4,"""2""",40800,40860
5430,202002,204103,120,40800,4,"""2""",40860,40980
5430,204103,203604,60,40800,4,"""2""",40980,41040
5430,203604,201903,60,40800,4,"""2""",41040,41100
5430,201903,203900,120,40800,4,"""2""",41100,41220
5430,203900,201503,60,40800,4,"""2""",41220,41280
5430,201503,208103,120,40800,4,"""2""",41280,41400
5430,208103,34104,60,40800,4,"""2""",41400,41460
5430,34104,105002,60,40800,4,"""2""",41460,41520
5430,105002,118002,120,40800,4,"""2""",41520,41640
5430,118002,106002,60,40800,4,"""2""",41640,41700
5430,106002,118102,60,40800,4,"""2""",41700,41760
5430,118102,101004,120,40800,4,"""2""",41760,41880
5430,101004,502802,120,40800,4,"""2""",41880,42000
5430,502802,500904,120,40800,4,"""2""",42000,42120
5430,500904,501602,60,40800,4,"""2""",42120,42180
5430,501602,501802,60,40800,4,"""2""",42180,42240
5430,501802,502000,60,40800,4,"""2""",42240,42300
5430,502000,501701,120,40800,4,"""2""",42300,42420
5430,501701,400402,120,40800,4,"""2""",42420,42540
5430,400402,402002,60,40800,4,"""2""",42540,42600
5430,402002,500702,120,40800,4,"""2""",42600,42720
5430,500702,402204,60,40800,4,"""2""",42720,42780
5430,402204,405100,120,40800,4,"""2""",42780,42900
5430,405100,405902,60,40800,4,"""2""",42900,42960
5430,405902,406502,120,40800,4,"""2""",42960,43080
5430,406502,407702,60,40800,4,"""2""",43080,43140
5430,407702,34201,60,40800,4,"""2""",43140,43200
5430,34201,408004,180,40800,4,"""2""",43200,43380
5430,200900,202002,60,42000,4,"""2""",42000,42060
5430,202002,204103,120,42000,4,"""2""",42060,42180
5430,204103,203604,60,42000,4,"""2""",42180,42240
5430,203604,201903,60,42000,4,"""2""",42240,42300
5430,201903,203900,120,42000,4,"""2""",42300,42420
5430,203900,201503,60,42000,4,"""2""",42420,42480
5430,201503,208103,120,42000,4,"""2""",42480,42600
5430,208103,34104,60,42000,4,"""2""",42600,42660
5430,34104,105002,60,42000,4,"""2""",42660,42720
5430,105002,118002,120,42000,4,"""2""",42720,42840
5430,118002,106002,60,42000,4,"""2""",42840,42900
5430,106002,118102,60,42000,4,"""2""",42900,42960
5430,118102,101004,120,42000,4,"""2""",42960,43080
5430,101004,502802,120,42000,4,"""2""",43080,43200
5430,502802,500904,120,42000,4,"""2""",43200,43320
5430,500904,501602,60,42000,4,"""2""",43320,43380
5430,501602,501802,60,42000,4,"""2""",43380,43440
5430,501802,502000,60,42000,4,"""2""",43440,43500
5430,502000,501701,120,42000,4,"""2""",43500,43620
5430,501701,400402,120,42000,4,"""2""",43620,43740
5430,400402,402002,60,42000,4,"""2""",43740,43800
5430,402002,500702,120,42000,4,"""2""",43800,43920
5430,500702,402204,60,42000,4,"""2""",43920,43980
5430,402204,405100,120,42000,4,"""2""",43980,44100
5430,405100,405902,60,42000,4,"""2""",44100,44160
5430,405902,406502,120,42000,4,"""2""",44160,44280
5430,406502,407702,60,42000,4,"""2""",44280,44340
5430,407702,34201,60,42000,4,"""2""",44340,44400
5430,34201,408004,180,42000,4,"""2""",44400,44580
5430,200900,202002,60,43200,4,"""2""",43200,43260
5430,202002,204103,120,43200,4,"""2""",43260,43380
5430,204103,203604,60,43200,4,"""2""",43380,43440
5430,203604,201903,60,43200,4,"""2""",43440,43500
5430,201903,203900,120,43200,4,"""2""",43500,43620
5430,203900,201503,60,43200,4,"""2""",43620,43680
5430,201503,208103,120,43200,4,"""2""",43680,43800
5430,208103,34104,60,43200,4,"""2""",43800,43860
5430,34104,105002,60,43200,4,"""2""",43860,43920
5430,105002,118002,120,43200,4,"""2""",43920,44040
5430,118002,106002,60,43200,4,"""2""",44040,44100
5430,106002,118102,60,43200,4,"""2""",44100,44160
5430,118102,101004,120,43200,4,"""2""",44160,44280
5430,101004,502802,120,43200,4,"""2""",44280,44400
5430,502802,500904,120,43200,4,"""2""",44400,44520
5430,500904,501602,60,43200,4,"""2""",44520,44580
5430,501602,501802,60,43200,4,"""2""",44580,44640
5430,501802,502000,60,43200,4,"""2""",44640,44700
5430,502000,501701,120,43200,4,"""2""",44700,44820
5430,501701,400402,120,43200,4,"""2""",44820,44940
5430,400402,402002,60,43200,4,"""2""",44940,45000
5430,402002,500702,120,43200,4,"""2""",45000,45120
5430,500702,402204,60,43200,4,"""2""",45120,45180
5430,402204,405100,120,43200,4,"""2""",45180,45300
5430,405100,405902,60,43200,4,"""2""",45300,45360
5430,405902,406502,120,43200,4,"""2""",45360,45480
5430,406502,407702,60,43200,4,"""2""",45480,45540
5430,407702,34201,60,43200,4,"""2""",45540,45600
5430,34201,408004,180,43200,4,"""2""",45600,45780
5430,200900,202002,60,44400,4,"""2""",44400,44460
5430,202002,204103,120,44400,4,"""2""",44460,44580
5430,204103,203604,60,44400,4,"""2""",44580,44640
5430,203604,201903,60,44400,4,"""2""",44640,44700
5430,201903,203900,120,44400,4,"""2""",44700,44820
5430,203900,201503,60,44400,4,"""2""",44820,44880
5430,201503,208103,120,44400,4,"""2""",44880,45000
5430,208103,34104,60,44400,4,"""2""",45000,45060
5430,34104,105002,60,44400,4,"""2""",45060,45120
5430,105002,118002,120,44400,4,"""2""",45120,45240
5430,118002,106002,60,44400,4,"""2""",45240,45300
5430,106002,118102,60,44400,4,"""2""",45300,45360
5430,118102,101004,120,44400,4,"""2""",45360,45480
5430,101004,502802,120,44400,4,"""2""",45480,45600
5430,502802,500904,120,44400,4,"""2""",45600,45720
5430,500904,501602,60,44400,4,"""2""",45720,45780
5430,501602,501802,60,44400,4,"""2""",45780,45840
5430,501802,502000,60,44400,4,"""2""",45840,45900
5430,502000,501701,120,44400,4,"""2""",45900,46020
5430,501701,400402,120,44400,4,"""2""",46020,46140
5430,400402,402002,60,44400,4,"""2""",46140,46200
5430,402002,500702,120,44400,4,"""2""",46200,46320
5430,500702,402204,60,44400,4,"""2""",46320,46380
5430,402204,405100,120,44400,4,"""2""",46380,46500
5430,405100,405902,60,44400,4,"""2""",46500,46560
5430,405902,406502,120,44400,4,"""2""",46560,46680
5430,406502,407702,60,44400,4,"""2""",46680,46740
5430,407702,34201,60,44400,4,"""2""",46740,46800
5430,34201,408004,180,44400,4,"""2""",46800,46980
5430,200900,202002,60,45600,4,"""2""",45600,45660
5430,202002,204103,120,45600,4,"""2""",45660,45780
5430,204103,203604,60,45600,4,"""2""",45780,45840
5430,203604,201903,60,45600,4,"""2""",45840,45900
5430,201903,203900,120,45600,4,"""2""",45900,46020
5430,203900,201503,60,45600,4,"""2""",46020,46080
5430,201503,208103,120,45600,4,"""2""",46080,46200
5430,208103,34104,60,45600,4,"""2""",46200,46260
5430,34104,105002,60,45600,4,"""2""",46260,46320
5430,105002,118002,120,45600,4,"""2""",46320,46440
5430,118002,106002,60,45600,4,"""2""",46440,46500
5430,106002,118102,60,45600,4,"""2""",46500,46560
5430,118102,101004,120,45600,4,"""2""",46560,46680
5430,101004,502802,120,45600,4,"""2""",46680,46800
5430,502802,500904,120,45600,4,"""2""",46800,46920
5430,500904,501602,60,45600,4,"""2""",46920,46980
5430,501602,501802,60,45600,4,"""2""",46980,47040
5430,501802,502000,60,45600,4,"""2""",47040,47100
5430,502000,501701,120,45600,4,"""2""",47100,47220
5430,501701,400402,120,45600,4,"""2""",47220,47340
5430,400402,402002,60,45600,4,"""2""",47340,47400
5430,402002,500702,120,45600,4,"""2""",47400,47520
5430,500702,402204,60,45600,4,"""2""",47520,47580
5430,402204,405100,120,45600,4,"""2""",47580,47700
5430,405100,405902,60,45600,4,"""2""",47700,47760
5430,405902,406502,120,45600,4,"""2""",47760,47880
5430,406502,407702,60,45600,4,"""2""",47880,47940
5430,407702,34201,60,45600,4,"""2""",47940,48000
5430,34201,408004,180,45600,4,"""2""",48000,48180
5430,200900,202002,60,46800,4,"""2""",46800,46860
5430,202002,204103,120,46800,4,"""2""",46860,46980
5430,204103,203604,60,46800,4,"""2""",46980,47040
5430,203604,201903,60,46800,4,"""2""",47040,47100
5430,201903,203900,120,46800,4,"""2""",47100,47220
5430,203900,201503,60,46800,4,"""2""",47220,47280
5430,201503,208103,120,46800,4,"""2""",47280,47400
5430,208103,34104,60,46800,4,"""2""",47400,47460
5430,34104,105002,60,46800,4,"""2""",47460,47520
5430,105002,118002,120,46800,4,"""2""",47520,47640
5430,118002,106002,60,46800,4,"""2""",47640,47700
5430,106002,118102,60,46800,4,"""2""",47700,47760
5430,118102,101004,120,46800,4,"""2""",47760,47880
5430,101004,502802,120,46800,4,"""2""",47880,48000
5430,502802,500904,120,46800,4,"""2""",48000,48120
5430,500904,501602,60,46800,4,"""2""",48120,48180
5430,501602,501802,60,46800,4,"""2""",48180,48240
5430,501802,502000,60,46800,4,"""2""",48240,48300
5430,502000,501701,120,46800,4,"""2""",48300,48420
5430,501701,400402,120,46800,4,"""2""",48420,48540
5430,400402,402002,60,46800,4,"""2""",48540,48600
5430,402002,500702,120,46800,4,"""2""",48600,48720
5430,500702,402204,60,46800,4,"""2""",48720,48780
5430,402204,405100,120,46800,4,"""2""",48780,48900
5430,405100,405902,60,46800,4,"""2""",48900,48960
5430,405902,406502,120,46800,4,"""2""",48960,49080
5430,406502,407702,60,46800,4,"""2""",49080,49140
5430,407702,34201,60,46800,4,"""2""",49140,49200
5430,34201,408004,180,46800,4,"""2""",49200,49380
5430,200900,202002,60,48000,4,"""2""",48000,48060
5430,202002,204103,120,48000,4,"""2""",48060,48180
5430,204103,203604,60,48000,4,"""2""",48180,48240
5430,203604,201903,60,48000,4,"""2""",48240,48300
5430,201903,203900,120,48000,4,"""2""",48300,48420
5430,203900,201503,60,48000,4,"""2""",48420,48480
5430,201503,208103,120,48000,4,"""2""",48480,48600
5430,208103,34104,60,48000,4,"""2""",48600,48660
5430,34104,105002,60,48000,4,"""2""",48660,48720
5430,105002,118002,120,48000,4,"""2""",48720,48840
5430,118002,106002,60,48000,4,"""2""",48840,48900
5430,106002,118102,60,48000,4,"""2""",48900,48960
5430,118102,101004,120,48000,4,"""2""",48960,49080
5430,101004,502802,120,48000,4,"""2""",49080,49200
5430,502802,500904,120,48000,4,"""2""",49200,49320
5430,500904,501602,60,48000,4,"""2""",49320,49380
5430,501602,501802,60,48000,4,"""2""",49380,49440
5430,501802,502000,60,48000,4,"""2""",49440,49500
5430,502000,501701,120,48000,4,"""2""",49500,49620
5430,501701,400402,120,48000,4,"""2""",49620,49740
5430,400402,402002,60,48000,4,"""2""",49740,49800
5430,402002,500702,120,48000,4,"""2""",49800,49920
5430,500702,402204,60,48000,4,"""2""",49920,49980
5430,402204,405100,120,48000,4,"""2""",49980,50100
5430,405100,405902,60,48000,4,"""2""",50100,50160
5430,405902,406502,120,48000,4,"""2""",50160,50280
5430,406502,407702,60,48000,4,"""2""",50280,50340
5430,407702,34201,60,48000,4,"""2""",50340,50400
5430,34201,408004,180,48000,4,"""2""",50400,50580
5430,200900,202002,60,49200,4,"""2""",49200,49260
5430,202002,204103,120,49200,4,"""2""",49260,49380
5430,204103,203604,60,49200,4,"""2""",49380,49440
5430,203604,201903,60,49200,4,"""2""",49440,49500
5430,201903,203900,120,49200,4,"""2""",49500,49620
5430,203900,201503,60,49200,4,"""2""",49620,49680
5430,201503,208103,120,49200,4,"""2""",49680,49800
5430,208103,34104,60,49200,4,"""2""",49800,49860
5430,34104,105002,60,49200,4,"""2""",49860,49920
5430,105002,118002,120,49200,4,"""2""",49920,50040
5430,118002,106002,60,49200,4,"""2""",50040,50100
5430,106002,118102,60,49200,4,"""2""",50100,50160
5430,118102,101004,120,49200,4,"""2""",50160,50280
5430,101004,502802,120,49200,4,"""2""",50280,50400
5430,502802,500904,120,49200,4,"""2""",50400,50520
5430,500904,501602,60,49200,4,"""2""",50520,50580
5430,501602,501802,60,49200,4,"""2""",50580,50640
5430,501802,502000,60,49200,4,"""2""",50640,50700
5430,502000,501701,120,49200,4,"""2""",50700,50820
5430,501701,400402,120,49200,4,"""2""",50820,50940
5430,400402,402002,60,49200,4,"""2""",50940,51000
5430,402002,500702,120,49200,4,"""2""",51000,51120
5430,500702,402204,60,49200,4,"""2""",51120,51180
5430,402204,405100,120,49200,4,"""2""",51180,51300
5430,405100,405902,60,49200,4,"""2""",51300,51360
5430,405902,406502,120,49200,4,"""2""",51360,51480
5430,406502,407702,60,49200,4,"""2""",51480,51540
5430,407702,34201,60,49200,4,"""2""",51540,51600
5430,34201,408004,180,49200,4,"""2""",51600,51780
5430,200900,202002,60,50400,4,"""2""",50400,50460
5430,202002,204103,120,50400,4,"""2""",50460,50580
5430,204103,203604,60,50400,4,"""2""",50580,50640
5430,203604,201903,60,50400,4,"""2""",50640,50700
5430,201903,203900,120,50400,4,"""2""",50700,50820
5430,203900,201503,60,50400,4,"""2""",50820,50880
5430,201503,208103,120,50400,4,"""2""",50880,51000
5430,208103,34104,60,50400,4,"""2""",51000,51060
5430,34104,105002,60,50400,4,"""2""",51060,51120
5430,105002,118002,120,50400,4,"""2""",51120,51240
5430,118002,106002,60,50400,4,"""2""",51240,51300
5430,106002,118102,60,50400,4,"""2""",51300,51360
5430,118102,101004,120,50400,4,"""2""",51360,51480
5430,101004,502802,120,50400,4,"""2""",51480,51600
5430,502802,500904,120,50400,4,"""2""",51600,51720
5430,500904,501602,60,50400,4,"""2""",51720,51780
5430,501602,501802,60,50400,4,"""2""",51780,51840
5430,501802,502000,60,50400,4,"""2""",51840,51900
5430,502000,501701,120,50400,4,"""2""",51900,52020
5430,501701,400402,120,50400,4,"""2""",52020,52140
5430,400402,402002,60,50400,4,"""2""",52140,52200
5430,402002,500702,120,50400,4,"""2""",52200,52320
5430,500702,402204,60,50400,4,"""2""",52320,52380
5430,402204,405100,120,50400,4,"""2""",52380,52500
5430,405100,405902,60,50400,4,"""2""",52500,52560
5430,405902,406502,120,50400,4,"""2""",52560,52680
5430,406502,407702,60,50400,4,"""2""",52680,52740
5430,407702,34201,60,50400,4,"""2""",52740,52800
5430,34201,408004,180,50400,4,"""2""",52800,52980
5430,200900,202002,60,51600,4,"""2""",51600,51660
5430,202002,204103,120,51600,4,"""2""",51660,51780
5430,204103,203604,60,51600,4,"""2""",51780,51840
5430,203604,201903,60,51600,4,"""2""",51840,51900
5430,201903,203900,120,51600,4,"""2""",51900,52020
5430,203900,201503,60,51600,4,"""2""",52020,52080
5430,201503,208103,120,51600,4,"""2""",52080,52200
5430,208103,34104,60,51600,4,"""2""",52200,52260
5430,34104,105002,60,51600,4,"""2""",52260,52320
5430,105002,118002,120,51600,4,"""2""",52320,52440
5430,118002,106002,60,51600,4,"""2""",52440,52500
5430,106002,118102,60,51600,4,"""2""",52500,52560
5430,118102,101004,120,51600,4,"""2""",52560,52680
5430,101004,502802,120,51600,4,"""2""",52680,52800
5430,502802,500904,120,51600,4,"""2""",52800,52920
5430,500904,501602,60,51600,4,"""2""",52920,52980
5430,501602,501802,60,51600,4,"""2""",52980,53040
5430,501802,502000,60,51600,4,"""2""",53040,53100
5430,502000,501701,120,51600,4,"""2""",53100,53220
5430,501701,400402,120,51600,4,"""2""",53220,53340
5430,400402,402002,60,51600,4,"""2""",53340,53400
5430,402002,500702,120,51600,4,"""2""",53400,53520
5430,500702,402204,60,51600,4,"""2""",53520,53580
5430,402204,405100,120,51600,4,"""2""",53580,53700
5430,405100,405902,60,51600,4,"""2""",53700,53760
5430,405902,406502,120,51600,4,"""2""",53760,53880
5430,406502,407702,60,51600,4,"""2""",53880,53940
5430,407702,34201,60,51600,4,"""2""",53940,54000
5430,34201,408004,180,51600,4,"""2""",54000,54180
5430,200900,202002,60,52800,4,"""2""",52800,52860
5430,202002,204103,120,52800,4,"""2""",52860,52980
5430,204103,203604,60,52800,4,"""2""",52980,53040
5430,203604,201903,60,52800,4,"""2""",53040,53100
5430,201903,203900,120,52800,4,"""2""",53100,53220
5430,203900,201503,60,52800,4,"""2""",53220,53280
5430,201503,208103,120,52800,4,"""2""",53280,53400
5430,208103,34104,60,52800,4,"""2""",53400,53460
5430,34104,105002,60,52800,4,"""2""",53460,53520
5430,105002,118002,120,52800,4,"""2""",53520,53640
5430,118002,106002,60,52800,4,"""2""",53640,53700
5430,106002,118102,60,52800,4,"""2""",53700,53760
5430,118102,101004,120,52800,4,"""2""",53760,53880
5430,101004,502802,120,52800,4,"""2""",53880,54000
5430,502802,500904,120,52800,4,"""2""",54000,54120
5430,500904,501602,60,52800,4,"""2""",54120,54180
5430,501602,501802,60,52800,4,"""2""",54180,54240
5430,501802,502000,60,52800,4,"""2""",54240,54300
5430,502000,501701,120,52800,4,"""2""",54300,54420
5430,501701,400402,120,52800,4,"""2""",54420,54540
5430,400402,402002,60,52800,4,"""2""",54540,54600
5430,402002,500702,120,52800,4,"""2""",54600,54720
5430,500702,402204,60,52800,4,"""2""",54720,54780
5430,402204,405100,120,52800,4,"""2""",54780,54900
5430,405100,405902,60,52800,4,"""2""",54900,54960
5430,405902,406502,120,52800,4,"""2""",54960,55080
5430,406502,407702,60,52800,4,"""2""",55080,55140
5430,407702,34201,60,52800,4,"""2""",55140,55200
5430,34201,408004,180,52800,4,"""2""",55200,55380
5430,200900,202002,60,54000,4,"""2""",54000,54060
5430,202002,204103,120,54000,4,"""2""",54060,54180
5430,204103,203604,60,54000,4,"""2""",54180,54240
5430,203604,201903,60,54000,4,"""2""",54240,54300
5430,201903,203900,120,54000,4,"""2""",54300,54420
5430,203900,201503,60,54000,4,"""2""",54420,54480
5430,201503,208103,120,54000,4,"""2""",54480,54600
5430,208103,34104,60,54000,4,"""2""",54600,54660
5430,34104,105002,60,54000,4,"""2""",54660,54720
5430,105002,118002,120,54000,4,"""2""",54720,54840
5430,118002,106002,60,54000,4,"""2""",54840,54900
5430,106002,118102,60,54000,4,"""2""",54900,54960
5430,118102,101004,120,54000,4,"""2""",54960,55080
5430,101004,502802,120,54000,4,"""2""",55080,55200
5430,502802,500904,120,54000,4,"""2""",55200,55320
5430,500904,501602,60,54000,4,"""2""",55320,55380
5430,501602,501802,60,54000,4,"""2""",55380,55440
5430,501802,502000,60,54000,4,"""2""",55440,55500
5430,502000,501701,120,54000,4,"""2""",55500,55620
5430,501701,400402,120,54000,4,"""2""",55620,55740
5430,400402,402002,60,54000,4,"""2""",55740,55800
5430,402002,500702,120,54000,4,"""2""",55800,55920
5430,500702,402204,60,54000,4,"""2""",55920,55980
5430,402204,405100,120,54000,4,"""2""",55980,56100
5430,405100,405902,60,54000,4,"""2""",56100,56160
5430,405902,406502,120,54000,4,"""2""",56160,56280
5430,406502,407702,60,54000,4,"""2""",56280,56340
5430,407702,34201,60,54000,4,"""2""",56340,56400
5430,34201,408004,180,54000,4,"""2""",56400,56580
5430,200900,202002,60,55200,4,"""2""",55200,55260
5430,202002,204103,120,55200,4,"""2""",55260,55380
5430,204103,203604,60,55200,4,"""2""",55380,55440
5430,203604,201903,60,55200,4,"""2""",55440,55500
5430,201903,203900,120,55200,4,"""2""",55500,55620
5430,203900,201503,60,55200,4,"""2""",55620,55680
5430,201503,208103,120,55200,4,"""2""",55680,55800
5430,208103,34104,60,55200,4,"""2""",55800,55860
5430,34104,105002,60,55200,4,"""2""",55860,55920
5430,105002,118002,120,55200,4,"""2""",55920,56040
5430,118002,106002,60,55200,4,"""2""",56040,56100
5430,106002,118102,60,55200,4,"""2""",56100,56160
5430,118102,101004,120,55200,4,"""2""",56160,56280
5430,101004,502802,120,55200,4,"""2""",56280,56400
5430,502802,500904,120,55200,4,"""2""",56400,56520
5430,500904,501602,60,55200,4,"""2""",56520,56580
5430,501602,501802,60,55200,4,"""2""",56580,56640
5430,501802,502000,60,55200,4,"""2""",56640,56700
5430,502000,501701,120,55200,4,"""2""",56700,56820
5430,501701,400402,120,55200,4,"""2""",56820,56940
5430,400402,402002,60,55200,4,"""2""",56940,57000
5430,402002,500702,120,55200,4,"""2""",57000,57120
5430,500702,402204,60,55200,4,"""2""",57120,57180
5430,402204,405100,120,55200,4,"""2""",57180,57300
5430,405100,405902,60,55200,4,"""2""",57300,57360
5430,405902,406502,120,55200,4,"""2""",57360,57480
5430,406502,407702,60,55200,4,"""2""",57480,57540
5430,407702,34201,60,55200,4,"""2""",57540,57600
5430,34201,408004,180,55200,4,"""2""",57600,57780
5430,200900,202002,60,56400,4,"""2""",56400,56460
5430,202002,204103,120,56400,4,"""2""",56460,56580
5430,204103,203604,60,56400,4,"""2""",56580,56640
5430,203604,201903,60,56400,4,"""2""",56640,56700
5430,201903,203900,120,56400,4,"""2""",56700,56820
5430,203900,201503,60,56400,4,"""2""",56820,56880
5430,201503,208103,120,56400,4,"""2""",56880,57000
5430,208103,34104,60,56400,4,"""2""",57000,57060
5430,34104,105002,60,56400,4,"""2""",57060,57120
5430,105002,118002,120,56400,4,"""2""",57120,57240
5430,118002,106002,60,56400,4,"""2""",57240,57300
5430,106002,118102,60,56400,4,"""2""",57300,57360
5430,118102,101004,120,56400,4,"""2""",57360,57480
5430,101004,502802,120,56400,4,"""2""",57480,57600
5430,502802,500904,120,56400,4,"""2""",57600,57720
5430,500904,501602,60,56400,4,"""2""",57720,57780
5430,501602,501802,60,56400,4,"""2""",57780,57840
5430,501802,502000,60,56400,4,"""2""",57840,57900
5430,502000,501701,120,56400,4,"""2""",57900,58020
5430,501701,400402,120,56400,4,"""2""",58020,58140
5430,400402,402002,60,56400,4,"""2""",58140,58200
5430,402002,500702,120,56400,4,"""2""",58200,58320
5430,500702,402204,60,56400,4,"""2""",58320,58380
5430,402204,405100,120,56400,4,"""2""",58380,58500
5430,405100,405902,60,56400,4,"""2""",58500,58560
5430,405902,406502,120,56400,4,"""2""",58560,58680
5430,406502,407702,60,56400,4,"""2""",58680,58740
5430,407702,34201,60,56400,4,"""2""",58740,58800
5430,34201,408004,180,56400,4,"""2""",58800,58980
5430,200900,202002,60,57600,4,"""2""",57600,57660
5430,202002,204103,120,57600,4,"""2""",57660,57780
5430,204103,203604,60,57600,4,"""2""",57780,57840
5430,203604,201903,60,57600,4,"""2""",57840,57900
5430,201903,203900,120,57600,4,"""2""",57900,58020
5430,203900,201503,60,57600,4,"""2""",58020,58080
5430,201503,208103,120,57600,4,"""2""",58080,58200
5430,208103,34104,60,57600,4,"""2""",58200,58260
5430,34104,105002,60,57600,4,"""2""",58260,58320
5430,105002,118002,120,57600,4,"""2""",58320,58440
5430,118002,106002,60,57600,4,"""2""",58440,58500
5430,106002,118102,60,57600,4,"""2""",58500,58560
5430,118102,101004,120,57600,4,"""2""",58560,58680
5430,101004,502802,120,57600,4,"""2""",58680,58800
5430,502802,500904,120,57600,4,"""2""",58800,58920
5430,500904,501602,60,57600,4,"""2""",58920,58980
5430,501602,501802,60,57600,4,"""2""",58980,59040
5430,501802,502000,60,57600,4,"""2""",59040,59100
5430,502000,501701,120,57600,4,"""2""",59100,59220
5430,501701,400402,120,57600,4,"""2""",59220,59340
5430,400402,402002,60,57600,4,"""2""",59340,59400
5430,402002,500702,120,57600,4,"""2""",59400,59520
5430,500702,402204,60,57600,4,"""2""",59520,59580
5430,402204,405100,120,57600,4,"""2""",59580,59700
5430,405100,405902,60,57600,4,"""2""",59700,59760
5430,405902,406502,120,57600,4,"""2""",59760,59880
5430,406502,407702,60,57600,4,"""2""",59880,59940
5430,407702,34201,60,57600,4,"""2""",59940,60000
5430,34201,408004,180,57600,4,"""2""",60000,60180
5430,200900,202002,60,58800,4,"""2""",58800,58860
5430,202002,204103,120,58800,4,"""2""",58860,58980
5430,204103,203604,60,58800,4,"""2""",58980,59040
5430,203604,201903,60,58800,4,"""2""",59040,59100
5430,201903,203900,120,58800,4,"""2""",59100,59220
5430,203900,201503,60,58800,4,"""2""",59220,59280
5430,201503,208103,120,58800,4,"""2""",59280,59400
5430,208103,34104,60,58800,4,"""2""",59400,59460
5430,34104,105002,60,58800,4,"""2""",59460,59520
5430,105002,118002,120,58800,4,"""2""",59520,59640
5430,118002,106002,60,58800,4,"""2""",59640,59700
5430,106002,118102,60,58800,4,"""2""",59700,59760
5430,118102,101004,120,58800,4,"""2""",59760,59880
5430,101004,502802,120,58800,4,"""2""",59880,60000
5430,502802,500904,120,58800,4,"""2""",60000,60120
5430,500904,501602,60,58800,4,"""2""",60120,60180
5430,501602,501802,60,58800,4,"""2""",60180,60240
5430,501802,502000,60,58800,4,"""2""",60240,60300
5430,502000,501701,120,58800,4,"""2""",60300,60420
5430,501701,400402,120,58800,4,"""2""",60420,60540
5430,400402,402002,60,58800,4,"""2""",60540,60600
5430,402002,500702,120,58800,4,"""2""",60600,60720
5430,500702,402204,60,58800,4,"""2""",60720,60780
5430,402204,405100,120,58800,4,"""2""",60780,60900
5430,405100,405902,60,58800,4,"""2""",60900,60960
5430,405902,406502,120,58800,4,"""2""",60960,61080
5430,406502,407702,60,58800,4,"""2""",61080,61140
5430,407702,34201,60,58800,4,"""2""",61140,61200
5430,34201,408004,180,58800,4,"""2""",61200,61380
5430,200900,202002,60,60000,4,"""2""",60000,60060
5430,202002,204103,120,60000,4,"""2""",60060,60180
5430,204103,203604,60,60000,4,"""2""",60180,60240
5430,203604,201903,60,60000,4,"""2""",60240,60300
5430,201903,203900,120,60000,4,"""2""",60300,60420
5430,203900,201503,60,60000,4,"""2""",60420,60480
5430,201503,208103,120,60000,4,"""2""",60480,60600
5430,208103,34104,60,60000,4,"""2""",60600,60660
5430,34104,105002,60,60000,4,"""2""",60660,60720
5430,105002,118002,120,60000,4,"""2""",60720,60840
5430,118002,106002,60,60000,4,"""2""",60840,60900
5430,106002,118102,60,60000,4,"""2""",60900,60960
5430,118102,101004,120,60000,4,"""2""",60960,61080
5430,101004,502802,120,60000,4,"""2""",61080,61200
5430,502802,500904,120,60000,4,"""2""",61200,61320
5430,500904,501602,60,60000,4,"""2""",61320,61380
5430,501602,501802,60,60000,4,"""2""",61380,61440
5430,501802,502000,60,60000,4,"""2""",61440,61500
5430,502000,501701,120,60000,4,"""2""",61500,61620
5430,501701,400402,120,60000,4,"""2""",61620,61740
5430,400402,402002,60,60000,4,"""2""",61740,61800
5430,402002,500702,120,60000,4,"""2""",61800,61920
5430,500702,402204,60,60000,4,"""2""",61920,61980
5430,402204,405100,120,60000,4,"""2""",61980,62100
5430,405100,405902,60,60000,4,"""2""",62100,62160
5430,405902,406502,120,60000,4,"""2""",62160,62280
5430,406502,407702,60,60000,4,"""2""",62280,62340
5430,407702,34201,60,60000,4,"""2""",62340,62400
5430,34201,408004,180,60000,4,"""2""",62400,62580
5430,200900,202002,60,61200,4,"""2""",61200,61260
5430,202002,204103,120,61200,4,"""2""",61260,61380
5430,204103,203604,60,61200,4,"""2""",61380,61440
5430,203604,201903,60,61200,4,"""2""",61440,61500
5430,201903,203900,120,61200,4,"""2""",61500,61620
5430,203900,201503,60,61200,4,"""2""",61620,61680
5430,201503,208103,120,61200,4,"""2""",61680,61800
5430,208103,34104,60,61200,4,"""2""",61800,61860
5430,34104,105002,60,61200,4,"""2""",61860,61920
5430,105002,118002,120,61200,4,"""2""",61920,62040
5430,118002,106002,60,61200,4,"""2""",62040,62100
5430,106002,118102,60,61200,4,"""2""",62100,62160
5430,118102,101004,120,61200,4,"""2""",62160,62280
5430,101004,502802,120,61200,4,"""2""",62280,62400
5430,502802,500904,120,61200,4,"""2""",62400,62520
5430,500904,501602,60,61200,4,"""2""",62520,62580
5430,501602,501802,60,61200,4,"""2""",62580,62640
5430,501802,502000,60,61200,4,"""2""",62640,62700
5430,502000,501701,120,61200,4,"""2""",62700,62820
5430,501701,400402,120,61200,4,"""2""",62820,62940
5430,400402,402002,60,61200,4,"""2""",62940,63000
5430,402002,500702,120,61200,4,"""2""",63000,63120
5430,500702,402204,60,61200,4,"""2""",63120,63180
5430,402204,405100,120,61200,4,"""2""",63180,63300
5430,405100,405902,60,61200,4,"""2""",63300,63360
5430,405902,406502,120,61200,4,"""2""",63360,63480
5430,406502,407702,60,61200,4,"""2""",63480,63540
5430,407702,34201,60,61200,4,"""2""",63540,63600
5430,34201,408004,180,61200,4,"""2""",63600,63780
5430,200900,202002,60,62400,4,"""2""",62400,62460
5430,202002,204103,120,62400,4,"""2""",62460,62580
5430,204103,203604,60,62400,4,"""2""",62580,62640
5430,203604,201903,60,62400,4,"""2""",62640,62700
5430,201903,203900,120,62400,4,"""2""",62700,62820
5430,203900,201503,60,62400,4,"""2""",62820,62880
5430,201503,208103,120,62400,4,"""2""",62880,63000
5430,208103,34104,60,62400,4,"""2""",63000,63060
5430,34104,105002,60,62400,4,"""2""",63060,63120
5430,105002,118002,120,62400,4,"""2""",63120,63240
5430,118002,106002,60,62400,4,"""2""",63240,63300
5430,106002,118102,60,62400,4,"""2""",63300,63360
5430,118102,101004,120,62400,4,"""2""",63360,63480
5430,101004,502802,120,62400,4,"""2""",63480,63600
5430,502802,500904,120,62400,4,"""2""",63600,63720
5430,500904,501602,60,62400,4,"""2""",63720,63780
5430,501602,501802,60,62400,4,"""2""",63780,63840
5430,501802,502000,60,62400,4,"""2""",63840,63900
5430,502000,501701,120,62400,4,"""2""",63900,64020
5430,501701,400402,120,62400,4,"""2""",64020,64140
5430,400402,402002,60,62400,4,"""2""",64140,64200
5430,402002,500702,120,62400,4,"""2""",64200,64320
5430,500702,402204,60,62400,4,"""2""",64320,64380
5430,402204,405100,120,62400,4,"""2""",64380,64500
5430,405100,405902,60,62400,4,"""2""",64500,64560
5430,405902,406502,120,62400,4,"""2""",64560,64680
5430,406502,407702,60,62400,4,"""2""",64680,64740
5430,407702,34201,60,62400,4,"""2""",64740,64800
5430,34201,408004,180,62400,4,"""2""",64800,64980
5430,200900,202002,60,63600,4,"""2""",63600,63660
5430,202002,204103,120,63600,4,"""2""",63660,63780
5430,204103,203604,60,63600,4,"""2""",63780,63840
5430,203604,201903,60,63600,4,"""2""",63840,63900
5430,201903,203900,120,63600,4,"""2""",63900,64020
5430,203900,201503,60,63600,4,"""2""",64020,64080
5430,201503,208103,120,63600,4,"""2""",64080,64200
5430,208103,34104,60,63600,4,"""2""",64200,64260
5430,34104,105002,60,63600,4,"""2""",64260,64320
5430,105002,118002,120,63600,4,"""2""",64320,64440
5430,118002,106002,60,63600,4,"""2""",64440,64500
5430,106002,118102,60,63600,4,"""2""",64500,64560
5430,118102,101004,120,63600,4,"""2""",64560,64680
5430,101004,502802,120,63600,4,"""2""",64680,64800
5430,502802,500904,120,63600,4,"""2""",64800,64920
5430,500904,501602,60,63600,4,"""2""",64920,64980
5430,501602,501802,60,63600,4,"""2""",64980,65040
5430,501802,502000,60,63600,4,"""2""",65040,65100
5430,502000,501701,120,63600,4,"""2""",65100,65220
5430,501701,400402,120,63600,4,"""2""",65220,65340
5430,400402,402002,60,63600,4,"""2""",65340,65400
5430,402002,500702,120,63600,4,"""2""",65400,65520
5430,500702,402204,60,63600,4,"""2""",65520,65580
5430,402204,405100,120,63600,4,"""2""",65580,65700
5430,405100,405902,60,63600,4,"""2""",65700,65760
5430,405902,406502,120,63600,4,"""2""",65760,65880
5430,406502,407702,60,63600,4,"""2""",65880,65940
5430,407702,34201,60,63600,4,"""2""",65940,66000
5430,34201,408004,180,63600,4,"""2""",66000,66180
5430,200900,202002,60,66000,4,"""2""",66000,66060
5430,202002,204103,120,66000,4,"""2""",66060,66180
5430,204103,203604,60,66000,4,"""2""",66180,66240
5430,203604,201903,60,66000,4,"""2""",66240,66300
5430,201903,203900,120,66000,4,"""2""",66300,66420
5430,203900,201503,60,66000,4,"""2""",66420,66480
5430,201503,208103,120,66000,4,"""2""",66480,66600
5430,208103,34104,60,66000,4,"""2""",66600,66660
5430,34104,105002,60,66000,4,"""2""",66660,66720
5430,105002,118002,120,66000,4,"""2""",66720,66840
5430,118002,106002,60,66000,4,"""2""",66840,66900
5430,106002,118102,60,66000,4,"""2""",66900,66960
5430,118102,101004,120,66000,4,"""2""",66960,67080
5430,101004,502802,120,66000,4,"""2""",67080,67200
5430,502802,500904,120,66000,4,"""2""",67200,67320
5430,500904,501602,60,66000,4,"""2""",67320,67380
5430,501602,501802,60,66000,4,"""2""",67380,67440
5430,501802,502000,60,66000,4,"""2""",67440,67500
5430,502000,501701,120,66000,4,"""2""",67500,67620
5430,501701,400402,120,66000,4,"""2""",67620,67740
5430,400402,402002,60,66000,4,"""2""",67740,67800
5430,402002,500702,120,66000,4,"""2""",67800,67920
5430,500702,402204,60,66000,4,"""2""",67920,67980
5430,402204,405100,120,66000,4,"""2""",67980,68100
5430,405100,405902,60,66000,4,"""2""",68100,68160
5430,405902,406502,120,66000,4,"""2""",68160,68280
5430,406502,407702,60,66000,4,"""2""",68280,68340
5430,407702,34201,60,66000,4,"""2""",68340,68400
5430,34201,408004,180,66000,4,"""2""",68400,68580
5431,101004,502802,120,25680,4,"""14""",25680,25800
5431,502802,500904,120,25680,4,"""14""",25800,25920
5431,500904,501602,60,25680,4,"""14""",25920,25980
5431,501602,501802,60,25680,4,"""14""",25980,26040
5431,501802,502000,60,25680,4,"""14""",26040,26100
5431,502000,501701,120,25680,4,"""14""",26100,26220
5431,501701,400402,120,25680,4,"""14""",26220,26340
5431,400402,402002,60,25680,4,"""14""",26340,26400
5431,402002,500702,120,25680,4,"""14""",26400,26520
5431,500702,402204,60,25680,4,"""14""",26520,26580
5431,402204,405100,120,25680,4,"""14""",26580,26700
5431,405100,405902,60,25680,4,"""14""",26700,26760
5431,405902,406502,120,25680,4,"""14""",26760,26880
5431,406502,407702,60,25680,4,"""14""",26880,26940
5431,407702,34201,60,25680,4,"""14""",26940,27000
5431,34201,408004,180,25680,4,"""14""",27000,27180
5431,408004,409301,360,25680,4,"""14""",27180,27540
5432,501701,400402,120,28440,4,"""12""",28440,28560
5432,400402,402002,60,28440,4,"""12""",28560,28620
5432,402002,500702,120,28440,4,"""12""",28620,28740
5432,500702,402204,60,28440,4,"""12""",28740,28800
5432,402204,405100,120,28440,4,"""12""",28800,28920
5432,405100,405902,60,28440,4,"""12""",28920,28980
5432,405902,406502,120,28440,4,"""12""",28980,29100
5432,406502,407702,60,28440,4,"""12""",29100,29160
5432,407702,34201,60,28440,4,"""12""",29160,29220
5432,34201,408004,180,28440,4,"""12""",29220,29400
5433,405100,405902,60,72900,4,"""16""",72900,72960
5433,405902,406502,120,72900,4,"""16""",72960,73080
5433,406502,407702,60,72900,4,"""16""",73080,73140
5433,407702,34201,60,72900,4,"""16""",73140,73200
5433,34201,408004,120,72900,4,"""16""",73200,73320
5433,405100,405902,60,74700,4,"""16""",74700,74760
5433,405902,406502,120,74700,4,"""16""",74760,74880
5433,406502,407702,60,74700,4,"""16""",74880,74940
5433,407702,34201,60,74700,4,"""16""",74940,75000
5433,34201,408004,120,74700,4,"""16""",75000,75120
5433,405100,405902,60,76500,4,"""16""",76500,76560
5433,405902,406502,120,76500,4,"""16""",76560,76680
5433,406502,407702,60,76500,4,"""16""",76680,76740
5433,407702,34201,60,76500,4,"""16""",76740,76800
5433,34201,408004,120,76500,4,"""16""",76800,76920
5433,405100,405902,60,78300,4,"""16""",78300,78360
5433,405902,406502,120,78300,4,"""16""",78360,78480
5433,406502,407702,60,78300,4,"""16""",78480,78540
5433,407702,34201,60,78300,4,"""16""",78540,78600
5433,34201,408004,120,78300,4,"""16""",78600,78720
5433,405100,405902,60,80100,4,"""16""",80100,80160
5433,405902,406502,120,80100,4,"""16""",80160,80280
5433,406502,407702,60,80100,4,"""16""",80280,80340
5433,407702,34201,60,80100,4,"""16""",80340,80400
5433,34201,408004,120,80100,4,"""16""",80400,80520
5450,503800,504001,0,24360,6,"""1""",24360,24360
5450,504001,501101,60,24360,6,"""1""",24360,24420
5450,501101,503302,60,24360,6,"""1""",24420,24480
5450,503302,503901,60,24360,6,"""1""",24480,24540
5450,503901,500402,60,24360,6,"""1""",24540,24600
5450,500402,501201,60,24360,6,"""1""",24600,24660
5450,501201,500102,60,24360,6,"""1""",24660,24720
5450,500102,500801,60,24360,6,"""1""",24720,24780
5450,500801,502201,120,24360,6,"""1""",24780,24900
5450,502201,102002,240,24360,6,"""1""",24900,25140
5450,102002,101103,120,24360,6,"""1""",25140,25260
5450,101103,115100,60,24360,6,"""1""",25260,25320
5450,115100,109015,120,24360,6,"""1""",25320,25440
5450,109015,112107,180,24360,6,"""1""",25440,25620
5450,112107,403102,60,24360,6,"""1""",25620,25680
5450,403102,404101,120,24360,6,"""1""",25680,25800
5450,404101,403001,60,24360,6,"""1""",25800,25860
5450,403001,406803,60,24360,6,"""1""",25860,25920
5450,406803,408003,180,24360,6,"""1""",25920,26100
5450,408003,400501,60,24360,6,"""1""",26100,26160
5450,400501,406302,60,24360,6,"""1""",26160,26220
5450,406302,409601,120,24360,6,"""1""",26220,26340
5450,409601,405200,120,24360,6,"""1""",26340,26460
5450,503800,504001,0,24960,6,"""1""",24960,24960
5450,504001,501101,60,24960,6,"""1""",24960,25020
5450,501101,503302,60,24960,6,"""1""",25020,25080
5450,503302,503901,60,24960,6,"""1""",25080,25140
5450,503901,500402,60,24960,6,"""1""",25140,25200
5450,500402,501201,60,24960,6,"""1""",25200,25260
5450,501201,500102,60,24960,6,"""1""",25260,25320
5450,500102,500801,60,24960,6,"""1""",25320,25380
5450,500801,502201,120,24960,6,"""1""",25380,25500
5450,502201,102002,240,24960,6,"""1""",25500,25740
5450,102002,101103,120,24960,6,"""1""",25740,25860
5450,101103,115100,60,24960,6,"""1""",25860,25920
5450,115100,109015,120,24960,6,"""1""",25920,26040
5450,109015,112107,180,24960,6,"""1""",26040,26220
5450,112107,403102,60,24960,6,"""1""",26220,26280
5450,403102,404101,120,24960,6,"""1""",26280,26400
5450,404101,403001,60,24960,6,"""1""",26400,26460
5450,403001,406803,60,24960,6,"""1""",26460,26520
5450,406803,408003,180,24960,6,"""1""",26520,26700
5450,408003,400501,60,24960,6,"""1""",26700,26760
5450,400501,406302,60,24960,6,"""1""",26760,26820
5450,406302,409601,120,24960,6,"""1""",26820,26940
5450,409601,405200,120,24960,6,"""1""",26940,27060
5450,503800,504001,0,25560,6,"""1""",25560,25560
5450,504001,501101,60,25560,6,"""1""",25560,25620
5450,501101,503302,60,25560,6,"""1""",25620,25680
5450,503302,503901,60,25560,6,"""1""",25680,25740
5450,503901,500402,60,25560,6,"""1""",25740,25800
5450,500402,501201,60,25560,6,"""1""",25800,25860
5450,501201,500102,60,25560,6,"""1""",25860,25920
5450,500102,500801,60,25560,6,"""1""",25920,25980
5450,500801,502201,120,25560,6,"""1""",25980,26100
5450,502201,102002,240,25560,6,"""1""",26100,26340
5450,102002,101103,120,25560,6,"""1""",26340,26460
5450,101103,115100,60,25560,6,"""1""",26460,26520
5450,115100,109015,120,25560,6,"""1""",26520,26640
5450,109015,112107,180,25560,6,"""1""",26640,26820
5450,112107,403102,60,25560,6,"""1""",26820,26880
5450,403102,404101,120,25560,6,"""1""",26880,27000
5450,404101,403001,60,25560,6,"""1""",27000,27060
5450,403001,406803,60,25560,6,"""1""",27060,27120
5450,406803,408003,180,25560,6,"""1""",27120,27300
5450,408003,400501,60,25560,6,"""1""",27300,27360
5450,400501,406302,60,25560,6,"""1""",27360,27420
5450,406302,409601,120,25560,6,"""1""",27420,27540
5450,409601,405200,120,25560,6,"""1""",27540,27660
5450,503800,504001,0,26160,6,"""1""",26160,26160
5450,504001,501101,60,26160,6,"""1""",26160,26220
5450,501101,503302,60,26160,6,"""1""",26220,26280
5450,503302,503901,60,26160,6,"""1""",26280,26340
5450,503901,500402,60,26160,6,"""1""",26340,26400
5450,500402,501201,60,26160,6,"""1""",26400,26460
5450,501201,500102,60,26160,6,"""1""",26460,26520
5450,500102,500801,60,26160,6,"""1""",26520,26580
5450,500801,502201,120,26160,6,"""1""",26580,26700
5450,502201,102002,240,26160,6,"""1""",26700,26940
5450,102002,101103,120,26160,6,"""1""",26940,27060
5450,101103,115100,60,26160,6,"""1""",27060,27120
5450,115100,109015,120,26160,6,"""1""",27120,27240
5450,109015,112107,180,26160,6,"""1""",27240,27420
5450,112107,403102,60,26160,6,"""1""",27420,27480
5450,403102,404101,120,26160,6,"""1""",27480,27600
5450,404101,403001,60,26160,6,"""1""",27600,27660
5450,403001,406803,60,26160,6,"""1""",27660,27720
5450,406803,408003,180,26160,6,"""1""",27720,27900
5450,408003,400501,60,26160,6,"""1""",27900,27960
5450,400501,406302,60,26160,6,"""1""",27960,28020
5450,406302,409601,120,26160,6,"""1""",28020,28140
5450,409601,405200,120,26160,6,"""1""",28140,28260
5450,503800,504001,0,26760,6,"""1""",26760,26760
5450,504001,501101,60,26760,6,"""1""",26760,26820
5450,501101,503302,60,26760,6,"""1""",26820,26880
5450,503302,503901,60,26760,6,"""1""",26880,26940
5450,503901,500402,60,26760,6,"""1""",26940,27000
5450,500402,501201,60,26760,6,"""1""",27000,27060
5450,501201,500102,60,26760,6,"""1""",27060,27120
5450,500102,500801,60,26760,6,"""1""",27120,27180
5450,500801,502201,120,26760,6,"""1""",27180,27300
5450,502201,102002,240,26760,6,"""1""",27300,27540
5450,102002,101103,120,26760,6,"""1""",27540,27660
5450,101103,115100,60,26760,6,"""1""",27660,27720
5450,115100,109015,120,26760,6,"""1""",27720,27840
5450,109015,112107,180,26760,6,"""1""",27840,28020
5450,112107,403102,60,26760,6,"""1""",28020,28080
5450,403102,404101,120,26760,6,"""1""",28080,28200
5450,404101,403001,60,26760,6,"""1""",28200,28260
5450,403001,406803,60,26760,6,"""1""",28260,28320
5450,406803,408003,180,26760,6,"""1""",28320,28500
5450,408003,400501,60,26760,6,"""1""",28500,28560
5450,400501,406302,60,26760,6,"""1""",28560,28620
5450,406302,409601,120,26760,6,"""1""",28620,28740
5450,409601,405200,120,26760,6,"""1""",28740,28860
5450,503800,504001,0,27360,6,"""1""",27360,27360
5450,504001,501101,60,27360,6,"""1""",27360,27420
5450,501101,503302,60,27360,6,"""1""",27420,27480
5450,503302,503901,60,27360,6,"""1""",27480,27540
5450,503901,500402,60,27360,6,"""1""",27540,27600
5450,500402,501201,60,27360,6,"""1""",27600,27660
5450,501201,500102,60,27360,6,"""1""",27660,27720
5450,500102,500801,60,27360,6,"""1""",27720,27780
5450,500801,502201,120,27360,6,"""1""",27780,27900
5450,502201,102002,240,27360,6,"""1""",27900,28140
5450,102002,101103,120,27360,6,"""1""",28140,28260
5450,101103,115100,60,27360,6,"""1""",28260,28320
5450,115100,109015,120,27360,6,"""1""",28320,28440
5450,109015,112107,180,27360,6,"""1""",28440,28620
5450,112107,403102,60,27360,6,"""1""",28620,28680
5450,403102,404101,120,27360,6,"""1""",28680,28800
5450,404101,403001,60,27360,6,"""1""",28800,28860
5450,403001,406803,60,27360,6,"""1""",28860,28920
5450,406803,408003,180,27360,6,"""1""",28920,29100
5450,408003,400501,60,27360,6,"""1""",29100,29160
5450,400501,406302,60,27360,6,"""1""",29160,29220
5450,406302,409601,120,27360,6,"""1""",29220,29340
5450,409601,405200,120,27360,6,"""1""",29340,29460
5450,503800,504001,0,27960,6,"""1""",27960,27960
5450,504001,501101,60,27960,6,"""1""",27960,28020
5450,501101,503302,60,27960,6,"""1""",28020,28080
5450,503302,503901,60,27960,6,"""1""",28080,28140
5450,503901,500402,60,27960,6,"""1""",28140,28200
5450,500402,501201,60,27960,6,"""1""",28200,28260
5450,501201,500102,60,27960,6,"""1""",28260,28320
5450,500102,500801,60,27960,6,"""1""",28320,28380
5450,500801,502201,120,27960,6,"""1""",28380,28500
5450,502201,102002,240,27960,6,"""1""",28500,28740
5450,102002,101103,120,27960,6,"""1""",28740,28860
5450,101103,115100,60,27960,6,"""1""",28860,28920
5450,115100,109015,120,27960,6,"""1""",28920,29040
5450,109015,112107,180,27960,6,"""1""",29040,29220
5450,112107,403102,60,27960,6,"""1""",29220,29280
5450,403102,404101,120,27960,6,"""1""",29280,29400
5450,404101,403001,60,27960,6,"""1""",29400,29460
5450,403001,406803,60,27960,6,"""1""",29460,29520
5450,406803,408003,180,27960,6,"""1""",29520,29700
5450,408003,400501,60,27960,6,"""1""",29700,29760
5450,400501,406302,60,27960,6,"""1""",29760,29820
5450,406302,409601,120,27960,6,"""1""",29820,29940
5450,409601,405200,120,27960,6,"""1""",29940,30060
5450,503800,504001,0,28560,6,"""1""",28560,28560
5450,504001,501101,60,28560,6,"""1""",28560,28620
5450,501101,503302,60,28560,6,"""1""",28620,28680
5450,503302,503901,60,28560,6,"""1""",28680,28740
5450,503901,500402,60,28560,6,"""1""",28740,28800
5450,500402,501201,60,28560,6,"""1""",28800,28860
5450,501201,500102,60,28560,6,"""1""",28860,28920
5450,500102,500801,60,28560,6,"""1""",28920,28980
5450,500801,502201,120,28560,6,"""1""",28980,29100
5450,502201,102002,240,28560,6,"""1""",29100,29340
5450,102002,101103,120,28560,6,"""1""",29340,29460
5450,101103,115100,60,28560,6,"""1""",29460,29520
5450,115100,109015,120,28560,6,"""1""",29520,29640
5450,109015,112107,180,28560,6,"""1""",29640,29820
5450,112107,403102,60,28560,6,"""1""",29820,29880
5450,403102,404101,120,28560,6,"""1""",29880,30000
5450,404101,403001,60,28560,6,"""1""",30000,30060
5450,403001,406803,60,28560,6,"""1""",30060,30120
5450,406803,408003,180,28560,6,"""1""",30120,30300
5450,408003,400501,60,28560,6,"""1""",30300,30360
5450,400501,406302,60,28560,6,"""1""",30360,30420
5450,406302,409601,120,28560,6,"""1""",30420,30540
5450,409601,405200,120,28560,6,"""1""",30540,30660
5450,503800,504001,0,29160,6,"""1""",29160,29160
5450,504001,501101,60,29160,6,"""1""",29160,29220
5450,501101,503302,60,29160,6,"""1""",29220,29280
5450,503302,503901,60,29160,6,"""1""",29280,29340
5450,503901,500402,60,29160,6,"""1""",29340,29400
5450,500402,501201,60,29160,6,"""1""",29400,29460
5450,501201,500102,60,29160,6,"""1""",29460,29520
5450,500102,500801,60,29160,6,"""1""",29520,29580
5450,500801,502201,120,29160,6,"""1""",29580,29700
5450,502201,102002,240,29160,6,"""1""",29700,29940
5450,102002,101103,120,29160,6,"""1""",29940,30060
5450,101103,115100,60,29160,6,"""1""",30060,30120
5450,115100,109015,120,29160,6,"""1""",30120,30240
5450,109015,112107,180,29160,6,"""1""",30240,30420
5450,112107,403102,60,29160,6,"""1""",30420,30480
5450,403102,404101,120,29160,6,"""1""",30480,30600
5450,404101,403001,60,29160,6,"""1""",30600,30660
5450,403001,406803,60,29160,6,"""1""",30660,30720
5450,406803,408003,180,29160,6,"""1""",30720,30900
5450,408003,400501,60,29160,6,"""1""",30900,30960
5450,400501,406302,60,29160,6,"""1""",30960,31020
5450,406302,409601,120,29160,6,"""1""",31020,31140
5450,409601,405200,120,29160,6,"""1""",31140,31260
5450,503800,504001,0,29760,6,"""1""",29760,29760
5450,504001,501101,60,29760,6,"""1""",29760,29820
5450,501101,503302,60,29760,6,"""1""",29820,29880
5450,503302,503901,60,29760,6,"""1""",29880,29940
5450,503901,500402,60,29760,6,"""1""",29940,30000
5450,500402,501201,60,29760,6,"""1""",30000,30060
5450,501201,500102,60,29760,6,"""1""",30060,30120
5450,500102,500801,60,29760,6,"""1""",30120,30180
5450,500801,502201,120,29760,6,"""1""",30180,30300
5450,502201,102002,240,29760,6,"""1""",30300,30540
5450,102002,101103,120,29760,6,"""1""",30540,30660
5450,101103,115100,60,29760,6,"""1""",30660,30720
5450,115100,109015,120,29760,6,"""1""",30720,30840
5450,109015,112107,180,29760,6,"""1""",30840,31020
5450,112107,403102,60,29760,6,"""1""",31020,31080
5450,403102,404101,120,29760,6,"""1""",31080,31200
5450,404101,403001,60,29760,6,"""1""",31200,31260
5450,403001,406803,60,29760,6,"""1""",31260,31320
5450,406803,408003,180,29760,6,"""1""",31320,31500
5450,408003,400501,60,29760,6,"""1""",31500,31560
5450,400501,406302,60,29760,6,"""1""",31560,31620
5450,406302,409601,120,29760,6,"""1""",31620,31740
5450,409601,405200,120,29760,6,"""1""",31740,31860
5450,503800,504001,0,30360,6,"""1""",30360,30360
5450,504001,501101,60,30360,6,"""1""",30360,30420
5450,501101,503302,60,30360,6,"""1""",30420,30480
5450,503302,503901,60,30360,6,"""1""",30480,30540
5450,503901,500402,60,30360,6,"""1""",30540,30600
5450,500402,501201,60,30360,6,"""1""",30600,30660
5450,501201,500102,60,30360,6,"""1""",30660,30720
5450,500102,500801,60,30360,6,"""1""",30720,30780
5450,500801,502201,120,30360,6,"""1""",30780,30900
5450,502201,102002,240,30360,6,"""1""",30900,31140
5450,102002,101103,120,30360,6,"""1""",31140,31260
5450,101103,115100,60,30360,6,"""1""",31260,31320
5450,115100,109015,120,30360,6,"""1""",31320,31440
5450,109015,112107,180,30360,6,"""1""",31440,31620
5450,112107,403102,60,30360,6,"""1""",31620,31680
5450,403102,404101,120,30360,6,"""1""",31680,31800
5450,404101,403001,60,30360,6,"""1""",31800,31860
5450,403001,406803,60,30360,6,"""1""",31860,31920
5450,406803,408003,180,30360,6,"""1""",31920,32100
5450,408003,400501,60,30360,6,"""1""",32100,32160
5450,400501,406302,60,30360,6,"""1""",32160,32220
5450,406302,409601,120,30360,6,"""1""",32220,32340
5450,409601,405200,120,30360,6,"""1""",32340,32460
5450,503800,504001,0,30960,6,"""1""",30960,30960
5450,504001,501101,60,30960,6,"""1""",30960,31020
5450,501101,503302,60,30960,6,"""1""",31020,31080
5450,503302,503901,60,30960,6,"""1""",31080,31140
5450,503901,500402,60,30960,6,"""1""",31140,31200
5450,500402,501201,60,30960,6,"""1""",31200,31260
5450,501201,500102,60,30960,6,"""1""",31260,31320
5450,500102,500801,60,30960,6,"""1""",31320,31380
5450,500801,502201,120,30960,6,"""1""",31380,31500
5450,502201,102002,240,30960,6,"""1""",31500,31740
5450,102002,101103,120,30960,6,"""1""",31740,31860
5450,101103,115100,60,30960,6,"""1""",31860,31920
5450,115100,109015,120,30960,6,"""1""",31920,32040
5450,109015,112107,180,30960,6,"""1""",32040,32220
5450,112107,403102,60,30960,6,"""1""",32220,32280
5450,403102,404101,120,30960,6,"""1""",32280,32400
5450,404101,403001,60,30960,6,"""1""",32400,32460
5450,403001,406803,60,30960,6,"""1""",32460,32520
5450,406803,408003,180,30960,6,"""1""",32520,32700
5450,408003,400501,60,30960,6,"""1""",32700,32760
5450,400501,406302,60,30960,6,"""1""",32760,32820
5450,406302,409601,120,30960,6,"""1""",32820,32940
5450,409601,405200,120,30960,6,"""1""",32940,33060
5450,503800,504001,0,31560,6,"""1""",31560,31560
5450,504001,501101,60,31560,6,"""1""",31560,31620
5450,501101,503302,60,31560,6,"""1""",31620,31680
5450,503302,503901,60,31560,6,"""1""",31680,31740
5450,503901,500402,60,31560,6,"""1""",31740,31800
5450,500402,501201,60,31560,6,"""1""",31800,31860
5450,501201,500102,60,31560,6,"""1""",31860,31920
5450,500102,500801,60,31560,6,"""1""",31920,31980
5450,500801,502201,120,31560,6,"""1""",31980,32100
5450,502201,102002,240,31560,6,"""1""",32100,32340
5450,102002,101103,120,31560,6,"""1""",32340,32460
5450,101103,115100,60,31560,6,"""1""",32460,32520
5450,115100,109015,120,31560,6,"""1""",32520,32640
5450,109015,112107,180,31560,6,"""1""",32640,32820
5450,112107,403102,60,31560,6,"""1""",32820,32880
5450,403102,404101,120,31560,6,"""1""",32880,33000
5450,404101,403001,60,31560,6,"""1""",33000,33060
5450,403001,406803,60,31560,6,"""1""",33060,33120
5450,406803,408003,180,31560,6,"""1""",33120,33300
5450,408003,400501,60,31560,6,"""1""",33300,33360
5450,400501,406302,60,31560,6,"""1""",33360,33420
5450,406302,409601,120,31560,6,"""1""",33420,33540
5450,409601,405200,120,31560,6,"""1""",33540,33660
5450,503800,504001,0,32160,6,"""1""",32160,32160
5450,504001,501101,60,32160,6,"""1""",32160,32220
5450,501101,503302,60,32160,6,"""1""",32220,32280
5450,503302,503901,60,32160,6,"""1""",32280,32340
5450,503901,500402,60,32160,6,"""1""",32340,32400
5450,500402,501201,60,32160,6,"""1""",32400,32460
5450,501201,500102,60,32160,6,"""1""",32460,32520
5450,500102,500801,60,32160,6,"""1""",32520,32580
5450,500801,502201,120,32160,6,"""1""",32580,32700
5450,502201,102002,240,32160,6,"""1""",32700,32940
5450,102002,101103,120,32160,6,"""1""",32940,33060
5450,101103,115100,60,32160,6,"""1""",33060,33120
5450,115100,109015,120,32160,6,"""1""",33120,33240
5450,109015,112107,180,32160,6,"""1""",33240,33420
5450,112107,403102,60,32160,6,"""1""",33420,33480
5450,403102,404101,120,32160,6,"""1""",33480,33600
5450,404101,403001,60,32160,6,"""1""",33600,33660
5450,403001,406803,60,32160,6,"""1""",33660,33720
5450,406803,408003,180,32160,6,"""1""",33720,33900
5450,408003,400501,60,32160,6,"""1""",33900,33960
5450,400501,406302,60,32160,6,"""1""",33960,34020
5450,406302,409601,120,32160,6,"""1""",34020,34140
5450,409601,405200,120,32160,6,"""1""",34140,34260
5450,503800,504001,0,32760,6,"""1""",32760,32760
5450,504001,501101,60,32760,6,"""1""",32760,32820
5450,501101,503302,60,32760,6,"""1""",32820,32880
5450,503302,503901,60,32760,6,"""1""",32880,32940
5450,503901,500402,60,32760,6,"""1""",32940,33000
5450,500402,501201,60,32760,6,"""1""",33000,33060
5450,501201,500102,60,32760,6,"""1""",33060,33120
5450,500102,500801,60,32760,6,"""1""",33120,33180
5450,500801,502201,120,32760,6,"""1""",33180,33300
5450,502201,102002,240,32760,6,"""1""",33300,33540
5450,102002,101103,120,32760,6,"""1""",33540,33660
5450,101103,115100,60,32760,6,"""1""",33660,33720
5450,115100,109015,120,32760,6,"""1""",33720,33840
5450,109015,112107,180,32760,6,"""1""",33840,34020
5450,112107,403102,60,32760,6,"""1""",34020,34080
5450,403102,404101,120,32760,6,"""1""",34080,34200
5450,404101,403001,60,32760,6,"""1""",34200,34260
5450,403001,406803,60,32760,6,"""1""",34260,34320
5450,406803,408003,180,32760,6,"""1""",34320,34500
5450,408003,400501,60,32760,6,"""1""",34500,34560
5450,400501,406302,60,32760,6,"""1""",34560,34620
5450,406302,409601,120,32760,6,"""1""",34620,34740
5450,409601,405200,120,32760,6,"""1""",34740,34860
5450,503800,504001,0,33360,6,"""1""",33360,33360
5450,504001,501101,60,33360,6,"""1""",33360,33420
5450,501101,503302,60,33360,6,"""1""",33420,33480
5450,503302,503901,60,33360,6,"""1""",33480,33540
5450,503901,500402,60,33360,6,"""1""",33540,33600
5450,500402,501201,60,33360,6,"""1""",33600,33660
5450,501201,500102,60,33360,6,"""1""",33660,33720
5450,500102,500801,60,33360,6,"""1""",33720,33780
5450,500801,502201,120,33360,6,"""1""",33780,33900
5450,502201,102002,240,33360,6,"""1""",33900,34140
5450,102002,101103,120,33360,6,"""1""",34140,34260
5450,101103,115100,60,33360,6,"""1""",34260,34320
5450,115100,109015,120,33360,6,"""1""",34320,34440
5450,109015,112107,180,33360,6,"""1""",34440,34620
5450,112107,403102,60,33360,6,"""1""",34620,34680
5450,403102,404101,120,33360,6,"""1""",34680,34800
5450,404101,403001,60,33360,6,"""1""",34800,34860
5450,403001,406803,60,33360,6,"""1""",34860,34920
5450,406803,408003,180,33360,6,"""1""",34920,35100
5450,408003,400501,60,33360,6,"""1""",35100,35160
5450,400501,406302,60,33360,6,"""1""",35160,35220
5450,406302,409601,120,33360,6,"""1""",35220,35340
5450,409601,405200,120,33360,6,"""1""",35340,35460
5450,503800,504001,0,33960,6,"""1""",33960,33960
5450,504001,501101,60,33960,6,"""1""",33960,34020
5450,501101,503302,60,33960,6,"""1""",34020,34080
5450,503302,503901,60,33960,6,"""1""",34080,34140
5450,503901,500402,60,33960,6,"""1""",34140,34200
5450,500402,501201,60,33960,6,"""1""",34200,34260
5450,501201,500102,60,33960,6,"""1""",34260,34320
5450,500102,500801,60,33960,6,"""1""",34320,34380
5450,500801,502201,120,33960,6,"""1""",34380,34500
5450,502201,102002,240,33960,6,"""1""",34500,34740
5450,102002,101103,120,33960,6,"""1""",34740,34860
5450,101103,115100,60,33960,6,"""1""",34860,34920
5450,115100,109015,120,33960,6,"""1""",34920,35040
5450,109015,112107,180,33960,6,"""1""",35040,35220
5450,112107,403102,60,33960,6,"""1""",35220,35280
5450,403102,404101,120,33960,6,"""1""",35280,35400
5450,404101,403001,60,33960,6,"""1""",35400,35460
5450,403001,406803,60,33960,6,"""1""",35460,35520
5450,406803,408003,180,33960,6,"""1""",35520,35700
5450,408003,400501,60,33960,6,"""1""",35700,35760
5450,400501,406302,60,33960,6,"""1""",35760,35820
5450,406302,409601,120,33960,6,"""1""",35820,35940
5450,409601,405200,120,33960,6,"""1""",35940,36060
5450,503800,504001,0,34560,6,"""1""",34560,34560
5450,504001,501101,60,34560,6,"""1""",34560,34620
5450,501101,503302,60,34560,6,"""1""",34620,34680
5450,503302,503901,60,34560,6,"""1""",34680,34740
5450,503901,500402,60,34560,6,"""1""",34740,34800
5450,500402,501201,60,34560,6,"""1""",34800,34860
5450,501201,500102,60,34560,6,"""1""",34860,34920
5450,500102,500801,60,34560,6,"""1""",34920,34980
5450,500801,502201,120,34560,6,"""1""",34980,35100
5450,502201,102002,240,34560,6,"""1""",35100,35340
5450,102002,101103,120,34560,6,"""1""",35340,35460
5450,101103,115100,60,34560,6,"""1""",35460,35520
5450,115100,109015,120,34560,6,"""1""",35520,35640
5450,109015,112107,180,34560,6,"""1""",35640,35820
5450,112107,403102,60,34560,6,"""1""",35820,35880
5450,403102,404101,120,34560,6,"""1""",35880,36000
5450,404101,403001,60,34560,6,"""1""",36000,36060
5450,403001,406803,60,34560,6,"""1""",36060,36120
5450,406803,408003,180,34560,6,"""1""",36120,36300
5450,408003,400501,60,34560,6,"""1""",36300,36360
5450,400501,406302,60,34560,6,"""1""",36360,36420
5450,406302,409601,120,34560,6,"""1""",36420,36540
5450,409601,405200,120,34560,6,"""1""",36540,36660
5450,503800,504001,0,35160,6,"""1""",35160,35160
5450,504001,501101,60,35160,6,"""1""",35160,35220
5450,501101,503302,60,35160,6,"""1""",35220,35280
5450,503302,503901,60,35160,6,"""1""",35280,35340
5450,503901,500402,60,35160,6,"""1""",35340,35400
5450,500402,501201,60,35160,6,"""1""",35400,35460
5450,501201,500102,60,35160,6,"""1""",35460,35520
5450,500102,500801,60,35160,6,"""1""",35520,35580
5450,500801,502201,120,35160,6,"""1""",35580,35700
5450,502201,102002,240,35160,6,"""1""",35700,35940
5450,102002,101103,120,35160,6,"""1""",35940,36060
5450,101103,115100,60,35160,6,"""1""",36060,36120
5450,115100,109015,120,35160,6,"""1""",36120,36240
5450,109015,112107,180,35160,6,"""1""",36240,36420
5450,112107,403102,60,35160,6,"""1""",36420,36480
5450,403102,404101,120,35160,6,"""1""",36480,36600
5450,404101,403001,60,35160,6,"""1""",36600,36660
5450,403001,406803,60,35160,6,"""1""",36660,36720
5450,406803,408003,180,35160,6,"""1""",36720,36900
5450,408003,400501,60,35160,6,"""1""",36900,36960
5450,400501,406302,60,35160,6,"""1""",36960,37020
5450,406302,409601,120,35160,6,"""1""",37020,37140
5450,409601,405200,120,35160,6,"""1""",37140,37260
5450,503800,504001,0,36360,6,"""1""",36360,36360
5450,504001,501101,60,36360,6,"""1""",36360,36420
5450,501101,503302,60,36360,6,"""1""",36420,36480
5450,503302,503901,60,36360,6,"""1""",36480,36540
5450,503901,500402,60,36360,6,"""1""",36540,36600
5450,500402,501201,60,36360,6,"""1""",36600,36660
5450,501201,500102,60,36360,6,"""1""",36660,36720
5450,500102,500801,60,36360,6,"""1""",36720,36780
5450,500801,502201,120,36360,6,"""1""",36780,36900
5450,502201,102002,240,36360,6,"""1""",36900,37140
5450,102002,101103,120,36360,6,"""1""",37140,37260
5450,101103,115100,60,36360,6,"""1""",37260,37320
5450,115100,109015,120,36360,6,"""1""",37320,37440
5450,109015,112107,180,36360,6,"""1""",37440,37620
5450,112107,403102,60,36360,6,"""1""",37620,37680
5450,403102,404101,120,36360,6,"""1""",37680,37800
5450,404101,403001,60,36360,6,"""1""",37800,37860
5450,403001,406803,60,36360,6,"""1""",37860,37920
5450,406803,408003,180,36360,6,"""1""",37920,38100
5450,408003,400501,60,36360,6,"""1""",38100,38160
5450,400501,406302,60,36360,6,"""1""",38160,38220
5450,406302,409601,120,36360,6,"""1""",38220,38340
5450,409601,405200,120,36360,6,"""1""",38340,38460
5450,503800,504001,0,37560,6,"""1""",37560,37560
5450,504001,501101,60,37560,6,"""1""",37560,37620
5450,501101,503302,60,37560,6,"""1""",37620,37680
5450,503302,503901,60,37560,6,"""1""",37680,37740
5450,503901,500402,60,37560,6,"""1""",37740,37800
5450,500402,501201,60,37560,6,"""1""",37800,37860
5450,501201,500102,60,37560,6,"""1""",37860,37920
5450,500102,500801,60,37560,6,"""1""",37920,37980
5450,500801,502201,120,37560,6,"""1""",37980,38100
5450,502201,102002,240,37560,6,"""1""",38100,38340
5450,102002,101103,120,37560,6,"""1""",38340,38460
5450,101103,115100,60,37560,6,"""1""",38460,38520
5450,115100,109015,120,37560,6,"""1""",38520,38640
5450,109015,112107,180,37560,6,"""1""",38640,38820
5450,112107,403102,60,37560,6,"""1""",38820,38880
5450,403102,404101,120,37560,6,"""1""",38880,39000
5450,404101,403001,60,37560,6,"""1""",39000,39060
5450,403001,406803,60,37560,6,"""1""",39060,39120
5450,406803,408003,180,37560,6,"""1""",39120,39300
5450,408003,400501,60,37560,6,"""1""",39300,39360
5450,400501,406302,60,37560,6,"""1""",39360,39420
5450,406302,409601,120,37560,6,"""1""",39420,39540
5450,409601,405200,120,37560,6,"""1""",39540,39660
5450,503800,504001,0,38760,6,"""1""",38760,38760
5450,504001,501101,60,38760,6,"""1""",38760,38820
5450,501101,503302,60,38760,6,"""1""",38820,38880
5450,503302,503901,60,38760,6,"""1""",38880,38940
5450,503901,500402,60,38760,6,"""1""",38940,39000
5450,500402,501201,60,38760,6,"""1""",39000,39060
5450,501201,500102,60,38760,6,"""1""",39060,39120
5450,500102,500801,60,38760,6,"""1""",39120,39180
5450,500801,502201,120,38760,6,"""1""",39180,39300
5450,502201,102002,240,38760,6,"""1""",39300,39540
5450,102002,101103,120,38760,6,"""1""",39540,39660
5450,101103,115100,60,38760,6,"""1""",39660,39720
5450,115100,109015,120,38760,6,"""1""",39720,39840
5450,109015,112107,180,38760,6,"""1""",39840,40020
5450,112107,403102,60,38760,6,"""1""",40020,40080
5450,403102,404101,120,38760,6,"""1""",40080,40200
5450,404101,403001,60,38760,6,"""1""",40200,40260
5450,403001,406803,60,38760,6,"""1""",40260,40320
5450,406803,408003,180,38760,6,"""1""",40320,40500
5450,408003,400501,60,38760,6,"""1""",40500,40560
5450,400501,406302,60,38760,6,"""1""",40560,40620
5450,406302,409601,120,38760,6,"""1""",40620,40740
5450,409601,405200,120,38760,6,"""1""",40740,40860
5450,503800,504001,0,39960,6,"""1""",39960,39960
5450,504001,501101,60,39960,6,"""1""",39960,40020
5450,501101,503302,60,39960,6,"""1""",40020,40080
5450,503302,503901,60,39960,6,"""1""",40080,40140
5450,503901,500402,60,39960,6,"""1""",40140,40200
5450,500402,501201,60,39960,6,"""1""",40200,40260
5450,501201,500102,60,39960,6,"""1""",40260,40320
5450,500102,500801,60,39960,6,"""1""",40320,40380
5450,500801,502201,120,39960,6,"""1""",40380,40500
5450,502201,102002,240,39960,6,"""1""",40500,40740
5450,102002,101103,120,39960,6,"""1""",40740,40860
5450,101103,115100,60,39960,6,"""1""",40860,40920
5450,115100,109015,120,39960,6,"""1""",40920,41040
5450,109015,112107,180,39960,6,"""1""",41040,41220
5450,112107,403102,60,39960,6,"""1""",41220,41280
5450,403102,404101,120,39960,6,"""1""",41280,41400
5450,404101,403001,60,39960,6,"""1""",41400,41460
5450,403001,406803,60,39960,6,"""1""",41460,41520
5450,406803,408003,180,39960,6,"""1""",41520,41700
5450,408003,400501,60,39960,6,"""1""",41700,41760
5450,400501,406302,60,39960,6,"""1""",41760,41820
5450,406302,409601,120,39960,6,"""1""",41820,41940
5450,409601,405200,120,39960,6,"""1""",41940,42060
5450,503800,504001,0,41160,6,"""1""",41160,41160
5450,504001,501101,60,41160,6,"""1""",41160,41220
5450,501101,503302,60,41160,6,"""1""",41220,41280
5450,503302,503901,60,41160,6,"""1""",41280,41340
5450,503901,500402,60,41160,6,"""1""",41340,41400
5450,500402,501201,60,41160,6,"""1""",41400,41460
5450,501201,500102,60,41160,6,"""1""",41460,41520
5450,500102,500801,60,41160,6,"""1""",41520,41580
5450,500801,502201,120,41160,6,"""1""",41580,41700
5450,502201,102002,240,41160,6,"""1""",41700,41940
5450,102002,101103,120,41160,6,"""1""",41940,42060
5450,101103,115100,60,41160,6,"""1""",42060,42120
5450,115100,109015,120,41160,6,"""1""",42120,42240
5450,109015,112107,180,41160,6,"""1""",42240,42420
5450,112107,403102,60,41160,6,"""1""",42420,42480
5450,403102,404101,120,41160,6,"""1""",42480,42600
5450,404101,403001,60,41160,6,"""1""",42600,42660
5450,403001,406803,60,41160,6,"""1""",42660,42720
5450,406803,408003,180,41160,6,"""1""",42720,42900
5450,408003,400501,60,41160,6,"""1""",42900,42960
5450,400501,406302,60,41160,6,"""1""",42960,43020
5450,406302,409601,120,41160,6,"""1""",43020,43140
5450,409601,405200,120,41160,6,"""1""",43140,43260
5450,503800,504001,0,42360,6,"""1""",42360,42360
5450,504001,501101,60,42360,6,"""1""",42360,42420
5450,501101,503302,60,42360,6,"""1""",42420,42480
5450,503302,503901,60,42360,6,"""1""",42480,42540
5450,503901,500402,60,42360,6,"""1""",42540,42600
5450,500402,501201,60,42360,6,"""1""",42600,42660
5450,501201,500102,60,42360,6,"""1""",42660,42720
5450,500102,500801,60,42360,6,"""1""",42720,42780
5450,500801,502201,120,42360,6,"""1""",42780,42900
5450,502201,102002,240,42360,6,"""1""",42900,43140
5450,102002,101103,120,42360,6,"""1""",43140,43260
5450,101103,115100,60,42360,6,"""1""",43260,43320
5450,115100,109015,120,42360,6,"""1""",43320,43440
5450,109015,112107,180,42360,6,"""1""",43440,43620
5450,112107,403102,60,42360,6,"""1""",43620,43680
5450,403102,404101,120,42360,6,"""1""",43680,43800
5450,404101,403001,60,42360,6,"""1""",43800,43860
5450,403001,406803,60,42360,6,"""1""",43860,43920
5450,406803,408003,180,42360,6,"""1""",43920,44100
5450,408003,400501,60,42360,6,"""1""",44100,44160
5450,400501,406302,60,42360,6,"""1""",44160,44220
5450,406302,409601,120,42360,6,"""1""",44220,44340
5450,409601,405200,120,42360,6,"""1""",44340,44460
5450,503800,504001,0,43560,6,"""1""",43560,43560
5450,504001,501101,60,43560,6,"""1""",43560,43620
5450,501101,503302,60,43560,6,"""1""",43620,43680
5450,503302,503901,60,43560,6,"""1""",43680,43740
5450,503901,500402,60,43560,6,"""1""",43740,43800
5450,500402,501201,60,43560,6,"""1""",43800,43860
5450,501201,500102,60,43560,6,"""1""",43860,43920
5450,500102,500801,60,43560,6,"""1""",43920,43980
5450,500801,502201,120,43560,6,"""1""",43980,44100
5450,502201,102002,240,43560,6,"""1""",44100,44340
5450,102002,101103,120,43560,6,"""1""",44340,44460
5450,101103,115100,60,43560,6,"""1""",44460,44520
5450,115100,109015,120,43560,6,"""1""",44520,44640
5450,109015,112107,180,43560,6,"""1""",44640,44820
5450,112107,403102,60,43560,6,"""1""",44820,44880
5450,403102,404101,120,43560,6,"""1""",44880,45000
5450,404101,403001,60,43560,6,"""1""",45000,45060
5450,403001,406803,60,43560,6,"""1""",45060,45120
5450,406803,408003,180,43560,6,"""1""",45120,45300
5450,408003,400501,60,43560,6,"""1""",45300,45360
5450,400501,406302,60,43560,6,"""1""",45360,45420
5450,406302,409601,120,43560,6,"""1""",45420,45540
5450,409601,405200,120,43560,6,"""1""",45540,45660
5450,503800,504001,0,44760,6,"""1""",44760,44760
5450,504001,501101,60,44760,6,"""1""",44760,44820
5450,501101,503302,60,44760,6,"""1""",44820,44880
5450,503302,503901,60,44760,6,"""1""",44880,44940
5450,503901,500402,60,44760,6,"""1""",44940,45000
5450,500402,501201,60,44760,6,"""1""",45000,45060
5450,501201,500102,60,44760,6,"""1""",45060,45120
5450,500102,500801,60,44760,6,"""1""",45120,45180
5450,500801,502201,120,44760,6,"""1""",45180,45300
5450,502201,102002,240,44760,6,"""1""",45300,45540
5450,102002,101103,120,44760,6,"""1""",45540,45660
5450,101103,115100,60,44760,6,"""1""",45660,45720
5450,115100,109015,120,44760,6,"""1""",45720,45840
5450,109015,112107,180,44760,6,"""1""",45840,46020
5450,112107,403102,60,44760,6,"""1""",46020,46080
5450,403102,404101,120,44760,6,"""1""",46080,46200
5450,404101,403001,60,44760,6,"""1""",46200,46260
5450,403001,406803,60,44760,6,"""1""",46260,46320
5450,406803,408003,180,44760,6,"""1""",46320,46500
5450,408003,400501,60,44760,6,"""1""",46500,46560
5450,400501,406302,60,44760,6,"""1""",46560,46620
5450,406302,409601,120,44760,6,"""1""",46620,46740
5450,409601,405200,120,44760,6,"""1""",46740,46860
5450,503800,504001,0,45960,6,"""1""",45960,45960
5450,504001,501101,60,45960,6,"""1""",45960,46020
5450,501101,503302,60,45960,6,"""1""",46020,46080
5450,503302,503901,60,45960,6,"""1""",46080,46140
5450,503901,500402,60,45960,6,"""1""",46140,46200
5450,500402,501201,60,45960,6,"""1""",46200,46260
5450,501201,500102,60,45960,6,"""1""",46260,46320
5450,500102,500801,60,45960,6,"""1""",46320,46380
5450,500801,502201,120,45960,6,"""1""",46380,46500
5450,502201,102002,240,45960,6,"""1""",46500,46740
5450,102002,101103,120,45960,6,"""1""",46740,46860
5450,101103,115100,60,45960,6,"""1""",46860,46920
5450,115100,109015,120,45960,6,"""1""",46920,47040
5450,109015,112107,180,45960,6,"""1""",47040,47220
5450,112107,403102,60,45960,6,"""1""",47220,47280
5450,403102,404101,120,45960,6,"""1""",47280,47400
5450,404101,403001,60,45960,6,"""1""",47400,47460
5450,403001,406803,60,45960,6,"""1""",47460,47520
5450,406803,408003,180,45960,6,"""1""",47520,47700
5450,408003,400501,60,45960,6,"""1""",47700,47760
5450,400501,406302,60,45960,6,"""1""",47760,47820
5450,406302,409601,120,45960,6,"""1""",47820,47940
5450,409601,405200,120,45960,6,"""1""",47940,48060
5450,503800,504001,0,47160,6,"""1""",47160,47160
5450,504001,501101,60,47160,6,"""1""",47160,47220
5450,501101,503302,60,47160,6,"""1""",47220,47280
5450,503302,503901,60,47160,6,"""1""",47280,47340
5450,503901,500402,60,47160,6,"""1""",47340,47400
5450,500402,501201,60,47160,6,"""1""",47400,47460
5450,501201,500102,60,47160,6,"""1""",47460,47520
5450,500102,500801,60,47160,6,"""1""",47520,47580
5450,500801,502201,120,47160,6,"""1""",47580,47700
5450,502201,102002,240,47160,6,"""1""",47700,47940
5450,102002,101103,120,47160,6,"""1""",47940,48060
5450,101103,115100,60,47160,6,"""1""",48060,48120
5450,115100,109015,120,47160,6,"""1""",48120,48240
5450,109015,112107,180,47160,6,"""1""",48240,48420
5450,112107,403102,60,47160,6,"""1""",48420,48480
5450,403102,404101,120,47160,6,"""1""",48480,48600
5450,404101,403001,60,47160,6,"""1""",48600,48660
5450,403001,406803,60,47160,6,"""1""",48660,48720
5450,406803,408003,180,47160,6,"""1""",48720,48900
5450,408003,400501,60,47160,6,"""1""",48900,48960
5450,400501,406302,60,47160,6,"""1""",48960,49020
5450,406302,409601,120,47160,6,"""1""",49020,49140
5450,409601,405200,120,47160,6,"""1""",49140,49260
5450,503800,504001,0,48360,6,"""1""",48360,48360
5450,504001,501101,60,48360,6,"""1""",48360,48420
5450,501101,503302,60,48360,6,"""1""",48420,48480
5450,503302,503901,60,48360,6,"""1""",48480,48540
5450,503901,500402,60,48360,6,"""1""",48540,48600
5450,500402,501201,60,48360,6,"""1""",48600,48660
5450,501201,500102,60,48360,6,"""1""",48660,48720
5450,500102,500801,60,48360,6,"""1""",48720,48780
5450,500801,502201,120,48360,6,"""1""",48780,48900
5450,502201,102002,240,48360,6,"""1""",48900,49140
5450,102002,101103,120,48360,6,"""1""",49140,49260
5450,101103,115100,60,48360,6,"""1""",49260,49320
5450,115100,109015,120,48360,6,"""1""",49320,49440
5450,109015,112107,180,48360,6,"""1""",49440,49620
5450,112107,403102,60,48360,6,"""1""",49620,49680
5450,403102,404101,120,48360,6,"""1""",49680,49800
5450,404101,403001,60,48360,6,"""1""",49800,49860
5450,403001,406803,60,48360,6,"""1""",49860,49920
5450,406803,408003,180,48360,6,"""1""",49920,50100
5450,408003,400501,60,48360,6,"""1""",50100,50160
5450,400501,406302,60,48360,6,"""1""",50160,50220
5450,406302,409601,120,48360,6,"""1""",50220,50340
5450,409601,405200,120,48360,6,"""1""",50340,50460
5450,503800,504001,0,49560,6,"""1""",49560,49560
5450,504001,501101,60,49560,6,"""1""",49560,49620
5450,501101,503302,60,49560,6,"""1""",49620,49680
5450,503302,503901,60,49560,6,"""1""",49680,49740
5450,503901,500402,60,49560,6,"""1""",49740,49800
5450,500402,501201,60,49560,6,"""1""",49800,49860
5450,501201,500102,60,49560,6,"""1""",49860,49920
5450,500102,500801,60,49560,6,"""1""",49920,49980
5450,500801,502201,120,49560,6,"""1""",49980,50100
5450,502201,102002,240,49560,6,"""1""",50100,50340
5450,102002,101103,120,49560,6,"""1""",50340,50460
5450,101103,115100,60,49560,6,"""1""",50460,50520
5450,115100,109015,120,49560,6,"""1""",50520,50640
5450,109015,112107,180,49560,6,"""1""",50640,50820
5450,112107,403102,60,49560,6,"""1""",50820,50880
5450,403102,404101,120,49560,6,"""1""",50880,51000
5450,404101,403001,60,49560,6,"""1""",51000,51060
5450,403001,406803,60,49560,6,"""1""",51060,51120
5450,406803,408003,180,49560,6,"""1""",51120,51300
5450,408003,400501,60,49560,6,"""1""",51300,51360
5450,400501,406302,60,49560,6,"""1""",51360,51420
5450,406302,409601,120,49560,6,"""1""",51420,51540
5450,409601,405200,120,49560,6,"""1""",51540,51660
5450,503800,504001,0,50760,6,"""1""",50760,50760
5450,504001,501101,60,50760,6,"""1""",50760,50820
5450,501101,503302,60,50760,6,"""1""",50820,50880
5450,503302,503901,60,50760,6,"""1""",50880,50940
5450,503901,500402,60,50760,6,"""1""",50940,51000
5450,500402,501201,60,50760,6,"""1""",51000,51060
5450,501201,500102,60,50760,6,"""1""",51060,51120
5450,500102,500801,60,50760,6,"""1""",51120,51180
5450,500801,502201,120,50760,6,"""1""",51180,51300
5450,502201,102002,240,50760,6,"""1""",51300,51540
5450,102002,101103,120,50760,6,"""1""",51540,51660
5450,101103,115100,60,50760,6,"""1""",51660,51720
5450,115100,109015,120,50760,6,"""1""",51720,51840
5450,109015,112107,180,50760,6,"""1""",51840,52020
5450,112107,403102,60,50760,6,"""1""",52020,52080
5450,403102,404101,120,50760,6,"""1""",52080,52200
5450,404101,403001,60,50760,6,"""1""",52200,52260
5450,403001,406803,60,50760,6,"""1""",52260,52320
5450,406803,408003,180,50760,6,"""1""",52320,52500
5450,408003,400501,60,50760,6,"""1""",52500,52560
5450,400501,406302,60,50760,6,"""1""",52560,52620
5450,406302,409601,120,50760,6,"""1""",52620,52740
5450,409601,405200,120,50760,6,"""1""",52740,52860
5450,503800,504001,0,51960,6,"""1""",51960,51960
5450,504001,501101,60,51960,6,"""1""",51960,52020
5450,501101,503302,60,51960,6,"""1""",52020,52080
5450,503302,503901,60,51960,6,"""1""",52080,52140
5450,503901,500402,60,51960,6,"""1""",52140,52200
5450,500402,501201,60,51960,6,"""1""",52200,52260
5450,501201,500102,60,51960,6,"""1""",52260,52320
5450,500102,500801,60,51960,6,"""1""",52320,52380
5450,500801,502201,120,51960,6,"""1""",52380,52500
5450,502201,102002,240,51960,6,"""1""",52500,52740
5450,102002,101103,120,51960,6,"""1""",52740,52860
5450,101103,115100,60,51960,6,"""1""",52860,52920
5450,115100,109015,120,51960,6,"""1""",52920,53040
5450,109015,112107,180,51960,6,"""1""",53040,53220
5450,112107,403102,60,51960,6,"""1""",53220,53280
5450,403102,404101,120,51960,6,"""1""",53280,53400
5450,404101,403001,60,51960,6,"""1""",53400,53460
5450,403001,406803,60,51960,6,"""1""",53460,53520
5450,406803,408003,180,51960,6,"""1""",53520,53700
5450,408003,400501,60,51960,6,"""1""",53700,53760
5450,400501,406302,60,51960,6,"""1""",53760,53820
5450,406302,409601,120,51960,6,"""1""",53820,53940
5450,409601,405200,120,51960,6,"""1""",53940,54060
5450,503800,504001,0,53160,6,"""1""",53160,53160
5450,504001,501101,60,53160,6,"""1""",53160,53220
5450,501101,503302,60,53160,6,"""1""",53220,53280
5450,503302,503901,60,53160,6,"""1""",53280,53340
5450,503901,500402,60,53160,6,"""1""",53340,53400
5450,500402,501201,60,53160,6,"""1""",53400,53460
5450,501201,500102,60,53160,6,"""1""",53460,53520
5450,500102,500801,60,53160,6,"""1""",53520,53580
5450,500801,502201,120,53160,6,"""1""",53580,53700
5450,502201,102002,240,53160,6,"""1""",53700,53940
5450,102002,101103,120,53160,6,"""1""",53940,54060
5450,101103,115100,60,53160,6,"""1""",54060,54120
5450,115100,109015,120,53160,6,"""1""",54120,54240
5450,109015,112107,180,53160,6,"""1""",54240,54420
5450,112107,403102,60,53160,6,"""1""",54420,54480
5450,403102,404101,120,53160,6,"""1""",54480,54600
5450,404101,403001,60,53160,6,"""1""",54600,54660
5450,403001,406803,60,53160,6,"""1""",54660,54720
5450,406803,408003,180,53160,6,"""1""",54720,54900
5450,408003,400501,60,53160,6,"""1""",54900,54960
5450,400501,406302,60,53160,6,"""1""",54960,55020
5450,406302,409601,120,53160,6,"""1""",55020,55140
5450,409601,405200,120,53160,6,"""1""",55140,55260
5450,503800,504001,0,54360,6,"""1""",54360,54360
5450,504001,501101,60,54360,6,"""1""",54360,54420
5450,501101,503302,60,54360,6,"""1""",54420,54480
5450,503302,503901,60,54360,6,"""1""",54480,54540
5450,503901,500402,60,54360,6,"""1""",54540,54600
5450,500402,501201,60,54360,6,"""1""",54600,54660
5450,501201,500102,60,54360,6,"""1""",54660,54720
5450,500102,500801,60,54360,6,"""1""",54720,54780
5450,500801,502201,120,54360,6,"""1""",54780,54900
5450,502201,102002,240,54360,6,"""1""",54900,55140
5450,102002,101103,120,54360,6,"""1""",55140,55260
5450,101103,115100,60,54360,6,"""1""",55260,55320
5450,115100,109015,120,54360,6,"""1""",55320,55440
5450,109015,112107,180,54360,6,"""1""",55440,55620
5450,112107,403102,60,54360,6,"""1""",55620,55680
5450,403102,404101,120,54360,6,"""1""",55680,55800
5450,404101,403001,60,54360,6,"""1""",55800,55860
5450,403001,406803,60,54360,6,"""1""",55860,55920
5450,406803,408003,180,54360,6,"""1""",55920,56100
5450,408003,400501,60,54360,6,"""1""",56100,56160
5450,400501,406302,60,54360,6,"""1""",56160,56220
5450,406302,409601,120,54360,6,"""1""",56220,56340
5450,409601,405200,120,54360,6,"""1""",56340,56460
5450,503800,504001,0,54960,6,"""1""",54960,54960
5450,504001,501101,60,54960,6,"""1""",54960,55020
5450,501101,503302,60,54960,6,"""1""",55020,55080
5450,503302,503901,60,54960,6,"""1""",55080,55140
5450,503901,500402,60,54960,6,"""1""",55140,55200
5450,500402,501201,60,54960,6,"""1""",55200,55260
5450,501201,500102,60,54960,6,"""1""",55260,55320
5450,500102,500801,60,54960,6,"""1""",55320,55380
5450,500801,502201,120,54960,6,"""1""",55380,55500
5450,502201,102002,240,54960,6,"""1""",55500,55740
5450,102002,101103,120,54960,6,"""1""",55740,55860
5450,101103,115100,60,54960,6,"""1""",55860,55920
5450,115100,109015,120,54960,6,"""1""",55920,56040
5450,109015,112107,180,54960,6,"""1""",56040,56220
5450,112107,403102,60,54960,6,"""1""",56220,56280
5450,403102,404101,120,54960,6,"""1""",56280,56400
5450,404101,403001,60,54960,6,"""1""",56400,56460
5450,403001,406803,60,54960,6,"""1""",56460,56520
5450,406803,408003,180,54960,6,"""1""",56520,56700
5450,408003,400501,60,54960,6,"""1""",56700,56760
5450,400501,406302,60,54960,6,"""1""",56760,56820
5450,406302,409601,120,54960,6,"""1""",56820,56940
5450,409601,405200,120,54960,6,"""1""",56940,57060
5450,503800,504001,0,55560,6,"""1""",55560,55560
5450,504001,501101,60,55560,6,"""1""",55560,55620
5450,501101,503302,60,55560,6,"""1""",55620,55680
5450,503302,503901,60,55560,6,"""1""",55680,55740
5450,503901,500402,60,55560,6,"""1""",55740,55800
5450,500402,501201,60,55560,6,"""1""",55800,55860
5450,501201,500102,60,55560,6,"""1""",55860,55920
5450,500102,500801,60,55560,6,"""1""",55920,55980
5450,500801,502201,120,55560,6,"""1""",55980,56100
5450,502201,102002,240,55560,6,"""1""",56100,56340
5450,102002,101103,120,55560,6,"""1""",56340,56460
5450,101103,115100,60,55560,6,"""1""",56460,56520
5450,115100,109015,120,55560,6,"""1""",56520,56640
5450,109015,112107,180,55560,6,"""1""",56640,56820
5450,112107,403102,60,55560,6,"""1""",56820,56880
5450,403102,404101,120,55560,6,"""1""",56880,57000
5450,404101,403001,60,55560,6,"""1""",57000,57060
5450,403001,406803,60,55560,6,"""1""",57060,57120
5450,406803,408003,180,55560,6,"""1""",57120,57300
5450,408003,400501,60,55560,6,"""1""",57300,57360
5450,400501,406302,60,55560,6,"""1""",57360,57420
5450,406302,409601,120,55560,6,"""1""",57420,57540
5450,409601,405200,120,55560,6,"""1""",57540,57660
5450,503800,504001,0,56160,6,"""1""",56160,56160
5450,504001,501101,60,56160,6,"""1""",56160,56220
5450,501101,503302,60,56160,6,"""1""",56220,56280
5450,503302,503901,60,56160,6,"""1""",56280,56340
5450,503901,500402,60,56160,6,"""1""",56340,56400
5450,500402,501201,60,56160,6,"""1""",56400,56460
5450,501201,500102,60,56160,6,"""1""",56460,56520
5450,500102,500801,60,56160,6,"""1""",56520,56580
5450,500801,502201,120,56160,6,"""1""",56580,56700
5450,502201,102002,240,56160,6,"""1""",56700,56940
5450,102002,101103,120,56160,6,"""1""",56940,57060
5450,101103,115100,60,56160,6,"""1""",57060,57120
5450,115100,109015,120,56160,6,"""1""",57120,57240
5450,109015,112107,180,56160,6,"""1""",57240,57420
5450,112107,403102,60,56160,6,"""1""",57420,57480
5450,403102,404101,120,56160,6,"""1""",57480,57600
5450,404101,403001,60,56160,6,"""1""",57600,57660
5450,403001,406803,60,56160,6,"""1""",57660,57720
5450,406803,408003,180,56160,6,"""1""",57720,57900
5450,408003,400501,60,56160,6,"""1""",57900,57960
5450,400501,406302,60,56160,6,"""1""",57960,58020
5450,406302,409601,120,56160,6,"""1""",58020,58140
5450,409601,405200,120,56160,6,"""1""",58140,58260
5450,503800,504001,0,56760,6,"""1""",56760,56760
5450,504001,501101,60,56760,6,"""1""",56760,56820
5450,501101,503302,60,56760,6,"""1""",56820,56880
5450,503302,503901,60,56760,6,"""1""",56880,56940
5450,503901,500402,60,56760,6,"""1""",56940,57000
5450,500402,501201,60,56760,6,"""1""",57000,57060
5450,501201,500102,60,56760,6,"""1""",57060,57120
5450,500102,500801,60,56760,6,"""1""",57120,57180
5450,500801,502201,120,56760,6,"""1""",57180,57300
5450,502201,102002,240,56760,6,"""1""",57300,57540
5450,102002,101103,120,56760,6,"""1""",57540,57660
5450,101103,115100,60,56760,6,"""1""",57660,57720
5450,115100,109015,120,56760,6,"""1""",57720,57840
5450,109015,112107,180,56760,6,"""1""",57840,58020
5450,112107,403102,60,56760,6,"""1""",58020,58080
5450,403102,404101,120,56760,6,"""1""",58080,58200
5450,404101,403001,60,56760,6,"""1""",58200,58260
5450,403001,406803,60,56760,6,"""1""",58260,58320
5450,406803,408003,180,56760,6,"""1""",58320,58500
5450,408003,400501,60,56760,6,"""1""",58500,58560
5450,400501,406302,60,56760,6,"""1""",58560,58620
5450,406302,409601,120,56760,6,"""1""",58620,58740
5450,409601,405200,120,56760,6,"""1""",58740,58860
5450,503800,504001,0,57360,6,"""1""",57360,57360
5450,504001,501101,60,57360,6,"""1""",57360,57420
5450,501101,503302,60,57360,6,"""1""",57420,57480
5450,503302,503901,60,57360,6,"""1""",57480,57540
5450,503901,500402,60,57360,6,"""1""",57540,57600
5450,500402,501201,60,57360,6,"""1""",57600,57660
5450,501201,500102,60,57360,6,"""1""",57660,57720
5450,500102,500801,60,57360,6,"""1""",57720,57780
5450,500801,502201,120,57360,6,"""1""",57780,57900
5450,502201,102002,240,57360,6,"""1""",57900,58140
5450,102002,101103,120,57360,6,"""1""",58140,58260
5450,101103,115100,60,57360,6,"""1""",58260,58320
5450,115100,109015,120,57360,6,"""1""",58320,58440
5450,109015,112107,180,57360,6,"""1""",58440,58620
5450,112107,403102,60,57360,6,"""1""",58620,58680
5450,403102,404101,120,57360,6,"""1""",58680,58800
5450,404101,403001,60,57360,6,"""1""",58800,58860
5450,403001,406803,60,57360,6,"""1""",58860,58920
5450,406803,408003,180,57360,6,"""1""",58920,59100
5450,408003,400501,60,57360,6,"""1""",59100,59160
5450,400501,406302,60,57360,6,"""1""",59160,59220
5450,406302,409601,120,57360,6,"""1""",59220,59340
5450,409601,405200,120,57360,6,"""1""",59340,59460
5450,503800,504001,0,57960,6,"""1""",57960,57960
5450,504001,501101,60,57960,6,"""1""",57960,58020
5450,501101,503302,60,57960,6,"""1""",58020,58080
5450,503302,503901,60,57960,6,"""1""",58080,58140
5450,503901,500402,60,57960,6,"""1""",58140,58200
5450,500402,501201,60,57960,6,"""1""",58200,58260
5450,501201,500102,60,57960,6,"""1""",58260,58320
5450,500102,500801,60,57960,6,"""1""",58320,58380
5450,500801,502201,120,57960,6,"""1""",58380,58500
5450,502201,102002,240,57960,6,"""1""",58500,58740
5450,102002,101103,120,57960,6,"""1""",58740,58860
5450,101103,115100,60,57960,6,"""1""",58860,58920
5450,115100,109015,120,57960,6,"""1""",58920,59040
5450,109015,112107,180,57960,6,"""1""",59040,59220
5450,112107,403102,60,57960,6,"""1""",59220,59280
5450,403102,404101,120,57960,6,"""1""",59280,59400
5450,404101,403001,60,57960,6,"""1""",59400,59460
5450,403001,406803,60,57960,6,"""1""",59460,59520
5450,406803,408003,180,57960,6,"""1""",59520,59700
5450,408003,400501,60,57960,6,"""1""",59700,59760
5450,400501,406302,60,57960,6,"""1""",59760,59820
5450,406302,409601,120,57960,6,"""1""",59820,59940
5450,409601,405200,120,57960,6,"""1""",59940,60060
5450,503800,504001,0,58560,6,"""1""",58560,58560
5450,504001,501101,60,58560,6,"""1""",58560,58620
5450,501101,503302,60,58560,6,"""1""",58620,58680
5450,503302,503901,60,58560,6,"""1""",58680,58740
5450,503901,500402,60,58560,6,"""1""",58740,58800
5450,500402,501201,60,58560,6,"""1""",58800,58860
5450,501201,500102,60,58560,6,"""1""",58860,58920
5450,500102,500801,60,58560,6,"""1""",58920,58980
5450,500801,502201,120,58560,6,"""1""",58980,59100
5450,502201,102002,240,58560,6,"""1""",59100,59340
5450,102002,101103,120,58560,6,"""1""",59340,59460
5450,101103,115100,60,58560,6,"""1""",59460,59520
5450,115100,109015,120,58560,6,"""1""",59520,59640
5450,109015,112107,180,58560,6,"""1""",59640,59820
5450,112107,403102,60,58560,6,"""1""",59820,59880
5450,403102,404101,120,58560,6,"""1""",59880,60000
5450,404101,403001,60,58560,6,"""1""",60000,60060
5450,403001,406803,60,58560,6,"""1""",60060,60120
5450,406803,408003,180,58560,6,"""1""",60120,60300
5450,408003,400501,60,58560,6,"""1""",60300,60360
5450,400501,406302,60,58560,6,"""1""",60360,60420
5450,406302,409601,120,58560,6,"""1""",60420,60540
5450,409601,405200,120,58560,6,"""1""",60540,60660
5450,503800,504001,0,59160,6,"""1""",59160,59160
5450,504001,501101,60,59160,6,"""1""",59160,59220
5450,501101,503302,60,59160,6,"""1""",59220,59280
5450,503302,503901,60,59160,6,"""1""",59280,59340
5450,503901,500402,60,59160,6,"""1""",59340,59400
5450,500402,501201,60,59160,6,"""1""",59400,59460
5450,501201,500102,60,59160,6,"""1""",59460,59520
5450,500102,500801,60,59160,6,"""1""",59520,59580
5450,500801,502201,120,59160,6,"""1""",59580,59700
5450,502201,102002,240,59160,6,"""1""",59700,59940
5450,102002,101103,120,59160,6,"""1""",59940,60060
5450,101103,115100,60,59160,6,"""1""",60060,60120
5450,115100,109015,120,59160,6,"""1""",60120,60240
5450,109015,112107,180,59160,6,"""1""",60240,60420
5450,112107,403102,60,59160,6,"""1""",60420,60480
5450,403102,404101,120,59160,6,"""1""",60480,60600
5450,404101,403001,60,59160,6,"""1""",60600,60660
5450,403001,406803,60,59160,6,"""1""",60660,60720
5450,406803,408003,180,59160,6,"""1""",60720,60900
5450,408003,400501,60,59160,6,"""1""",60900,60960
5450,400501,406302,60,59160,6,"""1""",60960,61020
5450,406302,409601,120,59160,6,"""1""",61020,61140
5450,409601,405200,120,59160,6,"""1""",61140,61260
5450,503800,504001,0,59760,6,"""1""",59760,59760
5450,504001,501101,60,59760,6,"""1""",59760,59820
5450,501101,503302,60,59760,6,"""1""",59820,59880
5450,503302,503901,60,59760,6,"""1""",59880,59940
5450,503901,500402,60,59760,6,"""1""",59940,60000
5450,500402,501201,60,59760,6,"""1""",60000,60060
5450,501201,500102,60,59760,6,"""1""",60060,60120
5450,500102,500801,60,59760,6,"""1""",60120,60180
5450,500801,502201,120,59760,6,"""1""",60180,60300
5450,502201,102002,240,59760,6,"""1""",60300,60540
5450,102002,101103,120,59760,6,"""1""",60540,60660
5450,101103,115100,60,59760,6,"""1""",60660,60720
5450,115100,109015,120,59760,6,"""1""",60720,60840
5450,109015,112107,180,59760,6,"""1""",60840,61020
5450,112107,403102,60,59760,6,"""1""",61020,61080
5450,403102,404101,120,59760,6,"""1""",61080,61200
5450,404101,403001,60,59760,6,"""1""",61200,61260
5450,403001,406803,60,59760,6,"""1""",61260,61320
5450,406803,408003,180,59760,6,"""1""",61320,61500
5450,408003,400501,60,59760,6,"""1""",61500,61560
5450,400501,406302,60,59760,6,"""1""",61560,61620
5450,406302,409601,120,59760,6,"""1""",61620,61740
5450,409601,405200,120,59760,6,"""1""",61740,61860
5450,503800,504001,0,60360,6,"""1""",60360,60360
5450,504001,501101,60,60360,6,"""1""",60360,60420
5450,501101,503302,60,60360,6,"""1""",60420,60480
5450,503302,503901,60,60360,6,"""1""",60480,60540
5450,503901,500402,60,60360,6,"""1""",60540,60600
5450,500402,501201,60,60360,6,"""1""",60600,60660
5450,501201,500102,60,60360,6,"""1""",60660,60720
5450,500102,500801,60,60360,6,"""1""",60720,60780
5450,500801,502201,120,60360,6,"""1""",60780,60900
5450,502201,102002,240,60360,6,"""1""",60900,61140
5450,102002,101103,120,60360,6,"""1""",61140,61260
5450,101103,115100,60,60360,6,"""1""",61260,61320
5450,115100,109015,120,60360,6,"""1""",61320,61440
5450,109015,112107,180,60360,6,"""1""",61440,61620
5450,112107,403102,60,60360,6,"""1""",61620,61680
5450,403102,404101,120,60360,6,"""1""",61680,61800
5450,404101,403001,60,60360,6,"""1""",61800,61860
5450,403001,406803,60,60360,6,"""1""",61860,61920
5450,406803,408003,180,60360,6,"""1""",61920,62100
5450,408003,400501,60,60360,6,"""1""",62100,62160
5450,400501,406302,60,60360,6,"""1""",62160,62220
5450,406302,409601,120,60360,6,"""1""",62220,62340
5450,409601,405200,120,60360,6,"""1""",62340,62460
5450,503800,504001,0,60960,6,"""1""",60960,60960
5450,504001,501101,60,60960,6,"""1""",60960,61020
5450,501101,503302,60,60960,6,"""1""",61020,61080
5450,503302,503901,60,60960,6,"""1""",61080,61140
5450,503901,500402,60,60960,6,"""1""",61140,61200
5450,500402,501201,60,60960,6,"""1""",61200,61260
5450,501201,500102,60,60960,6,"""1""",61260,61320
5450,500102,500801,60,60960,6,"""1""",61320,61380
5450,500801,502201,120,60960,6,"""1""",61380,61500
5450,502201,102002,240,60960,6,"""1""",61500,61740
5450,102002,101103,120,60960,6,"""1""",61740,61860
5450,101103,115100,60,60960,6,"""1""",61860,61920
5450,115100,109015,120,60960,6,"""1""",61920,62040
5450,109015,112107,180,60960,6,"""1""",62040,62220
5450,112107,403102,60,60960,6,"""1""",62220,62280
5450,403102,404101,120,60960,6,"""1""",62280,62400
5450,404101,403001,60,60960,6,"""1""",62400,62460
5450,403001,406803,60,60960,6,"""1""",62460,62520
5450,406803,408003,180,60960,6,"""1""",62520,62700
5450,408003,400501,60,60960,6,"""1""",62700,62760
5450,400501,406302,60,60960,6,"""1""",62760,62820
5450,406302,409601,120,60960,6,"""1""",62820,62940
5450,409601,405200,120,60960,6,"""1""",62940,63060
5450,503800,504001,0,61560,6,"""1""",61560,61560
5450,504001,501101,60,61560,6,"""1""",61560,61620
5450,501101,503302,60,61560,6,"""1""",61620,61680
5450,503302,503901,60,61560,6,"""1""",61680,61740
5450,503901,500402,60,61560,6,"""1""",61740,61800
5450,500402,501201,60,61560,6,"""1""",61800,61860
5450,501201,500102,60,61560,6,"""1""",61860,61920
5450,500102,500801,60,61560,6,"""1""",61920,61980
5450,500801,502201,120,61560,6,"""1""",61980,62100
5450,502201,102002,240,61560,6,"""1""",62100,62340
5450,102002,101103,120,61560,6,"""1""",62340,62460
5450,101103,115100,60,61560,6,"""1""",62460,62520
5450,115100,109015,120,61560,6,"""1""",62520,62640
5450,109015,112107,180,61560,6,"""1""",62640,62820
5450,112107,403102,60,61560,6,"""1""",62820,62880
5450,403102,404101,120,61560,6,"""1""",62880,63000
5450,404101,403001,60,61560,6,"""1""",63000,63060
5450,403001,406803,60,61560,6,"""1""",63060,63120
5450,406803,408003,180,61560,6,"""1""",63120,63300
5450,408003,400501,60,61560,6,"""1""",63300,63360
5450,400501,406302,60,61560,6,"""1""",63360,63420
5450,406302,409601,120,61560,6,"""1""",63420,63540
5450,409601,405200,120,61560,6,"""1""",63540,63660
5450,503800,504001,0,62160,6,"""1""",62160,62160
5450,504001,501101,60,62160,6,"""1""",62160,62220
5450,501101,503302,60,62160,6,"""1""",62220,62280
5450,503302,503901,60,62160,6,"""1""",62280,62340
5450,503901,500402,60,62160,6,"""1""",62340,62400
5450,500402,501201,60,62160,6,"""1""",62400,62460
5450,501201,500102,60,62160,6,"""1""",62460,62520
5450,500102,500801,60,62160,6,"""1""",62520,62580
5450,500801,502201,120,62160,6,"""1""",62580,62700
5450,502201,102002,240,62160,6,"""1""",62700,62940
5450,102002,101103,120,62160,6,"""1""",62940,63060
5450,101103,115100,60,62160,6,"""1""",63060,63120
5450,115100,109015,120,62160,6,"""1""",63120,63240
5450,109015,112107,180,62160,6,"""1""",63240,63420
5450,112107,403102,60,62160,6,"""1""",63420,63480
5450,403102,404101,120,62160,6,"""1""",63480,63600
5450,404101,403001,60,62160,6,"""1""",63600,63660
5450,403001,406803,60,62160,6,"""1""",63660,63720
5450,406803,408003,180,62160,6,"""1""",63720,63900
5450,408003,400501,60,62160,6,"""1""",63900,63960
5450,400501,406302,60,62160,6,"""1""",63960,64020
5450,406302,409601,120,62160,6,"""1""",64020,64140
5450,409601,405200,120,62160,6,"""1""",64140,64260
5450,503800,504001,0,62760,6,"""1""",62760,62760
5450,504001,501101,60,62760,6,"""1""",62760,62820
5450,501101,503302,60,62760,6,"""1""",62820,62880
5450,503302,503901,60,62760,6,"""1""",62880,62940
5450,503901,500402,60,62760,6,"""1""",62940,63000
5450,500402,501201,60,62760,6,"""1""",63000,63060
5450,501201,500102,60,62760,6,"""1""",63060,63120
5450,500102,500801,60,62760,6,"""1""",63120,63180
5450,500801,502201,120,62760,6,"""1""",63180,63300
5450,502201,102002,240,62760,6,"""1""",63300,63540
5450,102002,101103,120,62760,6,"""1""",63540,63660
5450,101103,115100,60,62760,6,"""1""",63660,63720
5450,115100,109015,120,62760,6,"""1""",63720,63840
5450,109015,112107,180,62760,6,"""1""",63840,64020
5450,112107,403102,60,62760,6,"""1""",64020,64080
5450,403102,404101,120,62760,6,"""1""",64080,64200
5450,404101,403001,60,62760,6,"""1""",64200,64260
5450,403001,406803,60,62760,6,"""1""",64260,64320
5450,406803,408003,180,62760,6,"""1""",64320,64500
5450,408003,400501,60,62760,6,"""1""",64500,64560
5450,400501,406302,60,62760,6,"""1""",64560,64620
5450,406302,409601,120,62760,6,"""1""",64620,64740
5450,409601,405200,120,62760,6,"""1""",64740,64860
5450,503800,504001,0,63360,6,"""1""",63360,63360
5450,504001,501101,60,63360,6,"""1""",63360,63420
5450,501101,503302,60,63360,6,"""1""",63420,63480
5450,503302,503901,60,63360,6,"""1""",63480,63540
5450,503901,500402,60,63360,6,"""1""",63540,63600
5450,500402,501201,60,63360,6,"""1""",63600,63660
5450,501201,500102,60,63360,6,"""1""",63660,63720
5450,500102,500801,60,63360,6,"""1""",63720,63780
5450,500801,502201,120,63360,6,"""1""",63780,63900
5450,502201,102002,240,63360,6,"""1""",63900,64140
5450,102002,101103,120,63360,6,"""1""",64140,64260
5450,101103,115100,60,63360,6,"""1""",64260,64320
5450,115100,109015,120,63360,6,"""1""",64320,64440
5450,109015,112107,180,63360,6,"""1""",64440,64620
5450,112107,403102,60,63360,6,"""1""",64620,64680
5450,403102,404101,120,63360,6,"""1""",64680,64800
5450,404101,403001,60,63360,6,"""1""",64800,64860
5450,403001,406803,60,63360,6,"""1""",64860,64920
5450,406803,408003,180,63360,6,"""1""",64920,65100
5450,408003,400501,60,63360,6,"""1""",65100,65160
5450,400501,406302,60,63360,6,"""1""",65160,65220
5450,406302,409601,120,63360,6,"""1""",65220,65340
5450,409601,405200,120,63360,6,"""1""",65340,65460
5450,503800,504001,0,63960,6,"""1""",63960,63960
5450,504001,501101,60,63960,6,"""1""",63960,64020
5450,501101,503302,60,63960,6,"""1""",64020,64080
5450,503302,503901,60,63960,6,"""1""",64080,64140
5450,503901,500402,60,63960,6,"""1""",64140,64200
5450,500402,501201,60,63960,6,"""1""",64200,64260
5450,501201,500102,60,63960,6,"""1""",64260,64320
5450,500102,500801,60,63960,6,"""1""",64320,64380
5450,500801,502201,120,63960,6,"""1""",64380,64500
5450,502201,102002,240,63960,6,"""1""",64500,64740
5450,102002,101103,120,63960,6,"""1""",64740,64860
5450,101103,115100,60,63960,6,"""1""",64860,64920
5450,115100,109015,120,63960,6,"""1""",64920,65040
5450,109015,112107,180,63960,6,"""1""",65040,65220
5450,112107,403102,60,63960,6,"""1""",65220,65280
5450,403102,404101,120,63960,6,"""1""",65280,65400
5450,404101,403001,60,63960,6,"""1""",65400,65460
5450,403001,406803,60,63960,6,"""1""",65460,65520
5450,406803,408003,180,63960,6,"""1""",65520,65700
5450,408003,400501,60,63960,6,"""1""",65700,65760
5450,400501,406302,60,63960,6,"""1""",65760,65820
5450,406302,409601,120,63960,6,"""1""",65820,65940
5450,409601,405200,120,63960,6,"""1""",65940,66060
5450,503800,504001,0,64560,6,"""1""",64560,64560
5450,504001,501101,60,64560,6,"""1""",64560,64620
5450,501101,503302,60,64560,6,"""1""",64620,64680
5450,503302,503901,60,64560,6,"""1""",64680,64740
5450,503901,500402,60,64560,6,"""1""",64740,64800
5450,500402,501201,60,64560,6,"""1""",64800,64860
5450,501201,500102,60,64560,6,"""1""",64860,64920
5450,500102,500801,60,64560,6,"""1""",64920,64980
5450,500801,502201,120,64560,6,"""1""",64980,65100
5450,502201,102002,240,64560,6,"""1""",65100,65340
5450,102002,101103,120,64560,6,"""1""",65340,65460
5450,101103,115100,60,64560,6,"""1""",65460,65520
5450,115100,109015,120,64560,6,"""1""",65520,65640
5450,109015,112107,180,64560,6,"""1""",65640,65820
5450,112107,403102,60,64560,6,"""1""",65820,65880
5450,403102,404101,120,64560,6,"""1""",65880,66000
5450,404101,403001,60,64560,6,"""1""",66000,66060
5450,403001,406803,60,64560,6,"""1""",66060,66120
5450,406803,408003,180,64560,6,"""1""",66120,66300
5450,408003,400501,60,64560,6,"""1""",66300,66360
5450,400501,406302,60,64560,6,"""1""",66360,66420
5450,406302,409601,120,64560,6,"""1""",66420,66540
5450,409601,405200,120,64560,6,"""1""",66540,66660
5450,503800,504001,0,65760,6,"""1""",65760,65760
5450,504001,501101,60,65760,6,"""1""",65760,65820
5450,501101,503302,60,65760,6,"""1""",65820,65880
5450,503302,503901,60,65760,6,"""1""",65880,65940
5450,503901,500402,60,65760,6,"""1""",65940,66000
5450,500402,501201,60,65760,6,"""1""",66000,66060
5450,501201,500102,60,65760,6,"""1""",66060,66120
5450,500102,500801,60,65760,6,"""1""",66120,66180
5450,500801,502201,120,65760,6,"""1""",66180,66300
5450,502201,102002,240,65760,6,"""1""",66300,66540
5450,102002,101103,120,65760,6,"""1""",66540,66660
5450,101103,115100,60,65760,6,"""1""",66660,66720
5450,115100,109015,120,65760,6,"""1""",66720,66840
5450,109015,112107,180,65760,6,"""1""",66840,67020
5450,112107,403102,60,65760,6,"""1""",67020,67080
5450,403102,404101,120,65760,6,"""1""",67080,67200
5450,404101,403001,60,65760,6,"""1""",67200,67260
5450,403001,406803,60,65760,6,"""1""",67260,67320
5450,406803,408003,180,65760,6,"""1""",67320,67500
5450,408003,400501,60,65760,6,"""1""",67500,67560
5450,400501,406302,60,65760,6,"""1""",67560,67620
5450,406302,409601,120,65760,6,"""1""",67620,67740
5450,409601,405200,120,65760,6,"""1""",67740,67860
5450,503800,504001,0,66960,6,"""1""",66960,66960
5450,504001,501101,60,66960,6,"""1""",66960,67020
5450,501101,503302,60,66960,6,"""1""",67020,67080
5450,503302,503901,60,66960,6,"""1""",67080,67140
5450,503901,500402,60,66960,6,"""1""",67140,67200
5450,500402,501201,60,66960,6,"""1""",67200,67260
5450,501201,500102,60,66960,6,"""1""",67260,67320
5450,500102,500801,60,66960,6,"""1""",67320,67380
5450,500801,502201,120,66960,6,"""1""",67380,67500
5450,502201,102002,240,66960,6,"""1""",67500,67740
5450,102002,101103,120,66960,6,"""1""",67740,67860
5450,101103,115100,60,66960,6,"""1""",67860,67920
5450,115100,109015,120,66960,6,"""1""",67920,68040
5450,109015,112107,180,66960,6,"""1""",68040,68220
5450,112107,403102,60,66960,6,"""1""",68220,68280
5450,403102,404101,120,66960,6,"""1""",68280,68400
5450,404101,403001,60,66960,6,"""1""",68400,68460
5450,403001,406803,60,66960,6,"""1""",68460,68520
5450,406803,408003,180,66960,6,"""1""",68520,68700
5450,408003,400501,60,66960,6,"""1""",68700,68760
5450,400501,406302,60,66960,6,"""1""",68760,68820
5450,406302,409601,120,66960,6,"""1""",68820,68940
5450,409601,405200,120,66960,6,"""1""",68940,69060
5450,503800,504001,0,68160,6,"""1""",68160,68160
5450,504001,501101,60,68160,6,"""1""",68160,68220
5450,501101,503302,60,68160,6,"""1""",68220,68280
5450,503302,503901,60,68160,6,"""1""",68280,68340
5450,503901,500402,60,68160,6,"""1""",68340,68400
5450,500402,501201,60,68160,6,"""1""",68400,68460
5450,501201,500102,60,68160,6,"""1""",68460,68520
5450,500102,500801,60,68160,6,"""1""",68520,68580
5450,500801,502201,120,68160,6,"""1""",68580,68700
5450,502201,102002,240,68160,6,"""1""",68700,68940
5450,102002,101103,120,68160,6,"""1""",68940,69060
5450,101103,115100,60,68160,6,"""1""",69060,69120
5450,115100,109015,120,68160,6,"""1""",69120,69240
5450,109015,112107,180,68160,6,"""1""",69240,69420
5450,112107,403102,60,68160,6,"""1""",69420,69480
5450,403102,404101,120,68160,6,"""1""",69480,69600
5450,404101,403001,60,68160,6,"""1""",69600,69660
5450,403001,406803,60,68160,6,"""1""",69660,69720
5450,406803,408003,180,68160,6,"""1""",69720,69900
5450,408003,400501,60,68160,6,"""1""",69900,69960
5450,400501,406302,60,68160,6,"""1""",69960,70020
5450,406302,409601,120,68160,6,"""1""",70020,70140
5450,409601,405200,120,68160,6,"""1""",70140,70260
5450,503800,504001,0,69360,6,"""1""",69360,69360
5450,504001,501101,60,69360,6,"""1""",69360,69420
5450,501101,503302,60,69360,6,"""1""",69420,69480
5450,503302,503901,60,69360,6,"""1""",69480,69540
5450,503901,500402,60,69360,6,"""1""",69540,69600
5450,500402,501201,60,69360,6,"""1""",69600,69660
5450,501201,500102,60,69360,6,"""1""",69660,69720
5450,500102,500801,60,69360,6,"""1""",69720,69780
5450,500801,502201,120,69360,6,"""1""",69780,69900
5450,502201,102002,240,69360,6,"""1""",69900,70140
5450,102002,101103,120,69360,6,"""1""",70140,70260
5450,101103,115100,60,69360,6,"""1""",70260,70320
5450,115100,109015,120,69360,6,"""1""",70320,70440
5450,109015,112107,180,69360,6,"""1""",70440,70620
5450,112107,403102,60,69360,6,"""1""",70620,70680
5450,403102,404101,120,69360,6,"""1""",70680,70800
5450,404101,403001,60,69360,6,"""1""",70800,70860
5450,403001,406803,60,69360,6,"""1""",70860,70920
5450,406803,408003,180,69360,6,"""1""",70920,71100
5450,408003,400501,60,69360,6,"""1""",71100,71160
5450,400501,406302,60,69360,6,"""1""",71160,71220
5450,406302,409601,120,69360,6,"""1""",71220,71340
5450,409601,405200,120,69360,6,"""1""",71340,71460
5451,503800,504001,0,21480,6,"""1""",21480,21480
5451,504001,501101,60,21480,6,"""1""",21480,21540
5451,501101,503302,60,21480,6,"""1""",21540,21600
5451,503302,503901,60,21480,6,"""1""",21600,21660
5451,503901,500402,60,21480,6,"""1""",21660,21720
5451,500402,501201,60,21480,6,"""1""",21720,21780
5451,501201,500102,60,21480,6,"""1""",21780,21840
5451,500102,500801,60,21480,6,"""1""",21840,21900
5451,500801,502201,120,21480,6,"""1""",21900,22020
5451,502201,102002,120,21480,6,"""1""",22020,22140
5451,102002,101103,120,21480,6,"""1""",22140,22260
5451,101103,115100,60,21480,6,"""1""",22260,22320
5451,115100,109015,120,21480,6,"""1""",22320,22440
5451,109015,112107,180,21480,6,"""1""",22440,22620
5451,112107,403102,60,21480,6,"""1""",22620,22680
5451,403102,404101,120,21480,6,"""1""",22680,22800
5451,404101,403001,60,21480,6,"""1""",22800,22860
5451,403001,406803,60,21480,6,"""1""",22860,22920
5451,406803,408003,180,21480,6,"""1""",22920,23100
5451,408003,400501,60,21480,6,"""1""",23100,23160
5451,400501,406302,60,21480,6,"""1""",23160,23220
5451,406302,409601,120,21480,6,"""1""",23220,23340
5451,409601,405200,120,21480,6,"""1""",23340,23460
5451,503800,504001,0,22080,6,"""1""",22080,22080
5451,504001,501101,60,22080,6,"""1""",22080,22140
5451,501101,503302,60,22080,6,"""1""",22140,22200
5451,503302,503901,60,22080,6,"""1""",22200,22260
5451,503901,500402,60,22080,6,"""1""",22260,22320
5451,500402,501201,60,22080,6,"""1""",22320,22380
5451,501201,500102,60,22080,6,"""1""",22380,22440
5451,500102,500801,60,22080,6,"""1""",22440,22500
5451,500801,502201,120,22080,6,"""1""",22500,22620
5451,502201,102002,120,22080,6,"""1""",22620,22740
5451,102002,101103,120,22080,6,"""1""",22740,22860
5451,101103,115100,60,22080,6,"""1""",22860,22920
5451,115100,109015,120,22080,6,"""1""",22920,23040
5451,109015,112107,180,22080,6,"""1""",23040,23220
5451,112107,403102,60,22080,6,"""1""",23220,23280
5451,403102,404101,120,22080,6,"""1""",23280,23400
5451,404101,403001,60,22080,6,"""1""",23400,23460
5451,403001,406803,60,22080,6,"""1""",23460,23520
5451,406803,408003,180,22080,6,"""1""",23520,23700
5451,408003,400501,60,22080,6,"""1""",23700,23760
5451,400501,406302,60,22080,6,"""1""",23760,23820
5451,406302,409601,120,22080,6,"""1""",23820,23940
5451,409601,405200,120,22080,6,"""1""",23940,24060
5451,503800,504001,0,22680,6,"""1""",22680,22680
5451,504001,501101,60,22680,6,"""1""",22680,22740
5451,501101,503302,60,22680,6,"""1""",22740,22800
5451,503302,503901,60,22680,6,"""1""",22800,22860
5451,503901,500402,60,22680,6,"""1""",22860,22920
5451,500402,501201,60,22680,6,"""1""",22920,22980
5451,501201,500102,60,22680,6,"""1""",22980,23040
5451,500102,500801,60,22680,6,"""1""",23040,23100
5451,500801,502201,120,22680,6,"""1""",23100,23220
5451,502201,102002,120,22680,6,"""1""",23220,23340
5451,102002,101103,120,22680,6,"""1""",23340,23460
5451,101103,115100,60,22680,6,"""1""",23460,23520
5451,115100,109015,120,22680,6,"""1""",23520,23640
5451,109015,112107,180,22680,6,"""1""",23640,23820
5451,112107,403102,60,22680,6,"""1""",23820,23880
5451,403102,404101,120,22680,6,"""1""",23880,24000
5451,404101,403001,60,22680,6,"""1""",24000,24060
5451,403001,406803,60,22680,6,"""1""",24060,24120
5451,406803,408003,180,22680,6,"""1""",24120,24300
5451,408003,400501,60,22680,6,"""1""",24300,24360
5451,400501,406302,60,22680,6,"""1""",24360,24420
5451,406302,409601,120,22680,6,"""1""",24420,24540
5451,409601,405200,120,22680,6,"""1""",24540,24660
5451,503800,504001,0,23280,6,"""1""",23280,23280
5451,504001,501101,60,23280,6,"""1""",23280,23340
5451,501101,503302,60,23280,6,"""1""",23340,23400
5451,503302,503901,60,23280,6,"""1""",23400,23460
5451,503901,500402,60,23280,6,"""1""",23460,23520
5451,500402,501201,60,23280,6,"""1""",23520,23580
5451,501201,500102,60,23280,6,"""1""",23580,23640
5451,500102,500801,60,23280,6,"""1""",23640,23700
5451,500801,502201,120,23280,6,"""1""",23700,23820
5451,502201,102002,120,23280,6,"""1""",23820,23940
5451,102002,101103,120,23280,6,"""1""",23940,24060
5451,101103,115100,60,23280,6,"""1""",24060,24120
5451,115100,109015,120,23280,6,"""1""",24120,24240
5451,109015,112107,180,23280,6,"""1""",24240,24420
5451,112107,403102,60,23280,6,"""1""",24420,24480
5451,403102,404101,120,23280,6,"""1""",24480,24600
5451,404101,403001,60,23280,6,"""1""",24600,24660
5451,403001,406803,60,23280,6,"""1""",24660,24720
5451,406803,408003,180,23280,6,"""1""",24720,24900
5451,408003,400501,60,23280,6,"""1""",24900,24960
5451,400501,406302,60,23280,6,"""1""",24960,25020
5451,406302,409601,120,23280,6,"""1""",25020,25140
5451,409601,405200,120,23280,6,"""1""",25140,25260
5451,503800,504001,0,23880,6,"""1""",23880,23880
5451,504001,501101,60,23880,6,"""1""",23880,23940
5451,501101,503302,60,23880,6,"""1""",23940,24000
5451,503302,503901,60,23880,6,"""1""",24000,24060
5451,503901,500402,60,23880,6,"""1""",24060,24120
5451,500402,501201,60,23880,6,"""1""",24120,24180
5451,501201,500102,60,23880,6,"""1""",24180,24240
5451,500102,500801,60,23880,6,"""1""",24240,24300
5451,500801,502201,120,23880,6,"""1""",24300,24420
5451,502201,102002,120,23880,6,"""1""",24420,24540
5451,102002,101103,120,23880,6,"""1""",24540,24660
5451,101103,115100,60,23880,6,"""1""",24660,24720
5451,115100,109015,120,23880,6,"""1""",24720,24840
5451,109015,112107,180,23880,6,"""1""",24840,25020
5451,112107,403102,60,23880,6,"""1""",25020,25080
5451,403102,404101,120,23880,6,"""1""",25080,25200
5451,404101,403001,60,23880,6,"""1""",25200,25260
5451,403001,406803,60,23880,6,"""1""",25260,25320
5451,406803,408003,180,23880,6,"""1""",25320,25500
5451,408003,400501,60,23880,6,"""1""",25500,25560
5451,400501,406302,60,23880,6,"""1""",25560,25620
5451,406302,409601,120,23880,6,"""1""",25620,25740
5451,409601,405200,120,23880,6,"""1""",25740,25860
5452,503800,504001,0,19080,6,"""1""",19080,19080
5452,504001,501101,0,19080,6,"""1""",19080,19080
5452,501101,503302,60,19080,6,"""1""",19080,19140
5452,503302,503901,60,19080,6,"""1""",19140,19200
5452,503901,500402,60,19080,6,"""1""",19200,19260
5452,500402,501201,60,19080,6,"""1""",19260,19320
5452,501201,500102,60,19080,6,"""1""",19320,19380
5452,500102,500801,60,19080,6,"""1""",19380,19440
5452,500801,502201,120,19080,6,"""1""",19440,19560
5452,502201,102002,180,19080,6,"""1""",19560,19740
5452,102002,101103,120,19080,6,"""1""",19740,19860
5452,101103,115100,60,19080,6,"""1""",19860,19920
5452,115100,109015,120,19080,6,"""1""",19920,20040
5452,109015,112107,180,19080,6,"""1""",20040,20220
5452,112107,403102,60,19080,6,"""1""",20220,20280
5452,403102,404101,60,19080,6,"""1""",20280,20340
5452,404101,403001,60,19080,6,"""1""",20340,20400
5452,403001,406803,60,19080,6,"""1""",20400,20460
5452,406803,408003,120,19080,6,"""1""",20460,20580
5452,408003,400501,60,19080,6,"""1""",20580,20640
5452,400501,406302,60,19080,6,"""1""",20640,20700
5452,406302,409601,120,19080,6,"""1""",20700,20820
5452,409601,405200,120,19080,6,"""1""",20820,20940
5452,503800,504001,0,20280,6,"""1""",20280,20280
5452,504001,501101,0,20280,6,"""1""",20280,20280
5452,501101,503302,60,20280,6,"""1""",20280,20340
5452,503302,503901,60,20280,6,"""1""",20340,20400
5452,503901,500402,60,20280,6,"""1""",20400,20460
5452,500402,501201,60,20280,6,"""1""",20460,20520
5452,501201,500102,60,20280,6,"""1""",20520,20580
5452,500102,500801,60,20280,6,"""1""",20580,20640
5452,500801,502201,120,20280,6,"""1""",20640,20760
5452,502201,102002,180,20280,6,"""1""",20760,20940
5452,102002,101103,120,20280,6,"""1""",20940,21060
5452,101103,115100,60,20280,6,"""1""",21060,21120
5452,115100,109015,120,20280,6,"""1""",21120,21240
5452,109015,112107,180,20280,6,"""1""",21240,21420
5452,112107,403102,60,20280,6,"""1""",21420,21480
5452,403102,404101,60,20280,6,"""1""",21480,21540
5452,404101,403001,60,20280,6,"""1""",21540,21600
5452,403001,406803,60,20280,6,"""1""",21600,21660
5452,406803,408003,120,20280,6,"""1""",21660,21780
5452,408003,400501,60,20280,6,"""1""",21780,21840
5452,400501,406302,60,20280,6,"""1""",21840,21900
5452,406302,409601,120,20280,6,"""1""",21900,22020
5452,409601,405200,120,20280,6,"""1""",22020,22140
5453,112107,403102,60,37080,6,"""19""",37080,37140
5453,403102,404101,120,37080,6,"""19""",37140,37260
5453,404101,403001,60,37080,6,"""19""",37260,37320
5453,403001,406803,60,37080,6,"""19""",37320,37380
5453,406803,408003,180,37080,6,"""19""",37380,37560
5453,408003,400501,60,37080,6,"""19""",37560,37620
5453,400501,406302,60,37080,6,"""19""",37620,37680
5453,406302,409601,120,37080,6,"""19""",37680,37800
5453,409601,405200,120,37080,6,"""19""",37800,37920
5453,112107,403102,60,38280,6,"""19""",38280,38340
5453,403102,404101,120,38280,6,"""19""",38340,38460
5453,404101,403001,60,38280,6,"""19""",38460,38520
5453,403001,406803,60,38280,6,"""19""",38520,38580
5453,406803,408003,180,38280,6,"""19""",38580,38760
5453,408003,400501,60,38280,6,"""19""",38760,38820
5453,400501,406302,60,38280,6,"""19""",38820,38880
5453,406302,409601,120,38280,6,"""19""",38880,39000
5453,409601,405200,120,38280,6,"""19""",39000,39120
5453,112107,403102,60,39480,6,"""19""",39480,39540
5453,403102,404101,120,39480,6,"""19""",39540,39660
5453,404101,403001,60,39480,6,"""19""",39660,39720
5453,403001,406803,60,39480,6,"""19""",39720,39780
5453,406803,408003,180,39480,6,"""19""",39780,39960
5453,408003,400501,60,39480,6,"""19""",39960,40020
5453,400501,406302,60,39480,6,"""19""",40020,40080
5453,406302,409601,120,39480,6,"""19""",40080,40200
5453,409601,405200,120,39480,6,"""19""",40200,40320
5453,112107,403102,60,40680,6,"""19""",40680,40740
5453,403102,404101,120,40680,6,"""19""",40740,40860
5453,404101,403001,60,40680,6,"""19""",40860,40920
5453,403001,406803,60,40680,6,"""19""",40920,40980
5453,406803,408003,180,40680,6,"""19""",40980,41160
5453,408003,400501,60,40680,6,"""19""",41160,41220
5453,400501,406302,60,40680,6,"""19""",41220,41280
5453,406302,409601,120,40680,6,"""19""",41280,41400
5453,409601,405200,120,40680,6,"""19""",41400,41520
5453,112107,403102,60,41880,6,"""19""",41880,41940
5453,403102,404101,120,41880,6,"""19""",41940,42060
5453,404101,403001,60,41880,6,"""19""",42060,42120
5453,403001,406803,60,41880,6,"""19""",42120,42180
5453,406803,408003,180,41880,6,"""19""",42180,42360
5453,408003,400501,60,41880,6,"""19""",42360,42420
5453,400501,406302,60,41880,6,"""19""",42420,42480
5453,406302,409601,120,41880,6,"""19""",42480,42600
5453,409601,405200,120,41880,6,"""19""",42600,42720
5453,112107,403102,60,43080,6,"""19""",43080,43140
5453,403102,404101,120,43080,6,"""19""",43140,43260
5453,404101,403001,60,43080,6,"""19""",43260,43320
5453,403001,406803,60,43080,6,"""19""",43320,43380
5453,406803,408003,180,43080,6,"""19""",43380,43560
5453,408003,400501,60,43080,6,"""19""",43560,43620
5453,400501,406302,60,43080,6,"""19""",43620,43680
5453,406302,409601,120,43080,6,"""19""",43680,43800
5453,409601,405200,120,43080,6,"""19""",43800,43920
5453,112107,403102,60,44280,6,"""19""",44280,44340
5453,403102,404101,120,44280,6,"""19""",44340,44460
5453,404101,403001,60,44280,6,"""19""",44460,44520
5453,403001,406803,60,44280,6,"""19""",44520,44580
5453,406803,408003,180,44280,6,"""19""",44580,44760
5453,408003,400501,60,44280,6,"""19""",44760,44820
5453,400501,406302,60,44280,6,"""19""",44820,44880
5453,406302,409601,120,44280,6,"""19""",44880,45000
5453,409601,405200,120,44280,6,"""19""",45000,45120
5453,112107,403102,60,45480,6,"""19""",45480,45540
5453,403102,404101,120,45480,6,"""19""",45540,45660
5453,404101,403001,60,45480,6,"""19""",45660,45720
5453,403001,406803,60,45480,6,"""19""",45720,45780
5453,406803,408003,180,45480,6,"""19""",45780,45960
5453,408003,400501,60,45480,6,"""19""",45960,46020
5453,400501,406302,60,45480,6,"""19""",46020,46080
5453,406302,409601,120,45480,6,"""19""",46080,46200
5453,409601,405200,120,45480,6,"""19""",46200,46320
5453,112107,403102,60,46680,6,"""19""",46680,46740
5453,403102,404101,120,46680,6,"""19""",46740,46860
5453,404101,403001,60,46680,6,"""19""",46860,46920
5453,403001,406803,60,46680,6,"""19""",46920,46980
5453,406803,408003,180,46680,6,"""19""",46980,47160
5453,408003,400501,60,46680,6,"""19""",47160,47220
5453,400501,406302,60,46680,6,"""19""",47220,47280
5453,406302,409601,120,46680,6,"""19""",47280,47400
5453,409601,405200,120,46680,6,"""19""",47400,47520
5453,112107,403102,60,47880,6,"""19""",47880,47940
5453,403102,404101,120,47880,6,"""19""",47940,48060
5453,404101,403001,60,47880,6,"""19""",48060,48120
5453,403001,406803,60,47880,6,"""19""",48120,48180
5453,406803,408003,180,47880,6,"""19""",48180,48360
5453,408003,400501,60,47880,6,"""19""",48360,48420
5453,400501,406302,60,47880,6,"""19""",48420,48480
5453,406302,409601,120,47880,6,"""19""",48480,48600
5453,409601,405200,120,47880,6,"""19""",48600,48720
5453,112107,403102,60,49080,6,"""19""",49080,49140
5453,403102,404101,120,49080,6,"""19""",49140,49260
5453,404101,403001,60,49080,6,"""19""",49260,49320
5453,403001,406803,60,49080,6,"""19""",49320,49380
5453,406803,408003,180,49080,6,"""19""",49380,49560
5453,408003,400501,60,49080,6,"""19""",49560,49620
5453,400501,406302,60,49080,6,"""19""",49620,49680
5453,406302,409601,120,49080,6,"""19""",49680,49800
5453,409601,405200,120,49080,6,"""19""",49800,49920
5453,112107,403102,60,50280,6,"""19""",50280,50340
5453,403102,404101,120,50280,6,"""19""",50340,50460
5453,404101,403001,60,50280,6,"""19""",50460,50520
5453,403001,406803,60,50280,6,"""19""",50520,50580
5453,406803,408003,180,50280,6,"""19""",50580,50760
5453,408003,400501,60,50280,6,"""19""",50760,50820
5453,400501,406302,60,50280,6,"""19""",50820,50880
5453,406302,409601,120,50280,6,"""19""",50880,51000
5453,409601,405200,120,50280,6,"""19""",51000,51120
5453,112107,403102,60,51480,6,"""19""",51480,51540
5453,403102,404101,120,51480,6,"""19""",51540,51660
5453,404101,403001,60,51480,6,"""19""",51660,51720
5453,403001,406803,60,51480,6,"""19""",51720,51780
5453,406803,408003,180,51480,6,"""19""",51780,51960
5453,408003,400501,60,51480,6,"""19""",51960,52020
5453,400501,406302,60,51480,6,"""19""",52020,52080
5453,406302,409601,120,51480,6,"""19""",52080,52200
5453,409601,405200,120,51480,6,"""19""",52200,52320
5453,112107,403102,60,52680,6,"""19""",52680,52740
5453,403102,404101,120,52680,6,"""19""",52740,52860
5453,404101,403001,60,52680,6,"""19""",52860,52920
5453,403001,406803,60,52680,6,"""19""",52920,52980
5453,406803,408003,180,52680,6,"""19""",52980,53160
5453,408003,400501,60,52680,6,"""19""",53160,53220
5453,400501,406302,60,52680,6,"""19""",53220,53280
5453,406302,409601,120,52680,6,"""19""",53280,53400
5453,409601,405200,120,52680,6,"""19""",53400,53520
5453,112107,403102,60,53880,6,"""19""",53880,53940
5453,403102,404101,120,53880,6,"""19""",53940,54060
5453,404101,403001,60,53880,6,"""19""",54060,54120
5453,403001,406803,60,53880,6,"""19""",54120,54180
5453,406803,408003,180,53880,6,"""19""",54180,54360
5453,408003,400501,60,53880,6,"""19""",54360,54420
5453,400501,406302,60,53880,6,"""19""",54420,54480
5453,406302,409601,120,53880,6,"""19""",54480,54600
5453,409601,405200,120,53880,6,"""19""",54600,54720
5453,112107,403102,60,55080,6,"""19""",55080,55140
5453,403102,404101,120,55080,6,"""19""",55140,55260
5453,404101,403001,60,55080,6,"""19""",55260,55320
5453,403001,406803,60,55080,6,"""19""",55320,55380
5453,406803,408003,180,55080,6,"""19""",55380,55560
5453,408003,400501,60,55080,6,"""19""",55560,55620
5453,400501,406302,60,55080,6,"""19""",55620,55680
5453,406302,409601,120,55080,6,"""19""",55680,55800
5453,409601,405200,120,55080,6,"""19""",55800,55920
5454,405200,406303,60,24840,6,"""2""",24840,24900
5454,406303,400502,60,24840,6,"""2""",24900,24960
5454,400502,408005,120,24840,6,"""2""",24960,25080
5454,408005,406804,120,24840,6,"""2""",25080,25200
5454,406804,403002,60,24840,6,"""2""",25200,25260
5454,403002,404103,120,24840,6,"""2""",25260,25380
5454,404103,403104,120,24840,6,"""2""",25380,25500
5454,403104,112103,120,24840,6,"""2""",25500,25620
5454,112103,101104,120,24840,6,"""2""",25620,25740
5454,101104,102001,180,24840,6,"""2""",25740,25920
5454,102001,502202,180,24840,6,"""2""",25920,26100
5454,502202,500802,60,24840,6,"""2""",26100,26160
5454,500802,500103,60,24840,6,"""2""",26160,26220
5454,500103,501202,60,24840,6,"""2""",26220,26280
5454,501202,500403,120,24840,6,"""2""",26280,26400
5454,500403,503902,60,24840,6,"""2""",26400,26460
5454,503902,503303,60,24840,6,"""2""",26460,26520
5454,503303,501102,60,24840,6,"""2""",26520,26580
5454,501102,504002,60,24840,6,"""2""",26580,26640
5454,504002,503801,120,24840,6,"""2""",26640,26760
5454,503801,503800,60,24840,6,"""2""",26760,26820
5454,405200,406303,60,25440,6,"""2""",25440,25500
5454,406303,400502,60,25440,6,"""2""",25500,25560
5454,400502,408005,120,25440,6,"""2""",25560,25680
5454,408005,406804,120,25440,6,"""2""",25680,25800
5454,406804,403002,60,25440,6,"""2""",25800,25860
5454,403002,404103,120,25440,6,"""2""",25860,25980
5454,404103,403104,120,25440,6,"""2""",25980,26100
5454,403104,112103,120,25440,6,"""2""",26100,26220
5454,112103,101104,120,25440,6,"""2""",26220,26340
5454,101104,102001,180,25440,6,"""2""",26340,26520
5454,102001,502202,180,25440,6,"""2""",26520,26700
5454,502202,500802,60,25440,6,"""2""",26700,26760
5454,500802,500103,60,25440,6,"""2""",26760,26820
5454,500103,501202,60,25440,6,"""2""",26820,26880
5454,501202,500403,120,25440,6,"""2""",26880,27000
5454,500403,503902,60,25440,6,"""2""",27000,27060
5454,503902,503303,60,25440,6,"""2""",27060,27120
5454,503303,501102,60,25440,6,"""2""",27120,27180
5454,501102,504002,60,25440,6,"""2""",27180,27240
5454,504002,503801,120,25440,6,"""2""",27240,27360
5454,503801,503800,60,25440,6,"""2""",27360,27420
5454,405200,406303,60,26040,6,"""2""",26040,26100
5454,406303,400502,60,26040,6,"""2""",26100,26160
5454,400502,408005,120,26040,6,"""2""",26160,26280
5454,408005,406804,120,26040,6,"""2""",26280,26400
5454,406804,403002,60,26040,6,"""2""",26400,26460
5454,403002,404103,120,26040,6,"""2""",26460,26580
5454,404103,403104,120,26040,6,"""2""",26580,26700
5454,403104,112103,120,26040,6,"""2""",26700,26820
5454,112103,101104,120,26040,6,"""2""",26820,26940
5454,101104,102001,180,26040,6,"""2""",26940,27120
5454,102001,502202,180,26040,6,"""2""",27120,27300
5454,502202,500802,60,26040,6,"""2""",27300,27360
5454,500802,500103,60,26040,6,"""2""",27360,27420
5454,500103,501202,60,26040,6,"""2""",27420,27480
5454,501202,500403,120,26040,6,"""2""",27480,27600
5454,500403,503902,60,26040,6,"""2""",27600,27660
5454,503902,503303,60,26040,6,"""2""",27660,27720
5454,503303,501102,60,26040,6,"""2""",27720,27780
5454,501102,504002,60,26040,6,"""2""",27780,27840
5454,504002,503801,120,26040,6,"""2""",27840,27960
5454,503801,503800,60,26040,6,"""2""",27960,28020
5454,405200,406303,60,26640,6,"""2""",26640,26700
5454,406303,400502,60,26640,6,"""2""",26700,26760
5454,400502,408005,120,26640,6,"""2""",26760,26880
5454,408005,406804,120,26640,6,"""2""",26880,27000
5454,406804,403002,60,26640,6,"""2""",27000,27060
5454,403002,404103,120,26640,6,"""2""",27060,27180
5454,404103,403104,120,26640,6,"""2""",27180,27300
5454,403104,112103,120,26640,6,"""2""",27300,27420
5454,112103,101104,120,26640,6,"""2""",27420,27540
5454,101104,102001,180,26640,6,"""2""",27540,27720
5454,102001,502202,180,26640,6,"""2""",27720,27900
5454,502202,500802,60,26640,6,"""2""",27900,27960
5454,500802,500103,60,26640,6,"""2""",27960,28020
5454,500103,501202,60,26640,6,"""2""",28020,28080
5454,501202,500403,120,26640,6,"""2""",28080,28200
5454,500403,503902,60,26640,6,"""2""",28200,28260
5454,503902,503303,60,26640,6,"""2""",28260,28320
5454,503303,501102,60,26640,6,"""2""",28320,28380
5454,501102,504002,60,26640,6,"""2""",28380,28440
5454,504002,503801,120,26640,6,"""2""",28440,28560
5454,503801,503800,60,26640,6,"""2""",28560,28620
5454,405200,406303,60,27240,6,"""2""",27240,27300
5454,406303,400502,60,27240,6,"""2""",27300,27360
5454,400502,408005,120,27240,6,"""2""",27360,27480
5454,408005,406804,120,27240,6,"""2""",27480,27600
5454,406804,403002,60,27240,6,"""2""",27600,27660
5454,403002,404103,120,27240,6,"""2""",27660,27780
5454,404103,403104,120,27240,6,"""2""",27780,27900
5454,403104,112103,120,27240,6,"""2""",27900,28020
5454,112103,101104,120,27240,6,"""2""",28020,28140
5454,101104,102001,180,27240,6,"""2""",28140,28320
5454,102001,502202,180,27240,6,"""2""",28320,28500
5454,502202,500802,60,27240,6,"""2""",28500,28560
5454,500802,500103,60,27240,6,"""2""",28560,28620
5454,500103,501202,60,27240,6,"""2""",28620,28680
5454,501202,500403,120,27240,6,"""2""",28680,28800
5454,500403,503902,60,27240,6,"""2""",28800,28860
5454,503902,503303,60,27240,6,"""2""",28860,28920
5454,503303,501102,60,27240,6,"""2""",28920,28980
5454,501102,504002,60,27240,6,"""2""",28980,29040
5454,504002,503801,120,27240,6,"""2""",29040,29160
5454,503801,503800,60,27240,6,"""2""",29160,29220
5454,405200,406303,60,27840,6,"""2""",27840,27900
5454,406303,400502,60,27840,6,"""2""",27900,27960
5454,400502,408005,120,27840,6,"""2""",27960,28080
5454,408005,406804,120,27840,6,"""2""",28080,28200
5454,406804,403002,60,27840,6,"""2""",28200,28260
5454,403002,404103,120,27840,6,"""2""",28260,28380
5454,404103,403104,120,27840,6,"""2""",28380,28500
5454,403104,112103,120,27840,6,"""2""",28500,28620
5454,112103,101104,120,27840,6,"""2""",28620,28740
5454,101104,102001,180,27840,6,"""2""",28740,28920
5454,102001,502202,180,27840,6,"""2""",28920,29100
5454,502202,500802,60,27840,6,"""2""",29100,29160
5454,500802,500103,60,27840,6,"""2""",29160,29220
5454,500103,501202,60,27840,6,"""2""",29220,29280
5454,501202,500403,120,27840,6,"""2""",29280,29400
5454,500403,503902,60,27840,6,"""2""",29400,29460
5454,503902,503303,60,27840,6,"""2""",29460,29520
5454,503303,501102,60,27840,6,"""2""",29520,29580
5454,501102,504002,60,27840,6,"""2""",29580,29640
5454,504002,503801,120,27840,6,"""2""",29640,29760
5454,503801,503800,60,27840,6,"""2""",29760,29820
5454,405200,406303,60,28440,6,"""2""",28440,28500
5454,406303,400502,60,28440,6,"""2""",28500,28560
5454,400502,408005,120,28440,6,"""2""",28560,28680
5454,408005,406804,120,28440,6,"""2""",28680,28800
5454,406804,403002,60,28440,6,"""2""",28800,28860
5454,403002,404103,120,28440,6,"""2""",28860,28980
5454,404103,403104,120,28440,6,"""2""",28980,29100
5454,403104,112103,120,28440,6,"""2""",29100,29220
5454,112103,101104,120,28440,6,"""2""",29220,29340
5454,101104,102001,180,28440,6,"""2""",29340,29520
5454,102001,502202,180,28440,6,"""2""",29520,29700
5454,502202,500802,60,28440,6,"""2""",29700,29760
5454,500802,500103,60,28440,6,"""2""",29760,29820
5454,500103,501202,60,28440,6,"""2""",29820,29880
5454,501202,500403,120,28440,6,"""2""",29880,30000
5454,500403,503902,60,28440,6,"""2""",30000,30060
5454,503902,503303,60,28440,6,"""2""",30060,30120
5454,503303,501102,60,28440,6,"""2""",30120,30180
5454,501102,504002,60,28440,6,"""2""",30180,30240
5454,504002,503801,120,28440,6,"""2""",30240,30360
5454,503801,503800,60,28440,6,"""2""",30360,30420
5454,405200,406303,60,29040,6,"""2""",29040,29100
5454,406303,400502,60,29040,6,"""2""",29100,29160
5454,400502,408005,120,29040,6,"""2""",29160,29280
5454,408005,406804,120,29040,6,"""2""",29280,29400
5454,406804,403002,60,29040,6,"""2""",29400,29460
5454,403002,404103,120,29040,6,"""2""",29460,29580
5454,404103,403104,120,29040,6,"""2""",29580,29700
5454,403104,112103,120,29040,6,"""2""",29700,29820
5454,112103,101104,120,29040,6,"""2""",29820,29940
5454,101104,102001,180,29040,6,"""2""",29940,30120
5454,102001,502202,180,29040,6,"""2""",30120,30300
5454,502202,500802,60,29040,6,"""2""",30300,30360
5454,500802,500103,60,29040,6,"""2""",30360,30420
5454,500103,501202,60,29040,6,"""2""",30420,30480
5454,501202,500403,120,29040,6,"""2""",30480,30600
5454,500403,503902,60,29040,6,"""2""",30600,30660
5454,503902,503303,60,29040,6,"""2""",30660,30720
5454,503303,501102,60,29040,6,"""2""",30720,30780
5454,501102,504002,60,29040,6,"""2""",30780,30840
5454,504002,503801,120,29040,6,"""2""",30840,30960
5454,503801,503800,60,29040,6,"""2""",30960,31020
5454,405200,406303,60,29640,6,"""2""",29640,29700
5454,406303,400502,60,29640,6,"""2""",29700,29760
5454,400502,408005,120,29640,6,"""2""",29760,29880
5454,408005,406804,120,29640,6,"""2""",29880,30000
5454,406804,403002,60,29640,6,"""2""",30000,30060
5454,403002,404103,120,29640,6,"""2""",30060,30180
5454,404103,403104,120,29640,6,"""2""",30180,30300
5454,403104,112103,120,29640,6,"""2""",30300,30420
5454,112103,101104,120,29640,6,"""2""",30420,30540
5454,101104,102001,180,29640,6,"""2""",30540,30720
5454,102001,502202,180,29640,6,"""2""",30720,30900
5454,502202,500802,60,29640,6,"""2""",30900,30960
5454,500802,500103,60,29640,6,"""2""",30960,31020
5454,500103,501202,60,29640,6,"""2""",31020,31080
5454,501202,500403,120,29640,6,"""2""",31080,31200
5454,500403,503902,60,29640,6,"""2""",31200,31260
5454,503902,503303,60,29640,6,"""2""",31260,31320
5454,503303,501102,60,29640,6,"""2""",31320,31380
5454,501102,504002,60,29640,6,"""2""",31380,31440
5454,504002,503801,120,29640,6,"""2""",31440,31560
5454,503801,503800,60,29640,6,"""2""",31560,31620
5454,405200,406303,60,30240,6,"""2""",30240,30300
5454,406303,400502,60,30240,6,"""2""",30300,30360
5454,400502,408005,120,30240,6,"""2""",30360,30480
5454,408005,406804,120,30240,6,"""2""",30480,30600
5454,406804,403002,60,30240,6,"""2""",30600,30660
5454,403002,404103,120,30240,6,"""2""",30660,30780
5454,404103,403104,120,30240,6,"""2""",30780,30900
5454,403104,112103,120,30240,6,"""2""",30900,31020
5454,112103,101104,120,30240,6,"""2""",31020,31140
5454,101104,102001,180,30240,6,"""2""",31140,31320
5454,102001,502202,180,30240,6,"""2""",31320,31500
5454,502202,500802,60,30240,6,"""2""",31500,31560
5454,500802,500103,60,30240,6,"""2""",31560,31620
5454,500103,501202,60,30240,6,"""2""",31620,31680
5454,501202,500403,120,30240,6,"""2""",31680,31800
5454,500403,503902,60,30240,6,"""2""",31800,31860
5454,503902,503303,60,30240,6,"""2""",31860,31920
5454,503303,501102,60,30240,6,"""2""",31920,31980
5454,501102,504002,60,30240,6,"""2""",31980,32040
5454,504002,503801,120,30240,6,"""2""",32040,32160
5454,503801,503800,60,30240,6,"""2""",32160,32220
5454,405200,406303,60,30840,6,"""2""",30840,30900
5454,406303,400502,60,30840,6,"""2""",30900,30960
5454,400502,408005,120,30840,6,"""2""",30960,31080
5454,408005,406804,120,30840,6,"""2""",31080,31200
5454,406804,403002,60,30840,6,"""2""",31200,31260
5454,403002,404103,120,30840,6,"""2""",31260,31380
5454,404103,403104,120,30840,6,"""2""",31380,31500
5454,403104,112103,120,30840,6,"""2""",31500,31620
5454,112103,101104,120,30840,6,"""2""",31620,31740
5454,101104,102001,180,30840,6,"""2""",31740,31920
5454,102001,502202,180,30840,6,"""2""",31920,32100
5454,502202,500802,60,30840,6,"""2""",32100,32160
5454,500802,500103,60,30840,6,"""2""",32160,32220
5454,500103,501202,60,30840,6,"""2""",32220,32280
5454,501202,500403,120,30840,6,"""2""",32280,32400
5454,500403,503902,60,30840,6,"""2""",32400,32460
5454,503902,503303,60,30840,6,"""2""",32460,32520
5454,503303,501102,60,30840,6,"""2""",32520,32580
5454,501102,504002,60,30840,6,"""2""",32580,32640
5454,504002,503801,120,30840,6,"""2""",32640,32760
5454,503801,503800,60,30840,6,"""2""",32760,32820
5454,405200,406303,60,31440,6,"""2""",31440,31500
5454,406303,400502,60,31440,6,"""2""",31500,31560
5454,400502,408005,120,31440,6,"""2""",31560,31680
5454,408005,406804,120,31440,6,"""2""",31680,31800
5454,406804,403002,60,31440,6,"""2""",31800,31860
5454,403002,404103,120,31440,6,"""2""",31860,31980
5454,404103,403104,120,31440,6,"""2""",31980,32100
5454,403104,112103,120,31440,6,"""2""",32100,32220
5454,112103,101104,120,31440,6,"""2""",32220,32340
5454,101104,102001,180,31440,6,"""2""",32340,32520
5454,102001,502202,180,31440,6,"""2""",32520,32700
5454,502202,500802,60,31440,6,"""2""",32700,32760
5454,500802,500103,60,31440,6,"""2""",32760,32820
5454,500103,501202,60,31440,6,"""2""",32820,32880
5454,501202,500403,120,31440,6,"""2""",32880,33000
5454,500403,503902,60,31440,6,"""2""",33000,33060
5454,503902,503303,60,31440,6,"""2""",33060,33120
5454,503303,501102,60,31440,6,"""2""",33120,33180
5454,501102,504002,60,31440,6,"""2""",33180,33240
5454,504002,503801,120,31440,6,"""2""",33240,33360
5454,503801,503800,60,31440,6,"""2""",33360,33420
5454,405200,406303,60,32040,6,"""2""",32040,32100
5454,406303,400502,60,32040,6,"""2""",32100,32160
5454,400502,408005,120,32040,6,"""2""",32160,32280
5454,408005,406804,120,32040,6,"""2""",32280,32400
5454,406804,403002,60,32040,6,"""2""",32400,32460
5454,403002,404103,120,32040,6,"""2""",32460,32580
5454,404103,403104,120,32040,6,"""2""",32580,32700
5454,403104,112103,120,32040,6,"""2""",32700,32820
5454,112103,101104,120,32040,6,"""2""",32820,32940
5454,101104,102001,180,32040,6,"""2""",32940,33120
5454,102001,502202,180,32040,6,"""2""",33120,33300
5454,502202,500802,60,32040,6,"""2""",33300,33360
5454,500802,500103,60,32040,6,"""2""",33360,33420
5454,500103,501202,60,32040,6,"""2""",33420,33480
5454,501202,500403,120,32040,6,"""2""",33480,33600
5454,500403,503902,60,32040,6,"""2""",33600,33660
5454,503902,503303,60,32040,6,"""2""",33660,33720
5454,503303,501102,60,32040,6,"""2""",33720,33780
5454,501102,504002,60,32040,6,"""2""",33780,33840
5454,504002,503801,120,32040,6,"""2""",33840,33960
5454,503801,503800,60,32040,6,"""2""",33960,34020
5454,405200,406303,60,32640,6,"""2""",32640,32700
5454,406303,400502,60,32640,6,"""2""",32700,32760
5454,400502,408005,120,32640,6,"""2""",32760,32880
5454,408005,406804,120,32640,6,"""2""",32880,33000
5454,406804,403002,60,32640,6,"""2""",33000,33060
5454,403002,404103,120,32640,6,"""2""",33060,33180
5454,404103,403104,120,32640,6,"""2""",33180,33300
5454,403104,112103,120,32640,6,"""2""",33300,33420
5454,112103,101104,120,32640,6,"""2""",33420,33540
5454,101104,102001,180,32640,6,"""2""",33540,33720
5454,102001,502202,180,32640,6,"""2""",33720,33900
5454,502202,500802,60,32640,6,"""2""",33900,33960
5454,500802,500103,60,32640,6,"""2""",33960,34020
5454,500103,501202,60,32640,6,"""2""",34020,34080
5454,501202,500403,120,32640,6,"""2""",34080,34200
5454,500403,503902,60,32640,6,"""2""",34200,34260
5454,503902,503303,60,32640,6,"""2""",34260,34320
5454,503303,501102,60,32640,6,"""2""",34320,34380
5454,501102,504002,60,32640,6,"""2""",34380,34440
5454,504002,503801,120,32640,6,"""2""",34440,34560
5454,503801,503800,60,32640,6,"""2""",34560,34620
5454,405200,406303,60,33240,6,"""2""",33240,33300
5454,406303,400502,60,33240,6,"""2""",33300,33360
5454,400502,408005,120,33240,6,"""2""",33360,33480
5454,408005,406804,120,33240,6,"""2""",33480,33600
5454,406804,403002,60,33240,6,"""2""",33600,33660
5454,403002,404103,120,33240,6,"""2""",33660,33780
5454,404103,403104,120,33240,6,"""2""",33780,33900
5454,403104,112103,120,33240,6,"""2""",33900,34020
5454,112103,101104,120,33240,6,"""2""",34020,34140
5454,101104,102001,180,33240,6,"""2""",34140,34320
5454,102001,502202,180,33240,6,"""2""",34320,34500
5454,502202,500802,60,33240,6,"""2""",34500,34560
5454,500802,500103,60,33240,6,"""2""",34560,34620
5454,500103,501202,60,33240,6,"""2""",34620,34680
5454,501202,500403,120,33240,6,"""2""",34680,34800
5454,500403,503902,60,33240,6,"""2""",34800,34860
5454,503902,503303,60,33240,6,"""2""",34860,34920
5454,503303,501102,60,33240,6,"""2""",34920,34980
5454,501102,504002,60,33240,6,"""2""",34980,35040
5454,504002,503801,120,33240,6,"""2""",35040,35160
5454,503801,503800,60,33240,6,"""2""",35160,35220
5454,405200,406303,60,33840,6,"""2""",33840,33900
5454,406303,400502,60,33840,6,"""2""",33900,33960
5454,400502,408005,120,33840,6,"""2""",33960,34080
5454,408005,406804,120,33840,6,"""2""",34080,34200
5454,406804,403002,60,33840,6,"""2""",34200,34260
5454,403002,404103,120,33840,6,"""2""",34260,34380
5454,404103,403104,120,33840,6,"""2""",34380,34500
5454,403104,112103,120,33840,6,"""2""",34500,34620
5454,112103,101104,120,33840,6,"""2""",34620,34740
5454,101104,102001,180,33840,6,"""2""",34740,34920
5454,102001,502202,180,33840,6,"""2""",34920,35100
5454,502202,500802,60,33840,6,"""2""",35100,35160
5454,500802,500103,60,33840,6,"""2""",35160,35220
5454,500103,501202,60,33840,6,"""2""",35220,35280
5454,501202,500403,120,33840,6,"""2""",35280,35400
5454,500403,503902,60,33840,6,"""2""",35400,35460
5454,503902,503303,60,33840,6,"""2""",35460,35520
5454,503303,501102,60,33840,6,"""2""",35520,35580
5454,501102,504002,60,33840,6,"""2""",35580,35640
5454,504002,503801,120,33840,6,"""2""",35640,35760
5454,503801,503800,60,33840,6,"""2""",35760,35820
5454,405200,406303,60,34440,6,"""2""",34440,34500
5454,406303,400502,60,34440,6,"""2""",34500,34560
5454,400502,408005,120,34440,6,"""2""",34560,34680
5454,408005,406804,120,34440,6,"""2""",34680,34800
5454,406804,403002,60,34440,6,"""2""",34800,34860
5454,403002,404103,120,34440,6,"""2""",34860,34980
5454,404103,403104,120,34440,6,"""2""",34980,35100
5454,403104,112103,120,34440,6,"""2""",35100,35220
5454,112103,101104,120,34440,6,"""2""",35220,35340
5454,101104,102001,180,34440,6,"""2""",35340,35520
5454,102001,502202,180,34440,6,"""2""",35520,35700
5454,502202,500802,60,34440,6,"""2""",35700,35760
5454,500802,500103,60,34440,6,"""2""",35760,35820
5454,500103,501202,60,34440,6,"""2""",35820,35880
5454,501202,500403,120,34440,6,"""2""",35880,36000
5454,500403,503902,60,34440,6,"""2""",36000,36060
5454,503902,503303,60,34440,6,"""2""",36060,36120
5454,503303,501102,60,34440,6,"""2""",36120,36180
5454,501102,504002,60,34440,6,"""2""",36180,36240
5454,504002,503801,120,34440,6,"""2""",36240,36360
5454,503801,503800,60,34440,6,"""2""",36360,36420
5454,405200,406303,60,35040,6,"""2""",35040,35100
5454,406303,400502,60,35040,6,"""2""",35100,35160
5454,400502,408005,120,35040,6,"""2""",35160,35280
5454,408005,406804,120,35040,6,"""2""",35280,35400
5454,406804,403002,60,35040,6,"""2""",35400,35460
5454,403002,404103,120,35040,6,"""2""",35460,35580
5454,404103,403104,120,35040,6,"""2""",35580,35700
5454,403104,112103,120,35040,6,"""2""",35700,35820
5454,112103,101104,120,35040,6,"""2""",35820,35940
5454,101104,102001,180,35040,6,"""2""",35940,36120
5454,102001,502202,180,35040,6,"""2""",36120,36300
5454,502202,500802,60,35040,6,"""2""",36300,36360
5454,500802,500103,60,35040,6,"""2""",36360,36420
5454,500103,501202,60,35040,6,"""2""",36420,36480
5454,501202,500403,120,35040,6,"""2""",36480,36600
5454,500403,503902,60,35040,6,"""2""",36600,36660
5454,503902,503303,60,35040,6,"""2""",36660,36720
5454,503303,501102,60,35040,6,"""2""",36720,36780
5454,501102,504002,60,35040,6,"""2""",36780,36840
5454,504002,503801,120,35040,6,"""2""",36840,36960
5454,503801,503800,60,35040,6,"""2""",36960,37020
5454,405200,406303,60,36240,6,"""2""",36240,36300
5454,406303,400502,60,36240,6,"""2""",36300,36360
5454,400502,408005,120,36240,6,"""2""",36360,36480
5454,408005,406804,120,36240,6,"""2""",36480,36600
5454,406804,403002,60,36240,6,"""2""",36600,36660
5454,403002,404103,120,36240,6,"""2""",36660,36780
5454,404103,403104,120,36240,6,"""2""",36780,36900
5454,403104,112103,120,36240,6,"""2""",36900,37020
5454,112103,101104,120,36240,6,"""2""",37020,37140
5454,101104,102001,180,36240,6,"""2""",37140,37320
5454,102001,502202,180,36240,6,"""2""",37320,37500
5454,502202,500802,60,36240,6,"""2""",37500,37560
5454,500802,500103,60,36240,6,"""2""",37560,37620
5454,500103,501202,60,36240,6,"""2""",37620,37680
5454,501202,500403,120,36240,6,"""2""",37680,37800
5454,500403,503902,60,36240,6,"""2""",37800,37860
5454,503902,503303,60,36240,6,"""2""",37860,37920
5454,503303,501102,60,36240,6,"""2""",37920,37980
5454,501102,504002,60,36240,6,"""2""",37980,38040
5454,504002,503801,120,36240,6,"""2""",38040,38160
5454,503801,503800,60,36240,6,"""2""",38160,38220
5454,405200,406303,60,37440,6,"""2""",37440,37500
5454,406303,400502,60,37440,6,"""2""",37500,37560
5454,400502,408005,120,37440,6,"""2""",37560,37680
5454,408005,406804,120,37440,6,"""2""",37680,37800
5454,406804,403002,60,37440,6,"""2""",37800,37860
5454,403002,404103,120,37440,6,"""2""",37860,37980
5454,404103,403104,120,37440,6,"""2""",37980,38100
5454,403104,112103,120,37440,6,"""2""",38100,38220
5454,112103,101104,120,37440,6,"""2""",38220,38340
5454,101104,102001,180,37440,6,"""2""",38340,38520
5454,102001,502202,180,37440,6,"""2""",38520,38700
5454,502202,500802,60,37440,6,"""2""",38700,38760
5454,500802,500103,60,37440,6,"""2""",38760,38820
5454,500103,501202,60,37440,6,"""2""",38820,38880
5454,501202,500403,120,37440,6,"""2""",38880,39000
5454,500403,503902,60,37440,6,"""2""",39000,39060
5454,503902,503303,60,37440,6,"""2""",39060,39120
5454,503303,501102,60,37440,6,"""2""",39120,39180
5454,501102,504002,60,37440,6,"""2""",39180,39240
5454,504002,503801,120,37440,6,"""2""",39240,39360
5454,503801,503800,60,37440,6,"""2""",39360,39420
5454,405200,406303,60,38640,6,"""2""",38640,38700
5454,406303,400502,60,38640,6,"""2""",38700,38760
5454,400502,408005,120,38640,6,"""2""",38760,38880
5454,408005,406804,120,38640,6,"""2""",38880,39000
5454,406804,403002,60,38640,6,"""2""",39000,39060
5454,403002,404103,120,38640,6,"""2""",39060,39180
5454,404103,403104,120,38640,6,"""2""",39180,39300
5454,403104,112103,120,38640,6,"""2""",39300,39420
5454,112103,101104,120,38640,6,"""2""",39420,39540
5454,101104,102001,180,38640,6,"""2""",39540,39720
5454,102001,502202,180,38640,6,"""2""",39720,39900
5454,502202,500802,60,38640,6,"""2""",39900,39960
5454,500802,500103,60,38640,6,"""2""",39960,40020
5454,500103,501202,60,38640,6,"""2""",40020,40080
5454,501202,500403,120,38640,6,"""2""",40080,40200
5454,500403,503902,60,38640,6,"""2""",40200,40260
5454,503902,503303,60,38640,6,"""2""",40260,40320
5454,503303,501102,60,38640,6,"""2""",40320,40380
5454,501102,504002,60,38640,6,"""2""",40380,40440
5454,504002,503801,120,38640,6,"""2""",40440,40560
5454,503801,503800,60,38640,6,"""2""",40560,40620
5454,405200,406303,60,39840,6,"""2""",39840,39900
5454,406303,400502,60,39840,6,"""2""",39900,39960
5454,400502,408005,120,39840,6,"""2""",39960,40080
5454,408005,406804,120,39840,6,"""2""",40080,40200
5454,406804,403002,60,39840,6,"""2""",40200,40260
5454,403002,404103,120,39840,6,"""2""",40260,40380
5454,404103,403104,120,39840,6,"""2""",40380,40500
5454,403104,112103,120,39840,6,"""2""",40500,40620
5454,112103,101104,120,39840,6,"""2""",40620,40740
5454,101104,102001,180,39840,6,"""2""",40740,40920
5454,102001,502202,180,39840,6,"""2""",40920,41100
5454,502202,500802,60,39840,6,"""2""",41100,41160
5454,500802,500103,60,39840,6,"""2""",41160,41220
5454,500103,501202,60,39840,6,"""2""",41220,41280
5454,501202,500403,120,39840,6,"""2""",41280,41400
5454,500403,503902,60,39840,6,"""2""",41400,41460
5454,503902,503303,60,39840,6,"""2""",41460,41520
5454,503303,501102,60,39840,6,"""2""",41520,41580
5454,501102,504002,60,39840,6,"""2""",41580,41640
5454,504002,503801,120,39840,6,"""2""",41640,41760
5454,503801,503800,60,39840,6,"""2""",41760,41820
5454,405200,406303,60,41040,6,"""2""",41040,41100
5454,406303,400502,60,41040,6,"""2""",41100,41160
5454,400502,408005,120,41040,6,"""2""",41160,41280
5454,408005,406804,120,41040,6,"""2""",41280,41400
5454,406804,403002,60,41040,6,"""2""",41400,41460
5454,403002,404103,120,41040,6,"""2""",41460,41580
5454,404103,403104,120,41040,6,"""2""",41580,41700
5454,403104,112103,120,41040,6,"""2""",41700,41820
5454,112103,101104,120,41040,6,"""2""",41820,41940
5454,101104,102001,180,41040,6,"""2""",41940,42120
5454,102001,502202,180,41040,6,"""2""",42120,42300
5454,502202,500802,60,41040,6,"""2""",42300,42360
5454,500802,500103,60,41040,6,"""2""",42360,42420
5454,500103,501202,60,41040,6,"""2""",42420,42480
5454,501202,500403,120,41040,6,"""2""",42480,42600
5454,500403,503902,60,41040,6,"""2""",42600,42660
5454,503902,503303,60,41040,6,"""2""",42660,42720
5454,503303,501102,60,41040,6,"""2""",42720,42780
5454,501102,504002,60,41040,6,"""2""",42780,42840
5454,504002,503801,120,41040,6,"""2""",42840,42960
5454,503801,503800,60,41040,6,"""2""",42960,43020
5454,405200,406303,60,42240,6,"""2""",42240,42300
5454,406303,400502,60,42240,6,"""2""",42300,42360
5454,400502,408005,120,42240,6,"""2""",42360,42480
5454,408005,406804,120,42240,6,"""2""",42480,42600
5454,406804,403002,60,42240,6,"""2""",42600,42660
5454,403002,404103,120,42240,6,"""2""",42660,42780
5454,404103,403104,120,42240,6,"""2""",42780,42900
5454,403104,112103,120,42240,6,"""2""",42900,43020
5454,112103,101104,120,42240,6,"""2""",43020,43140
5454,101104,102001,180,42240,6,"""2""",43140,43320
5454,102001,502202,180,42240,6,"""2""",43320,43500
5454,502202,500802,60,42240,6,"""2""",43500,43560
5454,500802,500103,60,42240,6,"""2""",43560,43620
5454,500103,501202,60,42240,6,"""2""",43620,43680
5454,501202,500403,120,42240,6,"""2""",43680,43800
5454,500403,503902,60,42240,6,"""2""",43800,43860
5454,503902,503303,60,42240,6,"""2""",43860,43920
5454,503303,501102,60,42240,6,"""2""",43920,43980
5454,501102,504002,60,42240,6,"""2""",43980,44040
5454,504002,503801,120,42240,6,"""2""",44040,44160
5454,503801,503800,60,42240,6,"""2""",44160,44220
5454,405200,406303,60,43440,6,"""2""",43440,43500
5454,406303,400502,60,43440,6,"""2""",43500,43560
5454,400502,408005,120,43440,6,"""2""",43560,43680
5454,408005,406804,120,43440,6,"""2""",43680,43800
5454,406804,403002,60,43440,6,"""2""",43800,43860
5454,403002,404103,120,43440,6,"""2""",43860,43980
5454,404103,403104,120,43440,6,"""2""",43980,44100
5454,403104,112103,120,43440,6,"""2""",44100,44220
5454,112103,101104,120,43440,6,"""2""",44220,44340
5454,101104,102001,180,43440,6,"""2""",44340,44520
5454,102001,502202,180,43440,6,"""2""",44520,44700
5454,502202,500802,60,43440,6,"""2""",44700,44760
5454,500802,500103,60,43440,6,"""2""",44760,44820
5454,500103,501202,60,43440,6,"""2""",44820,44880
5454,501202,500403,120,43440,6,"""2""",44880,45000
5454,500403,503902,60,43440,6,"""2""",45000,45060
5454,503902,503303,60,43440,6,"""2""",45060,45120
5454,503303,501102,60,43440,6,"""2""",45120,45180
5454,501102,504002,60,43440,6,"""2""",45180,45240
5454,504002,503801,120,43440,6,"""2""",45240,45360
5454,503801,503800,60,43440,6,"""2""",45360,45420
5454,405200,406303,60,44640,6,"""2""",44640,44700
5454,406303,400502,60,44640,6,"""2""",44700,44760
5454,400502,408005,120,44640,6,"""2""",44760,44880
5454,408005,406804,120,44640,6,"""2""",44880,45000
5454,406804,403002,60,44640,6,"""2""",45000,45060
5454,403002,404103,120,44640,6,"""2""",45060,45180
5454,404103,403104,120,44640,6,"""2""",45180,45300
5454,403104,112103,120,44640,6,"""2""",45300,45420
5454,112103,101104,120,44640,6,"""2""",45420,45540
5454,101104,102001,180,44640,6,"""2""",45540,45720
5454,102001,502202,180,44640,6,"""2""",45720,45900
5454,502202,500802,60,44640,6,"""2""",45900,45960
5454,500802,500103,60,44640,6,"""2""",45960,46020
5454,500103,501202,60,44640,6,"""2""",46020,46080
5454,501202,500403,120,44640,6,"""2""",46080,46200
5454,500403,503902,60,44640,6,"""2""",46200,46260
5454,503902,503303,60,44640,6,"""2""",46260,46320
5454,503303,501102,60,44640,6,"""2""",46320,46380
5454,501102,504002,60,44640,6,"""2""",46380,46440
5454,504002,503801,120,44640,6,"""2""",46440,46560
5454,503801,503800,60,44640,6,"""2""",46560,46620
5454,405200,406303,60,45840,6,"""2""",45840,45900
5454,406303,400502,60,45840,6,"""2""",45900,45960
5454,400502,408005,120,45840,6,"""2""",45960,46080
5454,408005,406804,120,45840,6,"""2""",46080,46200
5454,406804,403002,60,45840,6,"""2""",46200,46260
5454,403002,404103,120,45840,6,"""2""",46260,46380
5454,404103,403104,120,45840,6,"""2""",46380,46500
5454,403104,112103,120,45840,6,"""2""",46500,46620
5454,112103,101104,120,45840,6,"""2""",46620,46740
5454,101104,102001,180,45840,6,"""2""",46740,46920
5454,102001,502202,180,45840,6,"""2""",46920,47100
5454,502202,500802,60,45840,6,"""2""",47100,47160
5454,500802,500103,60,45840,6,"""2""",47160,47220
5454,500103,501202,60,45840,6,"""2""",47220,47280
5454,501202,500403,120,45840,6,"""2""",47280,47400
5454,500403,503902,60,45840,6,"""2""",47400,47460
5454,503902,503303,60,45840,6,"""2""",47460,47520
5454,503303,501102,60,45840,6,"""2""",47520,47580
5454,501102,504002,60,45840,6,"""2""",47580,47640
5454,504002,503801,120,45840,6,"""2""",47640,47760
5454,503801,503800,60,45840,6,"""2""",47760,47820
5454,405200,406303,60,47040,6,"""2""",47040,47100
5454,406303,400502,60,47040,6,"""2""",47100,47160
5454,400502,408005,120,47040,6,"""2""",47160,47280
5454,408005,406804,120,47040,6,"""2""",47280,47400
5454,406804,403002,60,47040,6,"""2""",47400,47460
5454,403002,404103,120,47040,6,"""2""",47460,47580
5454,404103,403104,120,47040,6,"""2""",47580,47700
5454,403104,112103,120,47040,6,"""2""",47700,47820
5454,112103,101104,120,47040,6,"""2""",47820,47940
5454,101104,102001,180,47040,6,"""2""",47940,48120
5454,102001,502202,180,47040,6,"""2""",48120,48300
5454,502202,500802,60,47040,6,"""2""",48300,48360
5454,500802,500103,60,47040,6,"""2""",48360,48420
5454,500103,501202,60,47040,6,"""2""",48420,48480
5454,501202,500403,120,47040,6,"""2""",48480,48600
5454,500403,503902,60,47040,6,"""2""",48600,48660
5454,503902,503303,60,47040,6,"""2""",48660,48720
5454,503303,501102,60,47040,6,"""2""",48720,48780
5454,501102,504002,60,47040,6,"""2""",48780,48840
5454,504002,503801,120,47040,6,"""2""",48840,48960
5454,503801,503800,60,47040,6,"""2""",48960,49020
5454,405200,406303,60,48240,6,"""2""",48240,48300
5454,406303,400502,60,48240,6,"""2""",48300,48360
5454,400502,408005,120,48240,6,"""2""",48360,48480
5454,408005,406804,120,48240,6,"""2""",48480,48600
5454,406804,403002,60,48240,6,"""2""",48600,48660
5454,403002,404103,120,48240,6,"""2""",48660,48780
5454,404103,403104,120,48240,6,"""2""",48780,48900
5454,403104,112103,120,48240,6,"""2""",48900,49020
5454,112103,101104,120,48240,6,"""2""",49020,49140
5454,101104,102001,180,48240,6,"""2""",49140,49320
5454,102001,502202,180,48240,6,"""2""",49320,49500
5454,502202,500802,60,48240,6,"""2""",49500,49560
5454,500802,500103,60,48240,6,"""2""",49560,49620
5454,500103,501202,60,48240,6,"""2""",49620,49680
5454,501202,500403,120,48240,6,"""2""",49680,49800
5454,500403,503902,60,48240,6,"""2""",49800,49860
5454,503902,503303,60,48240,6,"""2""",49860,49920
5454,503303,501102,60,48240,6,"""2""",49920,49980
5454,501102,504002,60,48240,6,"""2""",49980,50040
5454,504002,503801,120,48240,6,"""2""",50040,50160
5454,503801,503800,60,48240,6,"""2""",50160,50220
5454,405200,406303,60,49440,6,"""2""",49440,49500
5454,406303,400502,60,49440,6,"""2""",49500,49560
5454,400502,408005,120,49440,6,"""2""",49560,49680
5454,408005,406804,120,49440,6,"""2""",49680,49800
5454,406804,403002,60,49440,6,"""2""",49800,49860
5454,403002,404103,120,49440,6,"""2""",49860,49980
5454,404103,403104,120,49440,6,"""2""",49980,50100
5454,403104,112103,120,49440,6,"""2""",50100,50220
5454,112103,101104,120,49440,6,"""2""",50220,50340
5454,101104,102001,180,49440,6,"""2""",50340,50520
5454,102001,502202,180,49440,6,"""2""",50520,50700
5454,502202,500802,60,49440,6,"""2""",50700,50760
5454,500802,500103,60,49440,6,"""2""",50760,50820
5454,500103,501202,60,49440,6,"""2""",50820,50880
5454,501202,500403,120,49440,6,"""2""",50880,51000
5454,500403,503902,60,49440,6,"""2""",51000,51060
5454,503902,503303,60,49440,6,"""2""",51060,51120
5454,503303,501102,60,49440,6,"""2""",51120,51180
5454,501102,504002,60,49440,6,"""2""",51180,51240
5454,504002,503801,120,49440,6,"""2""",51240,51360
5454,503801,503800,60,49440,6,"""2""",51360,51420
5454,405200,406303,60,50640,6,"""2""",50640,50700
5454,406303,400502,60,50640,6,"""2""",50700,50760
5454,400502,408005,120,50640,6,"""2""",50760,50880
5454,408005,406804,120,50640,6,"""2""",50880,51000
5454,406804,403002,60,50640,6,"""2""",51000,51060
5454,403002,404103,120,50640,6,"""2""",51060,51180
5454,404103,403104,120,50640,6,"""2""",51180,51300
5454,403104,112103,120,50640,6,"""2""",51300,51420
5454,112103,101104,120,50640,6,"""2""",51420,51540
5454,101104,102001,180,50640,6,"""2""",51540,51720
5454,102001,502202,180,50640,6,"""2""",51720,51900
5454,502202,500802,60,50640,6,"""2""",51900,51960
5454,500802,500103,60,50640,6,"""2""",51960,52020
5454,500103,501202,60,50640,6,"""2""",52020,52080
5454,501202,500403,120,50640,6,"""2""",52080,52200
5454,500403,503902,60,50640,6,"""2""",52200,52260
5454,503902,503303,60,50640,6,"""2""",52260,52320
5454,503303,501102,60,50640,6,"""2""",52320,52380
5454,501102,504002,60,50640,6,"""2""",52380,52440
5454,504002,503801,120,50640,6,"""2""",52440,52560
5454,503801,503800,60,50640,6,"""2""",52560,52620
5454,405200,406303,60,51840,6,"""2""",51840,51900
5454,406303,400502,60,51840,6,"""2""",51900,51960
5454,400502,408005,120,51840,6,"""2""",51960,52080
5454,408005,406804,120,51840,6,"""2""",52080,52200
5454,406804,403002,60,51840,6,"""2""",52200,52260
5454,403002,404103,120,51840,6,"""2""",52260,52380
5454,404103,403104,120,51840,6,"""2""",52380,52500
5454,403104,112103,120,51840,6,"""2""",52500,52620
5454,112103,101104,120,51840,6,"""2""",52620,52740
5454,101104,102001,180,51840,6,"""2""",52740,52920
5454,102001,502202,180,51840,6,"""2""",52920,53100
5454,502202,500802,60,51840,6,"""2""",53100,53160
5454,500802,500103,60,51840,6,"""2""",53160,53220
5454,500103,501202,60,51840,6,"""2""",53220,53280
5454,501202,500403,120,51840,6,"""2""",53280,53400
5454,500403,503902,60,51840,6,"""2""",53400,53460
5454,503902,503303,60,51840,6,"""2""",53460,53520
5454,503303,501102,60,51840,6,"""2""",53520,53580
5454,501102,504002,60,51840,6,"""2""",53580,53640
5454,504002,503801,120,51840,6,"""2""",53640,53760
5454,503801,503800,60,51840,6,"""2""",53760,53820
5454,405200,406303,60,53040,6,"""2""",53040,53100
5454,406303,400502,60,53040,6,"""2""",53100,53160
5454,400502,408005,120,53040,6,"""2""",53160,53280
5454,408005,406804,120,53040,6,"""2""",53280,53400
5454,406804,403002,60,53040,6,"""2""",53400,53460
5454,403002,404103,120,53040,6,"""2""",53460,53580
5454,404103,403104,120,53040,6,"""2""",53580,53700
5454,403104,112103,120,53040,6,"""2""",53700,53820
5454,112103,101104,120,53040,6,"""2""",53820,53940
5454,101104,102001,180,53040,6,"""2""",53940,54120
5454,102001,502202,180,53040,6,"""2""",54120,54300
5454,502202,500802,60,53040,6,"""2""",54300,54360
5454,500802,500103,60,53040,6,"""2""",54360,54420
5454,500103,501202,60,53040,6,"""2""",54420,54480
5454,501202,500403,120,53040,6,"""2""",54480,54600
5454,500403,503902,60,53040,6,"""2""",54600,54660
5454,503902,503303,60,53040,6,"""2""",54660,54720
5454,503303,501102,60,53040,6,"""2""",54720,54780
5454,501102,504002,60,53040,6,"""2""",54780,54840
5454,504002,503801,120,53040,6,"""2""",54840,54960
5454,503801,503800,60,53040,6,"""2""",54960,55020
5454,405200,406303,60,53640,6,"""2""",53640,53700
5454,406303,400502,60,53640,6,"""2""",53700,53760
5454,400502,408005,120,53640,6,"""2""",53760,53880
5454,408005,406804,120,53640,6,"""2""",53880,54000
5454,406804,403002,60,53640,6,"""2""",54000,54060
5454,403002,404103,120,53640,6,"""2""",54060,54180
5454,404103,403104,120,53640,6,"""2""",54180,54300
5454,403104,112103,120,53640,6,"""2""",54300,54420
5454,112103,101104,120,53640,6,"""2""",54420,54540
5454,101104,102001,180,53640,6,"""2""",54540,54720
5454,102001,502202,180,53640,6,"""2""",54720,54900
5454,502202,500802,60,53640,6,"""2""",54900,54960
5454,500802,500103,60,53640,6,"""2""",54960,55020
5454,500103,501202,60,53640,6,"""2""",55020,55080
5454,501202,500403,120,53640,6,"""2""",55080,55200
5454,500403,503902,60,53640,6,"""2""",55200,55260
5454,503902,503303,60,53640,6,"""2""",55260,55320
5454,503303,501102,60,53640,6,"""2""",55320,55380
5454,501102,504002,60,53640,6,"""2""",55380,55440
5454,504002,503801,120,53640,6,"""2""",55440,55560
5454,503801,503800,60,53640,6,"""2""",55560,55620
5454,405200,406303,60,54240,6,"""2""",54240,54300
5454,406303,400502,60,54240,6,"""2""",54300,54360
5454,400502,408005,120,54240,6,"""2""",54360,54480
5454,408005,406804,120,54240,6,"""2""",54480,54600
5454,406804,403002,60,54240,6,"""2""",54600,54660
5454,403002,404103,120,54240,6,"""2""",54660,54780
5454,404103,403104,120,54240,6,"""2""",54780,54900
5454,403104,112103,120,54240,6,"""2""",54900,55020
5454,112103,101104,120,54240,6,"""2""",55020,55140
5454,101104,102001,180,54240,6,"""2""",55140,55320
5454,102001,502202,180,54240,6,"""2""",55320,55500
5454,502202,500802,60,54240,6,"""2""",55500,55560
5454,500802,500103,60,54240,6,"""2""",55560,55620
5454,500103,501202,60,54240,6,"""2""",55620,55680
5454,501202,500403,120,54240,6,"""2""",55680,55800
5454,500403,503902,60,54240,6,"""2""",55800,55860
5454,503902,503303,60,54240,6,"""2""",55860,55920
5454,503303,501102,60,54240,6,"""2""",55920,55980
5454,501102,504002,60,54240,6,"""2""",55980,56040
5454,504002,503801,120,54240,6,"""2""",56040,56160
5454,503801,503800,60,54240,6,"""2""",56160,56220
5454,405200,406303,60,54840,6,"""2""",54840,54900
5454,406303,400502,60,54840,6,"""2""",54900,54960
5454,400502,408005,120,54840,6,"""2""",54960,55080
5454,408005,406804,120,54840,6,"""2""",55080,55200
5454,406804,403002,60,54840,6,"""2""",55200,55260
5454,403002,404103,120,54840,6,"""2""",55260,55380
5454,404103,403104,120,54840,6,"""2""",55380,55500
5454,403104,112103,120,54840,6,"""2""",55500,55620
5454,112103,101104,120,54840,6,"""2""",55620,55740
5454,101104,102001,180,54840,6,"""2""",55740,55920
5454,102001,502202,180,54840,6,"""2""",55920,56100
5454,502202,500802,60,54840,6,"""2""",56100,56160
5454,500802,500103,60,54840,6,"""2""",56160,56220
5454,500103,501202,60,54840,6,"""2""",56220,56280
5454,501202,500403,120,54840,6,"""2""",56280,56400
5454,500403,503902,60,54840,6,"""2""",56400,56460
5454,503902,503303,60,54840,6,"""2""",56460,56520
5454,503303,501102,60,54840,6,"""2""",56520,56580
5454,501102,504002,60,54840,6,"""2""",56580,56640
5454,504002,503801,120,54840,6,"""2""",56640,56760
5454,503801,503800,60,54840,6,"""2""",56760,56820
5454,405200,406303,60,55440,6,"""2""",55440,55500
5454,406303,400502,60,55440,6,"""2""",55500,55560
5454,400502,408005,120,55440,6,"""2""",55560,55680
5454,408005,406804,120,55440,6,"""2""",55680,55800
5454,406804,403002,60,55440,6,"""2""",55800,55860
5454,403002,404103,120,55440,6,"""2""",55860,55980
5454,404103,403104,120,55440,6,"""2""",55980,56100
5454,403104,112103,120,55440,6,"""2""",56100,56220
5454,112103,101104,120,55440,6,"""2""",56220,56340
5454,101104,102001,180,55440,6,"""2""",56340,56520
5454,102001,502202,180,55440,6,"""2""",56520,56700
5454,502202,500802,60,55440,6,"""2""",56700,56760
5454,500802,500103,60,55440,6,"""2""",56760,56820
5454,500103,501202,60,55440,6,"""2""",56820,56880
5454,501202,500403,120,55440,6,"""2""",56880,57000
5454,500403,503902,60,55440,6,"""2""",57000,57060
5454,503902,503303,60,55440,6,"""2""",57060,57120
5454,503303,501102,60,55440,6,"""2""",57120,57180
5454,501102,504002,60,55440,6,"""2""",57180,57240
5454,504002,503801,120,55440,6,"""2""",57240,57360
5454,503801,503800,60,55440,6,"""2""",57360,57420
5454,405200,406303,60,56040,6,"""2""",56040,56100
5454,406303,400502,60,56040,6,"""2""",56100,56160
5454,400502,408005,120,56040,6,"""2""",56160,56280
5454,408005,406804,120,56040,6,"""2""",56280,56400
5454,406804,403002,60,56040,6,"""2""",56400,56460
5454,403002,404103,120,56040,6,"""2""",56460,56580
5454,404103,403104,120,56040,6,"""2""",56580,56700
5454,403104,112103,120,56040,6,"""2""",56700,56820
5454,112103,101104,120,56040,6,"""2""",56820,56940
5454,101104,102001,180,56040,6,"""2""",56940,57120
5454,102001,502202,180,56040,6,"""2""",57120,57300
5454,502202,500802,60,56040,6,"""2""",57300,57360
5454,500802,500103,60,56040,6,"""2""",57360,57420
5454,500103,501202,60,56040,6,"""2""",57420,57480
5454,501202,500403,120,56040,6,"""2""",57480,57600
5454,500403,503902,60,56040,6,"""2""",57600,57660
5454,503902,503303,60,56040,6,"""2""",57660,57720
5454,503303,501102,60,56040,6,"""2""",57720,57780
5454,501102,504002,60,56040,6,"""2""",57780,57840
5454,504002,503801,120,56040,6,"""2""",57840,57960
5454,503801,503800,60,56040,6,"""2""",57960,58020
5454,405200,406303,60,56640,6,"""2""",56640,56700
5454,406303,400502,60,56640,6,"""2""",56700,56760
5454,400502,408005,120,56640,6,"""2""",56760,56880
5454,408005,406804,120,56640,6,"""2""",56880,57000
5454,406804,403002,60,56640,6,"""2""",57000,57060
5454,403002,404103,120,56640,6,"""2""",57060,57180
5454,404103,403104,120,56640,6,"""2""",57180,57300
5454,403104,112103,120,56640,6,"""2""",57300,57420
5454,112103,101104,120,56640,6,"""2""",57420,57540
5454,101104,102001,180,56640,6,"""2""",57540,57720
5454,102001,502202,180,56640,6,"""2""",57720,57900
5454,502202,500802,60,56640,6,"""2""",57900,57960
5454,500802,500103,60,56640,6,"""2""",57960,58020
5454,500103,501202,60,56640,6,"""2""",58020,58080
5454,501202,500403,120,56640,6,"""2""",58080,58200
5454,500403,503902,60,56640,6,"""2""",58200,58260
5454,503902,503303,60,56640,6,"""2""",58260,58320
5454,503303,501102,60,56640,6,"""2""",58320,58380
5454,501102,504002,60,56640,6,"""2""",58380,58440
5454,504002,503801,120,56640,6,"""2""",58440,58560
5454,503801,503800,60,56640,6,"""2""",58560,58620
5454,405200,406303,60,57240,6,"""2""",57240,57300
5454,406303,400502,60,57240,6,"""2""",57300,57360
5454,400502,408005,120,57240,6,"""2""",57360,57480
5454,408005,406804,120,57240,6,"""2""",57480,57600
5454,406804,403002,60,57240,6,"""2""",57600,57660
5454,403002,404103,120,57240,6,"""2""",57660,57780
5454,404103,403104,120,57240,6,"""2""",57780,57900
5454,403104,112103,120,57240,6,"""2""",57900,58020
5454,112103,101104,120,57240,6,"""2""",58020,58140
5454,101104,102001,180,57240,6,"""2""",58140,58320
5454,102001,502202,180,57240,6,"""2""",58320,58500
5454,502202,500802,60,57240,6,"""2""",58500,58560
5454,500802,500103,60,57240,6,"""2""",58560,58620
5454,500103,501202,60,57240,6,"""2""",58620,58680
5454,501202,500403,120,57240,6,"""2""",58680,58800
5454,500403,503902,60,57240,6,"""2""",58800,58860
5454,503902,503303,60,57240,6,"""2""",58860,58920
5454,503303,501102,60,57240,6,"""2""",58920,58980
5454,501102,504002,60,57240,6,"""2""",58980,59040
5454,504002,503801,120,57240,6,"""2""",59040,59160
5454,503801,503800,60,57240,6,"""2""",59160,59220
5454,405200,406303,60,57840,6,"""2""",57840,57900
5454,406303,400502,60,57840,6,"""2""",57900,57960
5454,400502,408005,120,57840,6,"""2""",57960,58080
5454,408005,406804,120,57840,6,"""2""",58080,58200
5454,406804,403002,60,57840,6,"""2""",58200,58260
5454,403002,404103,120,57840,6,"""2""",58260,58380
5454,404103,403104,120,57840,6,"""2""",58380,58500
5454,403104,112103,120,57840,6,"""2""",58500,58620
5454,112103,101104,120,57840,6,"""2""",58620,58740
5454,101104,102001,180,57840,6,"""2""",58740,58920
5454,102001,502202,180,57840,6,"""2""",58920,59100
5454,502202,500802,60,57840,6,"""2""",59100,59160
5454,500802,500103,60,57840,6,"""2""",59160,59220
5454,500103,501202,60,57840,6,"""2""",59220,59280
5454,501202,500403,120,57840,6,"""2""",59280,59400
5454,500403,503902,60,57840,6,"""2""",59400,59460
5454,503902,503303,60,57840,6,"""2""",59460,59520
5454,503303,501102,60,57840,6,"""2""",59520,59580
5454,501102,504002,60,57840,6,"""2""",59580,59640
5454,504002,503801,120,57840,6,"""2""",59640,59760
5454,503801,503800,60,57840,6,"""2""",59760,59820
5454,405200,406303,60,58440,6,"""2""",58440,58500
5454,406303,400502,60,58440,6,"""2""",58500,58560
5454,400502,408005,120,58440,6,"""2""",58560,58680
5454,408005,406804,120,58440,6,"""2""",58680,58800
5454,406804,403002,60,58440,6,"""2""",58800,58860
5454,403002,404103,120,58440,6,"""2""",58860,58980
5454,404103,403104,120,58440,6,"""2""",58980,59100
5454,403104,112103,120,58440,6,"""2""",59100,59220
5454,112103,101104,120,58440,6,"""2""",59220,59340
5454,101104,102001,180,58440,6,"""2""",59340,59520
5454,102001,502202,180,58440,6,"""2""",59520,59700
5454,502202,500802,60,58440,6,"""2""",59700,59760
5454,500802,500103,60,58440,6,"""2""",59760,59820
5454,500103,501202,60,58440,6,"""2""",59820,59880
5454,501202,500403,120,58440,6,"""2""",59880,60000
5454,500403,503902,60,58440,6,"""2""",60000,60060
5454,503902,503303,60,58440,6,"""2""",60060,60120
5454,503303,501102,60,58440,6,"""2""",60120,60180
5454,501102,504002,60,58440,6,"""2""",60180,60240
5454,504002,503801,120,58440,6,"""2""",60240,60360
5454,503801,503800,60,58440,6,"""2""",60360,60420
5454,405200,406303,60,59040,6,"""2""",59040,59100
5454,406303,400502,60,59040,6,"""2""",59100,59160
5454,400502,408005,120,59040,6,"""2""",59160,59280
5454,408005,406804,120,59040,6,"""2""",59280,59400
5454,406804,403002,60,59040,6,"""2""",59400,59460
5454,403002,404103,120,59040,6,"""2""",59460,59580
5454,404103,403104,120,59040,6,"""2""",59580,59700
5454,403104,112103,120,59040,6,"""2""",59700,59820
5454,112103,101104,120,59040,6,"""2""",59820,59940
5454,101104,102001,180,59040,6,"""2""",59940,60120
5454,102001,502202,180,59040,6,"""2""",60120,60300
5454,502202,500802,60,59040,6,"""2""",60300,60360
5454,500802,500103,60,59040,6,"""2""",60360,60420
5454,500103,501202,60,59040,6,"""2""",60420,60480
5454,501202,500403,120,59040,6,"""2""",60480,60600
5454,500403,503902,60,59040,6,"""2""",60600,60660
5454,503902,503303,60,59040,6,"""2""",60660,60720
5454,503303,501102,60,59040,6,"""2""",60720,60780
5454,501102,504002,60,59040,6,"""2""",60780,60840
5454,504002,503801,120,59040,6,"""2""",60840,60960
5454,503801,503800,60,59040,6,"""2""",60960,61020
5454,405200,406303,60,59640,6,"""2""",59640,59700
5454,406303,400502,60,59640,6,"""2""",59700,59760
5454,400502,408005,120,59640,6,"""2""",59760,59880
5454,408005,406804,120,59640,6,"""2""",59880,60000
5454,406804,403002,60,59640,6,"""2""",60000,60060
5454,403002,404103,120,59640,6,"""2""",60060,60180
5454,404103,403104,120,59640,6,"""2""",60180,60300
5454,403104,112103,120,59640,6,"""2""",60300,60420
5454,112103,101104,120,59640,6,"""2""",60420,60540
5454,101104,102001,180,59640,6,"""2""",60540,60720
5454,102001,502202,180,59640,6,"""2""",60720,60900
5454,502202,500802,60,59640,6,"""2""",60900,60960
5454,500802,500103,60,59640,6,"""2""",60960,61020
5454,500103,501202,60,59640,6,"""2""",61020,61080
5454,501202,500403,120,59640,6,"""2""",61080,61200
5454,500403,503902,60,59640,6,"""2""",61200,61260
5454,503902,503303,60,59640,6,"""2""",61260,61320
5454,503303,501102,60,59640,6,"""2""",61320,61380
5454,501102,504002,60,59640,6,"""2""",61380,61440
5454,504002,503801,120,59640,6,"""2""",61440,61560
5454,503801,503800,60,59640,6,"""2""",61560,61620
5454,405200,406303,60,60240,6,"""2""",60240,60300
5454,406303,400502,60,60240,6,"""2""",60300,60360
5454,400502,408005,120,60240,6,"""2""",60360,60480
5454,408005,406804,120,60240,6,"""2""",60480,60600
5454,406804,403002,60,60240,6,"""2""",60600,60660
5454,403002,404103,120,60240,6,"""2""",60660,60780
5454,404103,403104,120,60240,6,"""2""",60780,60900
5454,403104,112103,120,60240,6,"""2""",60900,61020
5454,112103,101104,120,60240,6,"""2""",61020,61140
5454,101104,102001,180,60240,6,"""2""",61140,61320
5454,102001,502202,180,60240,6,"""2""",61320,61500
5454,502202,500802,60,60240,6,"""2""",61500,61560
5454,500802,500103,60,60240,6,"""2""",61560,61620
5454,500103,501202,60,60240,6,"""2""",61620,61680
5454,501202,500403,120,60240,6,"""2""",61680,61800
5454,500403,503902,60,60240,6,"""2""",61800,61860
5454,503902,503303,60,60240,6,"""2""",61860,61920
5454,503303,501102,60,60240,6,"""2""",61920,61980
5454,501102,504002,60,60240,6,"""2""",61980,62040
5454,504002,503801,120,60240,6,"""2""",62040,62160
5454,503801,503800,60,60240,6,"""2""",62160,62220
5454,405200,406303,60,60840,6,"""2""",60840,60900
5454,406303,400502,60,60840,6,"""2""",60900,60960
5454,400502,408005,120,60840,6,"""2""",60960,61080
5454,408005,406804,120,60840,6,"""2""",61080,61200
5454,406804,403002,60,60840,6,"""2""",61200,61260
5454,403002,404103,120,60840,6,"""2""",61260,61380
5454,404103,403104,120,60840,6,"""2""",61380,61500
5454,403104,112103,120,60840,6,"""2""",61500,61620
5454,112103,101104,120,60840,6,"""2""",61620,61740
5454,101104,102001,180,60840,6,"""2""",61740,61920
5454,102001,502202,180,60840,6,"""2""",61920,62100
5454,502202,500802,60,60840,6,"""2""",62100,62160
5454,500802,500103,60,60840,6,"""2""",62160,62220
5454,500103,501202,60,60840,6,"""2""",62220,62280
5454,501202,500403,120,60840,6,"""2""",62280,62400
5454,500403,503902,60,60840,6,"""2""",62400,62460
5454,503902,503303,60,60840,6,"""2""",62460,62520
5454,503303,501102,60,60840,6,"""2""",62520,62580
5454,501102,504002,60,60840,6,"""2""",62580,62640
5454,504002,503801,120,60840,6,"""2""",62640,62760
5454,503801,503800,60,60840,6,"""2""",62760,62820
5454,405200,406303,60,61440,6,"""2""",61440,61500
5454,406303,400502,60,61440,6,"""2""",61500,61560
5454,400502,408005,120,61440,6,"""2""",61560,61680
5454,408005,406804,120,61440,6,"""2""",61680,61800
5454,406804,403002,60,61440,6,"""2""",61800,61860
5454,403002,404103,120,61440,6,"""2""",61860,61980
5454,404103,403104,120,61440,6,"""2""",61980,62100
5454,403104,112103,120,61440,6,"""2""",62100,62220
5454,112103,101104,120,61440,6,"""2""",62220,62340
5454,101104,102001,180,61440,6,"""2""",62340,62520
5454,102001,502202,180,61440,6,"""2""",62520,62700
5454,502202,500802,60,61440,6,"""2""",62700,62760
5454,500802,500103,60,61440,6,"""2""",62760,62820
5454,500103,501202,60,61440,6,"""2""",62820,62880
5454,501202,500403,120,61440,6,"""2""",62880,63000
5454,500403,503902,60,61440,6,"""2""",63000,63060
5454,503902,503303,60,61440,6,"""2""",63060,63120
5454,503303,501102,60,61440,6,"""2""",63120,63180
5454,501102,504002,60,61440,6,"""2""",63180,63240
5454,504002,503801,120,61440,6,"""2""",63240,63360
5454,503801,503800,60,61440,6,"""2""",63360,63420
5454,405200,406303,60,62040,6,"""2""",62040,62100
5454,406303,400502,60,62040,6,"""2""",62100,62160
5454,400502,408005,120,62040,6,"""2""",62160,62280
5454,408005,406804,120,62040,6,"""2""",62280,62400
5454,406804,403002,60,62040,6,"""2""",62400,62460
5454,403002,404103,120,62040,6,"""2""",62460,62580
5454,404103,403104,120,62040,6,"""2""",62580,62700
5454,403104,112103,120,62040,6,"""2""",62700,62820
5454,112103,101104,120,62040,6,"""2""",62820,62940
5454,101104,102001,180,62040,6,"""2""",62940,63120
5454,102001,502202,180,62040,6,"""2""",63120,63300
5454,502202,500802,60,62040,6,"""2""",63300,63360
5454,500802,500103,60,62040,6,"""2""",63360,63420
5454,500103,501202,60,62040,6,"""2""",63420,63480
5454,501202,500403,120,62040,6,"""2""",63480,63600
5454,500403,503902,60,62040,6,"""2""",63600,63660
5454,503902,503303,60,62040,6,"""2""",63660,63720
5454,503303,501102,60,62040,6,"""2""",63720,63780
5454,501102,504002,60,62040,6,"""2""",63780,63840
5454,504002,503801,120,62040,6,"""2""",63840,63960
5454,503801,503800,60,62040,6,"""2""",63960,64020
5454,405200,406303,60,62640,6,"""2""",62640,62700
5454,406303,400502,60,62640,6,"""2""",62700,62760
5454,400502,408005,120,62640,6,"""2""",62760,62880
5454,408005,406804,120,62640,6,"""2""",62880,63000
5454,406804,403002,60,62640,6,"""2""",63000,63060
5454,403002,404103,120,62640,6,"""2""",63060,63180
5454,404103,403104,120,62640,6,"""2""",63180,63300
5454,403104,112103,120,62640,6,"""2""",63300,63420
5454,112103,101104,120,62640,6,"""2""",63420,63540
5454,101104,102001,180,62640,6,"""2""",63540,63720
5454,102001,502202,180,62640,6,"""2""",63720,63900
5454,502202,500802,60,62640,6,"""2""",63900,63960
5454,500802,500103,60,62640,6,"""2""",63960,64020
5454,500103,501202,60,62640,6,"""2""",64020,64080
5454,501202,500403,120,62640,6,"""2""",64080,64200
5454,500403,503902,60,62640,6,"""2""",64200,64260
5454,503902,503303,60,62640,6,"""2""",64260,64320
5454,503303,501102,60,62640,6,"""2""",64320,64380
5454,501102,504002,60,62640,6,"""2""",64380,64440
5454,504002,503801,120,62640,6,"""2""",64440,64560
5454,503801,503800,60,62640,6,"""2""",64560,64620
5454,405200,406303,60,63240,6,"""2""",63240,63300
5454,406303,400502,60,63240,6,"""2""",63300,63360
5454,400502,408005,120,63240,6,"""2""",63360,63480
5454,408005,406804,120,63240,6,"""2""",63480,63600
5454,406804,403002,60,63240,6,"""2""",63600,63660
5454,403002,404103,120,63240,6,"""2""",63660,63780
5454,404103,403104,120,63240,6,"""2""",63780,63900
5454,403104,112103,120,63240,6,"""2""",63900,64020
5454,112103,101104,120,63240,6,"""2""",64020,64140
5454,101104,102001,180,63240,6,"""2""",64140,64320
5454,102001,502202,180,63240,6,"""2""",64320,64500
5454,502202,500802,60,63240,6,"""2""",64500,64560
5454,500802,500103,60,63240,6,"""2""",64560,64620
5454,500103,501202,60,63240,6,"""2""",64620,64680
5454,501202,500403,120,63240,6,"""2""",64680,64800
5454,500403,503902,60,63240,6,"""2""",64800,64860
5454,503902,503303,60,63240,6,"""2""",64860,64920
5454,503303,501102,60,63240,6,"""2""",64920,64980
5454,501102,504002,60,63240,6,"""2""",64980,65040
5454,504002,503801,120,63240,6,"""2""",65040,65160
5454,503801,503800,60,63240,6,"""2""",65160,65220
5454,405200,406303,60,63840,6,"""2""",63840,63900
5454,406303,400502,60,63840,6,"""2""",63900,63960
5454,400502,408005,120,63840,6,"""2""",63960,64080
5454,408005,406804,120,63840,6,"""2""",64080,64200
5454,406804,403002,60,63840,6,"""2""",64200,64260
5454,403002,404103,120,63840,6,"""2""",64260,64380
5454,404103,403104,120,63840,6,"""2""",64380,64500
5454,403104,112103,120,63840,6,"""2""",64500,64620
5454,112103,101104,120,63840,6,"""2""",64620,64740
5454,101104,102001,180,63840,6,"""2""",64740,64920
5454,102001,502202,180,63840,6,"""2""",64920,65100
5454,502202,500802,60,63840,6,"""2""",65100,65160
5454,500802,500103,60,63840,6,"""2""",65160,65220
5454,500103,501202,60,63840,6,"""2""",65220,65280
5454,501202,500403,120,63840,6,"""2""",65280,65400
5454,500403,503902,60,63840,6,"""2""",65400,65460
5454,503902,503303,60,63840,6,"""2""",65460,65520
5454,503303,501102,60,63840,6,"""2""",65520,65580
5454,501102,504002,60,63840,6,"""2""",65580,65640
5454,504002,503801,120,63840,6,"""2""",65640,65760
5454,503801,503800,60,63840,6,"""2""",65760,65820
5454,405200,406303,60,64440,6,"""2""",64440,64500
5454,406303,400502,60,64440,6,"""2""",64500,64560
5454,400502,408005,120,64440,6,"""2""",64560,64680
5454,408005,406804,120,64440,6,"""2""",64680,64800
5454,406804,403002,60,64440,6,"""2""",64800,64860
5454,403002,404103,120,64440,6,"""2""",64860,64980
5454,404103,403104,120,64440,6,"""2""",64980,65100
5454,403104,112103,120,64440,6,"""2""",65100,65220
5454,112103,101104,120,64440,6,"""2""",65220,65340
5454,101104,102001,180,64440,6,"""2""",65340,65520
5454,102001,502202,180,64440,6,"""2""",65520,65700
5454,502202,500802,60,64440,6,"""2""",65700,65760
5454,500802,500103,60,64440,6,"""2""",65760,65820
5454,500103,501202,60,64440,6,"""2""",65820,65880
5454,501202,500403,120,64440,6,"""2""",65880,66000
5454,500403,503902,60,64440,6,"""2""",66000,66060
5454,503902,503303,60,64440,6,"""2""",66060,66120
5454,503303,501102,60,64440,6,"""2""",66120,66180
5454,501102,504002,60,64440,6,"""2""",66180,66240
5454,504002,503801,120,64440,6,"""2""",66240,66360
5454,503801,503800,60,64440,6,"""2""",66360,66420
5454,405200,406303,60,65040,6,"""2""",65040,65100
5454,406303,400502,60,65040,6,"""2""",65100,65160
5454,400502,408005,120,65040,6,"""2""",65160,65280
5454,408005,406804,120,65040,6,"""2""",65280,65400
5454,406804,403002,60,65040,6,"""2""",65400,65460
5454,403002,404103,120,65040,6,"""2""",65460,65580
5454,404103,403104,120,65040,6,"""2""",65580,65700
5454,403104,112103,120,65040,6,"""2""",65700,65820
5454,112103,101104,120,65040,6,"""2""",65820,65940
5454,101104,102001,180,65040,6,"""2""",65940,66120
5454,102001,502202,180,65040,6,"""2""",66120,66300
5454,502202,500802,60,65040,6,"""2""",66300,66360
5454,500802,500103,60,65040,6,"""2""",66360,66420
5454,500103,501202,60,65040,6,"""2""",66420,66480
5454,501202,500403,120,65040,6,"""2""",66480,66600
5454,500403,503902,60,65040,6,"""2""",66600,66660
5454,503902,503303,60,65040,6,"""2""",66660,66720
5454,503303,501102,60,65040,6,"""2""",66720,66780
5454,501102,504002,60,65040,6,"""2""",66780,66840
5454,504002,503801,120,65040,6,"""2""",66840,66960
5454,503801,503800,60,65040,6,"""2""",66960,67020
5454,405200,406303,60,65640,6,"""2""",65640,65700
5454,406303,400502,60,65640,6,"""2""",65700,65760
5454,400502,408005,120,65640,6,"""2""",65760,65880
5454,408005,406804,120,65640,6,"""2""",65880,66000
5454,406804,403002,60,65640,6,"""2""",66000,66060
5454,403002,404103,120,65640,6,"""2""",66060,66180
5454,404103,403104,120,65640,6,"""2""",66180,66300
5454,403104,112103,120,65640,6,"""2""",66300,66420
5454,112103,101104,120,65640,6,"""2""",66420,66540
5454,101104,102001,180,65640,6,"""2""",66540,66720
5454,102001,502202,180,65640,6,"""2""",66720,66900
5454,502202,500802,60,65640,6,"""2""",66900,66960
5454,500802,500103,60,65640,6,"""2""",66960,67020
5454,500103,501202,60,65640,6,"""2""",67020,67080
5454,501202,500403,120,65640,6,"""2""",67080,67200
5454,500403,503902,60,65640,6,"""2""",67200,67260
5454,503902,503303,60,65640,6,"""2""",67260,67320
5454,503303,501102,60,65640,6,"""2""",67320,67380
5454,501102,504002,60,65640,6,"""2""",67380,67440
5454,504002,503801,120,65640,6,"""2""",67440,67560
5454,503801,503800,60,65640,6,"""2""",67560,67620
5454,405200,406303,60,66840,6,"""2""",66840,66900
5454,406303,400502,60,66840,6,"""2""",66900,66960
5454,400502,408005,120,66840,6,"""2""",66960,67080
5454,408005,406804,120,66840,6,"""2""",67080,67200
5454,406804,403002,60,66840,6,"""2""",67200,67260
5454,403002,404103,120,66840,6,"""2""",67260,67380
5454,404103,403104,120,66840,6,"""2""",67380,67500
5454,403104,112103,120,66840,6,"""2""",67500,67620
5454,112103,101104,120,66840,6,"""2""",67620,67740
5454,101104,102001,180,66840,6,"""2""",67740,67920
5454,102001,502202,180,66840,6,"""2""",67920,68100
5454,502202,500802,60,66840,6,"""2""",68100,68160
5454,500802,500103,60,66840,6,"""2""",68160,68220
5454,500103,501202,60,66840,6,"""2""",68220,68280
5454,501202,500403,120,66840,6,"""2""",68280,68400
5454,500403,503902,60,66840,6,"""2""",68400,68460
5454,503902,503303,60,66840,6,"""2""",68460,68520
5454,503303,501102,60,66840,6,"""2""",68520,68580
5454,501102,504002,60,66840,6,"""2""",68580,68640
5454,504002,503801,120,66840,6,"""2""",68640,68760
5454,503801,503800,60,66840,6,"""2""",68760,68820
5454,405200,406303,60,68040,6,"""2""",68040,68100
5454,406303,400502,60,68040,6,"""2""",68100,68160
5454,400502,408005,120,68040,6,"""2""",68160,68280
5454,408005,406804,120,68040,6,"""2""",68280,68400
5454,406804,403002,60,68040,6,"""2""",68400,68460
5454,403002,404103,120,68040,6,"""2""",68460,68580
5454,404103,403104,120,68040,6,"""2""",68580,68700
5454,403104,112103,120,68040,6,"""2""",68700,68820
5454,112103,101104,120,68040,6,"""2""",68820,68940
5454,101104,102001,180,68040,6,"""2""",68940,69120
5454,102001,502202,180,68040,6,"""2""",69120,69300
5454,502202,500802,60,68040,6,"""2""",69300,69360
5454,500802,500103,60,68040,6,"""2""",69360,69420
5454,500103,501202,60,68040,6,"""2""",69420,69480
5454,501202,500403,120,68040,6,"""2""",69480,69600
5454,500403,503902,60,68040,6,"""2""",69600,69660
5454,503902,503303,60,68040,6,"""2""",69660,69720
5454,503303,501102,60,68040,6,"""2""",69720,69780
5454,501102,504002,60,68040,6,"""2""",69780,69840
5454,504002,503801,120,68040,6,"""2""",69840,69960
5454,503801,503800,60,68040,6,"""2""",69960,70020
5454,405200,406303,60,69360,6,"""2""",69360,69420
5454,406303,400502,60,69360,6,"""2""",69420,69480
5454,400502,408005,120,69360,6,"""2""",69480,69600
5454,408005,406804,120,69360,6,"""2""",69600,69720
5454,406804,403002,60,69360,6,"""2""",69720,69780
5454,403002,404103,120,69360,6,"""2""",69780,69900
5454,404103,403104,120,69360,6,"""2""",69900,70020
5454,403104,112103,120,69360,6,"""2""",70020,70140
5454,112103,101104,120,69360,6,"""2""",70140,70260
5454,101104,102001,180,69360,6,"""2""",70260,70440
5454,102001,502202,180,69360,6,"""2""",70440,70620
5454,502202,500802,60,69360,6,"""2""",70620,70680
5454,500802,500103,60,69360,6,"""2""",70680,70740
5454,500103,501202,60,69360,6,"""2""",70740,70800
5454,501202,500403,120,69360,6,"""2""",70800,70920
5454,500403,503902,60,69360,6,"""2""",70920,70980
5454,503902,503303,60,69360,6,"""2""",70980,71040
5454,503303,501102,60,69360,6,"""2""",71040,71100
5454,501102,504002,60,69360,6,"""2""",71100,71160
5454,504002,503801,120,69360,6,"""2""",71160,71280
5454,503801,503800,60,69360,6,"""2""",71280,71340
5454,405200,406303,60,70260,6,"""2""",70260,70320
5454,406303,400502,60,70260,6,"""2""",70320,70380
5454,400502,408005,120,70260,6,"""2""",70380,70500
5454,408005,406804,120,70260,6,"""2""",70500,70620
5454,406804,403002,60,70260,6,"""2""",70620,70680
5454,403002,404103,120,70260,6,"""2""",70680,70800
5454,404103,403104,120,70260,6,"""2""",70800,70920
5454,403104,112103,120,70260,6,"""2""",70920,71040
5454,112103,101104,120,70260,6,"""2""",71040,71160
5454,101104,102001,180,70260,6,"""2""",71160,71340
5454,102001,502202,180,70260,6,"""2""",71340,71520
5454,502202,500802,60,70260,6,"""2""",71520,71580
5454,500802,500103,60,70260,6,"""2""",71580,71640
5454,500103,501202,60,70260,6,"""2""",71640,71700
5454,501202,500403,120,70260,6,"""2""",71700,71820
5454,500403,503902,60,70260,6,"""2""",71820,71880
5454,503902,503303,60,70260,6,"""2""",71880,71940
5454,503303,501102,60,70260,6,"""2""",71940,72000
5454,501102,504002,60,70260,6,"""2""",72000,72060
5454,504002,503801,120,70260,6,"""2""",72060,72180
5454,503801,503800,60,70260,6,"""2""",72180,72240
5455,405200,406303,60,20160,6,"""2""",20160,20220
5455,406303,400502,60,20160,6,"""2""",20220,20280
5455,400502,408005,120,20160,6,"""2""",20280,20400
5455,408005,406804,120,20160,6,"""2""",20400,20520
5455,406804,403002,60,20160,6,"""2""",20520,20580
5455,403002,404103,60,20160,6,"""2""",20580,20640
5455,404103,403104,60,20160,6,"""2""",20640,20700
5455,403104,112103,120,20160,6,"""2""",20700,20820
5455,112103,101104,120,20160,6,"""2""",20820,20940
5455,101104,102001,180,20160,6,"""2""",20940,21120
5455,102001,502202,180,20160,6,"""2""",21120,21300
5455,502202,500802,60,20160,6,"""2""",21300,21360
5455,500802,500103,60,20160,6,"""2""",21360,21420
5455,500103,501202,60,20160,6,"""2""",21420,21480
5455,501202,500403,120,20160,6,"""2""",21480,21600
5455,500403,503902,60,20160,6,"""2""",21600,21660
5455,503902,503303,60,20160,6,"""2""",21660,21720
5455,503303,501102,60,20160,6,"""2""",21720,21780
5455,501102,504002,60,20160,6,"""2""",21780,21840
5455,504002,503801,120,20160,6,"""2""",21840,21960
5455,503801,503800,60,20160,6,"""2""",21960,22020
5455,405200,406303,60,21360,6,"""2""",21360,21420
5455,406303,400502,60,21360,6,"""2""",21420,21480
5455,400502,408005,120,21360,6,"""2""",21480,21600
5455,408005,406804,120,21360,6,"""2""",21600,21720
5455,406804,403002,60,21360,6,"""2""",21720,21780
5455,403002,404103,60,21360,6,"""2""",21780,21840
5455,404103,403104,60,21360,6,"""2""",21840,21900
5455,403104,112103,120,21360,6,"""2""",21900,22020
5455,112103,101104,120,21360,6,"""2""",22020,22140
5455,101104,102001,180,21360,6,"""2""",22140,22320
5455,102001,502202,180,21360,6,"""2""",22320,22500
5455,502202,500802,60,21360,6,"""2""",22500,22560
5455,500802,500103,60,21360,6,"""2""",22560,22620
5455,500103,501202,60,21360,6,"""2""",22620,22680
5455,501202,500403,120,21360,6,"""2""",22680,22800
5455,500403,503902,60,21360,6,"""2""",22800,22860
5455,503902,503303,60,21360,6,"""2""",22860,22920
5455,503303,501102,60,21360,6,"""2""",22920,22980
5455,501102,504002,60,21360,6,"""2""",22980,23040
5455,504002,503801,120,21360,6,"""2""",23040,23160
5455,503801,503800,60,21360,6,"""2""",23160,23220
5455,405200,406303,60,22560,6,"""2""",22560,22620
5455,406303,400502,60,22560,6,"""2""",22620,22680
5455,400502,408005,120,22560,6,"""2""",22680,22800
5455,408005,406804,120,22560,6,"""2""",22800,22920
5455,406804,403002,60,22560,6,"""2""",22920,22980
5455,403002,404103,60,22560,6,"""2""",22980,23040
5455,404103,403104,60,22560,6,"""2""",23040,23100
5455,403104,112103,120,22560,6,"""2""",23100,23220
5455,112103,101104,120,22560,6,"""2""",23220,23340
5455,101104,102001,180,22560,6,"""2""",23340,23520
5455,102001,502202,180,22560,6,"""2""",23520,23700
5455,502202,500802,60,22560,6,"""2""",23700,23760
5455,500802,500103,60,22560,6,"""2""",23760,23820
5455,500103,501202,60,22560,6,"""2""",23820,23880
5455,501202,500403,120,22560,6,"""2""",23880,24000
5455,500403,503902,60,22560,6,"""2""",24000,24060
5455,503902,503303,60,22560,6,"""2""",24060,24120
5455,503303,501102,60,22560,6,"""2""",24120,24180
5455,501102,504002,60,22560,6,"""2""",24180,24240
5455,504002,503801,120,22560,6,"""2""",24240,24360
5455,503801,503800,60,22560,6,"""2""",24360,24420
5455,405200,406303,60,23760,6,"""2""",23760,23820
5455,406303,400502,60,23760,6,"""2""",23820,23880
5455,400502,408005,120,23760,6,"""2""",23880,24000
5455,408005,406804,120,23760,6,"""2""",24000,24120
5455,406804,403002,60,23760,6,"""2""",24120,24180
5455,403002,404103,60,23760,6,"""2""",24180,24240
5455,404103,403104,60,23760,6,"""2""",24240,24300
5455,403104,112103,120,23760,6,"""2""",24300,24420
5455,112103,101104,120,23760,6,"""2""",24420,24540
5455,101104,102001,180,23760,6,"""2""",24540,24720
5455,102001,502202,180,23760,6,"""2""",24720,24900
5455,502202,500802,60,23760,6,"""2""",24900,24960
5455,500802,500103,60,23760,6,"""2""",24960,25020
5455,500103,501202,60,23760,6,"""2""",25020,25080
5455,501202,500403,120,23760,6,"""2""",25080,25200
5455,500403,503902,60,23760,6,"""2""",25200,25260
5455,503902,503303,60,23760,6,"""2""",25260,25320
5455,503303,501102,60,23760,6,"""2""",25320,25380
5455,501102,504002,60,23760,6,"""2""",25380,25440
5455,504002,503801,120,23760,6,"""2""",25440,25560
5455,503801,503800,60,23760,6,"""2""",25560,25620
5455,405200,406303,60,24360,6,"""2""",24360,24420
5455,406303,400502,60,24360,6,"""2""",24420,24480
5455,400502,408005,120,24360,6,"""2""",24480,24600
5455,408005,406804,120,24360,6,"""2""",24600,24720
5455,406804,403002,60,24360,6,"""2""",24720,24780
5455,403002,404103,60,24360,6,"""2""",24780,24840
5455,404103,403104,60,24360,6,"""2""",24840,24900
5455,403104,112103,120,24360,6,"""2""",24900,25020
5455,112103,101104,120,24360,6,"""2""",25020,25140
5455,101104,102001,180,24360,6,"""2""",25140,25320
5455,102001,502202,180,24360,6,"""2""",25320,25500
5455,502202,500802,60,24360,6,"""2""",25500,25560
5455,500802,500103,60,24360,6,"""2""",25560,25620
5455,500103,501202,60,24360,6,"""2""",25620,25680
5455,501202,500403,120,24360,6,"""2""",25680,25800
5455,500403,503902,60,24360,6,"""2""",25800,25860
5455,503902,503303,60,24360,6,"""2""",25860,25920
5455,503303,501102,60,24360,6,"""2""",25920,25980
5455,501102,504002,60,24360,6,"""2""",25980,26040
5455,504002,503801,120,24360,6,"""2""",26040,26160
5455,503801,503800,60,24360,6,"""2""",26160,26220
5456,405200,406303,60,35640,6,"""44""",35640,35700
5456,406303,400502,60,35640,6,"""44""",35700,35760
5456,400502,408005,120,35640,6,"""44""",35760,35880
5456,408005,406804,120,35640,6,"""44""",35880,36000
5456,406804,403002,60,35640,6,"""44""",36000,36060
5456,403002,404103,120,35640,6,"""44""",36060,36180
5456,404103,403104,120,35640,6,"""44""",36180,36300
5456,403104,112103,120,35640,6,"""44""",36300,36420
5456,405200,406303,60,36840,6,"""44""",36840,36900
5456,406303,400502,60,36840,6,"""44""",36900,36960
5456,400502,408005,120,36840,6,"""44""",36960,37080
5456,408005,406804,120,36840,6,"""44""",37080,37200
5456,406804,403002,60,36840,6,"""44""",37200,37260
5456,403002,404103,120,36840,6,"""44""",37260,37380
5456,404103,403104,120,36840,6,"""44""",37380,37500
5456,403104,112103,120,36840,6,"""44""",37500,37620
5456,405200,406303,60,38040,6,"""44""",38040,38100
5456,406303,400502,60,38040,6,"""44""",38100,38160
5456,400502,408005,120,38040,6,"""44""",38160,38280
5456,408005,406804,120,38040,6,"""44""",38280,38400
5456,406804,403002,60,38040,6,"""44""",38400,38460
5456,403002,404103,120,38040,6,"""44""",38460,38580
5456,404103,403104,120,38040,6,"""44""",38580,38700
5456,403104,112103,120,38040,6,"""44""",38700,38820
5456,405200,406303,60,39240,6,"""44""",39240,39300
5456,406303,400502,60,39240,6,"""44""",39300,39360
5456,400502,408005,120,39240,6,"""44""",39360,39480
5456,408005,406804,120,39240,6,"""44""",39480,39600
5456,406804,403002,60,39240,6,"""44""",39600,39660
5456,403002,404103,120,39240,6,"""44""",39660,39780
5456,404103,403104,120,39240,6,"""44""",39780,39900
5456,403104,112103,120,39240,6,"""44""",39900,40020
5456,405200,406303,60,40440,6,"""44""",40440,40500
5456,406303,400502,60,40440,6,"""44""",40500,40560
5456,400502,408005,120,40440,6,"""44""",40560,40680
5456,408005,406804,120,40440,6,"""44""",40680,40800
5456,406804,403002,60,40440,6,"""44""",40800,40860
5456,403002,404103,120,40440,6,"""44""",40860,40980
5456,404103,403104,120,40440,6,"""44""",40980,41100
5456,403104,112103,120,40440,6,"""44""",41100,41220
5456,405200,406303,60,41640,6,"""44""",41640,41700
5456,406303,400502,60,41640,6,"""44""",41700,41760
5456,400502,408005,120,41640,6,"""44""",41760,41880
5456,408005,406804,120,41640,6,"""44""",41880,42000
5456,406804,403002,60,41640,6,"""44""",42000,42060
5456,403002,404103,120,41640,6,"""44""",42060,42180
5456,404103,403104,120,41640,6,"""44""",42180,42300
5456,403104,112103,120,41640,6,"""44""",42300,42420
5456,405200,406303,60,42840,6,"""44""",42840,42900
5456,406303,400502,60,42840,6,"""44""",42900,42960
5456,400502,408005,120,42840,6,"""44""",42960,43080
5456,408005,406804,120,42840,6,"""44""",43080,43200
5456,406804,403002,60,42840,6,"""44""",43200,43260
5456,403002,404103,120,42840,6,"""44""",43260,43380
5456,404103,403104,120,42840,6,"""44""",43380,43500
5456,403104,112103,120,42840,6,"""44""",43500,43620
5456,405200,406303,60,44040,6,"""44""",44040,44100
5456,406303,400502,60,44040,6,"""44""",44100,44160
5456,400502,408005,120,44040,6,"""44""",44160,44280
5456,408005,406804,120,44040,6,"""44""",44280,44400
5456,406804,403002,60,44040,6,"""44""",44400,44460
5456,403002,404103,120,44040,6,"""44""",44460,44580
5456,404103,403104,120,44040,6,"""44""",44580,44700
5456,403104,112103,120,44040,6,"""44""",44700,44820
5456,405200,406303,60,45240,6,"""44""",45240,45300
5456,406303,400502,60,45240,6,"""44""",45300,45360
5456,400502,408005,120,45240,6,"""44""",45360,45480
5456,408005,406804,120,45240,6,"""44""",45480,45600
5456,406804,403002,60,45240,6,"""44""",45600,45660
5456,403002,404103,120,45240,6,"""44""",45660,45780
5456,404103,403104,120,45240,6,"""44""",45780,45900
5456,403104,112103,120,45240,6,"""44""",45900,46020
5456,405200,406303,60,46440,6,"""44""",46440,46500
5456,406303,400502,60,46440,6,"""44""",46500,46560
5456,400502,408005,120,46440,6,"""44""",46560,46680
5456,408005,406804,120,46440,6,"""44""",46680,46800
5456,406804,403002,60,46440,6,"""44""",46800,46860
5456,403002,404103,120,46440,6,"""44""",46860,46980
5456,404103,403104,120,46440,6,"""44""",46980,47100
5456,403104,112103,120,46440,6,"""44""",47100,47220
5456,405200,406303,60,47640,6,"""44""",47640,47700
5456,406303,400502,60,47640,6,"""44""",47700,47760
5456,400502,408005,120,47640,6,"""44""",47760,47880
5456,408005,406804,120,47640,6,"""44""",47880,48000
5456,406804,403002,60,47640,6,"""44""",48000,48060
5456,403002,404103,120,47640,6,"""44""",48060,48180
5456,404103,403104,120,47640,6,"""44""",48180,48300
5456,403104,112103,120,47640,6,"""44""",48300,48420
5456,405200,406303,60,48840,6,"""44""",48840,48900
5456,406303,400502,60,48840,6,"""44""",48900,48960
5456,400502,408005,120,48840,6,"""44""",48960,49080
5456,408005,406804,120,48840,6,"""44""",49080,49200
5456,406804,403002,60,48840,6,"""44""",49200,49260
5456,403002,404103,120,48840,6,"""44""",49260,49380
5456,404103,403104,120,48840,6,"""44""",49380,49500
5456,403104,112103,120,48840,6,"""44""",49500,49620
5456,405200,406303,60,50040,6,"""44""",50040,50100
5456,406303,400502,60,50040,6,"""44""",50100,50160
5456,400502,408005,120,50040,6,"""44""",50160,50280
5456,408005,406804,120,50040,6,"""44""",50280,50400
5456,406804,403002,60,50040,6,"""44""",50400,50460
5456,403002,404103,120,50040,6,"""44""",50460,50580
5456,404103,403104,120,50040,6,"""44""",50580,50700
5456,403104,112103,120,50040,6,"""44""",50700,50820
5456,405200,406303,60,51240,6,"""44""",51240,51300
5456,406303,400502,60,51240,6,"""44""",51300,51360
5456,400502,408005,120,51240,6,"""44""",51360,51480
5456,408005,406804,120,51240,6,"""44""",51480,51600
5456,406804,403002,60,51240,6,"""44""",51600,51660
5456,403002,404103,120,51240,6,"""44""",51660,51780
5456,404103,403104,120,51240,6,"""44""",51780,51900
5456,403104,112103,120,51240,6,"""44""",51900,52020
5456,405200,406303,60,52440,6,"""44""",52440,52500
5456,406303,400502,60,52440,6,"""44""",52500,52560
5456,400502,408005,120,52440,6,"""44""",52560,52680
5456,408005,406804,120,52440,6,"""44""",52680,52800
5456,406804,403002,60,52440,6,"""44""",52800,52860
5456,403002,404103,120,52440,6,"""44""",52860,52980
5456,404103,403104,120,52440,6,"""44""",52980,53100
5456,403104,112103,120,52440,6,"""44""",53100,53220
5456,405200,406303,60,66240,6,"""44""",66240,66300
5456,406303,400502,60,66240,6,"""44""",66300,66360
5456,400502,408005,120,66240,6,"""44""",66360,66480
5456,408005,406804,120,66240,6,"""44""",66480,66600
5456,406804,403002,60,66240,6,"""44""",66600,66660
5456,403002,404103,120,66240,6,"""44""",66660,66780
5456,404103,403104,120,66240,6,"""44""",66780,66900
5456,403104,112103,120,66240,6,"""44""",66900,67020
5456,405200,406303,60,67440,6,"""44""",67440,67500
5456,406303,400502,60,67440,6,"""44""",67500,67560
5456,400502,408005,120,67440,6,"""44""",67560,67680
5456,408005,406804,120,67440,6,"""44""",67680,67800
5456,406804,403002,60,67440,6,"""44""",67800,67860
5456,403002,404103,120,67440,6,"""44""",67860,67980
5456,404103,403104,120,67440,6,"""44""",67980,68100
5456,403104,112103,120,67440,6,"""44""",68100,68220
5456,405200,406303,60,68640,6,"""44""",68640,68700
5456,406303,400502,60,68640,6,"""44""",68700,68760
5456,400502,408005,120,68640,6,"""44""",68760,68880
5456,408005,406804,120,68640,6,"""44""",68880,69000
5456,406804,403002,60,68640,6,"""44""",69000,69060
5456,403002,404103,120,68640,6,"""44""",69060,69180
5456,404103,403104,120,68640,6,"""44""",69180,69300
5456,403104,112103,120,68640,6,"""44""",69300,69420
5457,405200,406303,60,72060,6,"""44""",72060,72120
5457,406303,400502,60,72060,6,"""44""",72120,72180
5457,400502,408005,120,72060,6,"""44""",72180,72300
5457,408005,406804,120,72060,6,"""44""",72300,72420
5457,406804,403002,60,72060,6,"""44""",72420,72480
5457,403002,404103,60,72060,6,"""44""",72480,72540
5457,404103,403104,60,72060,6,"""44""",72540,72600
5457,403104,112103,120,72060,6,"""44""",72600,72720
5467,408703,404002,60,24240,7,"""95""",24240,24300
5467,404002,405502,60,24240,7,"""95""",24300,24360
5467,405502,409102,60,24240,7,"""95""",24360,24420
5467,409102,400902,60,24240,7,"""95""",24420,24480
5467,400902,404502,60,24240,7,"""95""",24480,24540
5467,404502,406401,60,24240,7,"""95""",24540,24600
5467,406401,405103,60,24240,7,"""95""",24600,24660
5467,405103,407602,60,24240,7,"""95""",24660,24720
5467,407602,409003,120,24240,7,"""95""",24720,24840
5467,409003,403803,60,24240,7,"""95""",24840,24900
5467,403803,101103,120,24240,7,"""95""",24900,25020
5467,101103,115100,60,24240,7,"""95""",25020,25080
5467,115100,109015,120,24240,7,"""95""",25080,25200
5467,109015,112104,120,24240,7,"""95""",25200,25320
5467,112104,403102,60,24240,7,"""95""",25320,25380
5467,408703,404002,60,25440,7,"""95""",25440,25500
5467,404002,405502,60,25440,7,"""95""",25500,25560
5467,405502,409102,60,25440,7,"""95""",25560,25620
5467,409102,400902,60,25440,7,"""95""",25620,25680
5467,400902,404502,60,25440,7,"""95""",25680,25740
5467,404502,406401,60,25440,7,"""95""",25740,25800
5467,406401,405103,60,25440,7,"""95""",25800,25860
5467,405103,407602,60,25440,7,"""95""",25860,25920
5467,407602,409003,120,25440,7,"""95""",25920,26040
5467,409003,403803,60,25440,7,"""95""",26040,26100
5467,403803,101103,120,25440,7,"""95""",26100,26220
5467,101103,115100,60,25440,7,"""95""",26220,26280
5467,115100,109015,120,25440,7,"""95""",26280,26400
5467,109015,112104,120,25440,7,"""95""",26400,26520
5467,112104,403102,60,25440,7,"""95""",26520,26580
5467,408703,404002,60,27840,7,"""95""",27840,27900
5467,404002,405502,60,27840,7,"""95""",27900,27960
5467,405502,409102,60,27840,7,"""95""",27960,28020
5467,409102,400902,60,27840,7,"""95""",28020,28080
5467,400902,404502,60,27840,7,"""95""",28080,28140
5467,404502,406401,60,27840,7,"""95""",28140,28200
5467,406401,405103,60,27840,7,"""95""",28200,28260
5467,405103,407602,60,27840,7,"""95""",28260,28320
5467,407602,409003,120,27840,7,"""95""",28320,28440
5467,409003,403803,60,27840,7,"""95""",28440,28500
5467,403803,101103,120,27840,7,"""95""",28500,28620
5467,101103,115100,60,27840,7,"""95""",28620,28680
5467,115100,109015,120,27840,7,"""95""",28680,28800
5467,109015,112104,120,27840,7,"""95""",28800,28920
5467,112104,403102,60,27840,7,"""95""",28920,28980
5467,408703,404002,60,29040,7,"""95""",29040,29100
5467,404002,405502,60,29040,7,"""95""",29100,29160
5467,405502,409102,60,29040,7,"""95""",29160,29220
5467,409102,400902,60,29040,7,"""95""",29220,29280
5467,400902,404502,60,29040,7,"""95""",29280,29340
5467,404502,406401,60,29040,7,"""95""",29340,29400
5467,406401,405103,60,29040,7,"""95""",29400,29460
5467,405103,407602,60,29040,7,"""95""",29460,29520
5467,407602,409003,120,29040,7,"""95""",29520,29640
5467,409003,403803,60,29040,7,"""95""",29640,29700
5467,403803,101103,120,29040,7,"""95""",29700,29820
5467,101103,115100,60,29040,7,"""95""",29820,29880
5467,115100,109015,120,29040,7,"""95""",29880,30000
5467,109015,112104,120,29040,7,"""95""",30000,30120
5467,112104,403102,60,29040,7,"""95""",30120,30180
5467,408703,404002,60,30240,7,"""95""",30240,30300
5467,404002,405502,60,30240,7,"""95""",30300,30360
5467,405502,409102,60,30240,7,"""95""",30360,30420
5467,409102,400902,60,30240,7,"""95""",30420,30480
5467,400902,404502,60,30240,7,"""95""",30480,30540
5467,404502,406401,60,30240,7,"""95""",30540,30600
5467,406401,405103,60,30240,7,"""95""",30600,30660
5467,405103,407602,60,30240,7,"""95""",30660,30720
5467,407602,409003,120,30240,7,"""95""",30720,30840
5467,409003,403803,60,30240,7,"""95""",30840,30900
5467,403803,101103,120,30240,7,"""95""",30900,31020
5467,101103,115100,60,30240,7,"""95""",31020,31080
5467,115100,109015,120,30240,7,"""95""",31080,31200
5467,109015,112104,120,30240,7,"""95""",31200,31320
5467,112104,403102,60,30240,7,"""95""",31320,31380
5467,408703,404002,60,31440,7,"""95""",31440,31500
5467,404002,405502,60,31440,7,"""95""",31500,31560
5467,405502,409102,60,31440,7,"""95""",31560,31620
5467,409102,400902,60,31440,7,"""95""",31620,31680
5467,400902,404502,60,31440,7,"""95""",31680,31740
5467,404502,406401,60,31440,7,"""95""",31740,31800
5467,406401,405103,60,31440,7,"""95""",31800,31860
5467,405103,407602,60,31440,7,"""95""",31860,31920
5467,407602,409003,120,31440,7,"""95""",31920,32040
5467,409003,403803,60,31440,7,"""95""",32040,32100
5467,403803,101103,120,31440,7,"""95""",32100,32220
5467,101103,115100,60,31440,7,"""95""",32220,32280
5467,115100,109015,120,31440,7,"""95""",32280,32400
5467,109015,112104,120,31440,7,"""95""",32400,32520
5467,112104,403102,60,31440,7,"""95""",32520,32580
5467,408703,404002,60,55440,7,"""95""",55440,55500
5467,404002,405502,60,55440,7,"""95""",55500,55560
5467,405502,409102,60,55440,7,"""95""",55560,55620
5467,409102,400902,60,55440,7,"""95""",55620,55680
5467,400902,404502,60,55440,7,"""95""",55680,55740
5467,404502,406401,60,55440,7,"""95""",55740,55800
5467,406401,405103,60,55440,7,"""95""",55800,55860
5467,405103,407602,60,55440,7,"""95""",55860,55920
5467,407602,409003,120,55440,7,"""95""",55920,56040
5467,409003,403803,60,55440,7,"""95""",56040,56100
5467,403803,101103,120,55440,7,"""95""",56100,56220
5467,101103,115100,60,55440,7,"""95""",56220,56280
5467,115100,109015,120,55440,7,"""95""",56280,56400
5467,109015,112104,120,55440,7,"""95""",56400,56520
5467,112104,403102,60,55440,7,"""95""",56520,56580
5467,408703,404002,60,56640,7,"""95""",56640,56700
5467,404002,405502,60,56640,7,"""95""",56700,56760
5467,405502,409102,60,56640,7,"""95""",56760,56820
5467,409102,400902,60,56640,7,"""95""",56820,56880
5467,400902,404502,60,56640,7,"""95""",56880,56940
5467,404502,406401,60,56640,7,"""95""",56940,57000
5467,406401,405103,60,56640,7,"""95""",57000,57060
5467,405103,407602,60,56640,7,"""95""",57060,57120
5467,407602,409003,120,56640,7,"""95""",57120,57240
5467,409003,403803,60,56640,7,"""95""",57240,57300
5467,403803,101103,120,56640,7,"""95""",57300,57420
5467,101103,115100,60,56640,7,"""95""",57420,57480
5467,115100,109015,120,56640,7,"""95""",57480,57600
5467,109015,112104,120,56640,7,"""95""",57600,57720
5467,112104,403102,60,56640,7,"""95""",57720,57780
5467,408703,404002,60,57840,7,"""95""",57840,57900
5467,404002,405502,60,57840,7,"""95""",57900,57960
5467,405502,409102,60,57840,7,"""95""",57960,58020
5467,409102,400902,60,57840,7,"""95""",58020,58080
5467,400902,404502,60,57840,7,"""95""",58080,58140
5467,404502,406401,60,57840,7,"""95""",58140,58200
5467,406401,405103,60,57840,7,"""95""",58200,58260
5467,405103,407602,60,57840,7,"""95""",58260,58320
5467,407602,409003,120,57840,7,"""95""",58320,58440
5467,409003,403803,60,57840,7,"""95""",58440,58500
5467,403803,101103,120,57840,7,"""95""",58500,58620
5467,101103,115100,60,57840,7,"""95""",58620,58680
5467,115100,109015,120,57840,7,"""95""",58680,58800
5467,109015,112104,120,57840,7,"""95""",58800,58920
5467,112104,403102,60,57840,7,"""95""",58920,58980
5467,408703,404002,60,59040,7,"""95""",59040,59100
5467,404002,405502,60,59040,7,"""95""",59100,59160
5467,405502,409102,60,59040,7,"""95""",59160,59220
5467,409102,400902,60,59040,7,"""95""",59220,59280
5467,400902,404502,60,59040,7,"""95""",59280,59340
5467,404502,406401,60,59040,7,"""95""",59340,59400
5467,406401,405103,60,59040,7,"""95""",59400,59460
5467,405103,407602,60,59040,7,"""95""",59460,59520
5467,407602,409003,120,59040,7,"""95""",59520,59640
5467,409003,403803,60,59040,7,"""95""",59640,59700
5467,403803,101103,120,59040,7,"""95""",59700,59820
5467,101103,115100,60,59040,7,"""95""",59820,59880
5467,115100,109015,120,59040,7,"""95""",59880,60000
5467,109015,112104,120,59040,7,"""95""",60000,60120
5467,112104,403102,60,59040,7,"""95""",60120,60180
5467,408703,404002,60,60240,7,"""95""",60240,60300
5467,404002,405502,60,60240,7,"""95""",60300,60360
5467,405502,409102,60,60240,7,"""95""",60360,60420
5467,409102,400902,60,60240,7,"""95""",60420,60480
5467,400902,404502,60,60240,7,"""95""",60480,60540
5467,404502,406401,60,60240,7,"""95""",60540,60600
5467,406401,405103,60,60240,7,"""95""",60600,60660
5467,405103,407602,60,60240,7,"""95""",60660,60720
5467,407602,409003,120,60240,7,"""95""",60720,60840
5467,409003,403803,60,60240,7,"""95""",60840,60900
5467,403803,101103,120,60240,7,"""95""",60900,61020
5467,101103,115100,60,60240,7,"""95""",61020,61080
5467,115100,109015,120,60240,7,"""95""",61080,61200
5467,109015,112104,120,60240,7,"""95""",61200,61320
5467,112104,403102,60,60240,7,"""95""",61320,61380
5467,408703,404002,60,61440,7,"""95""",61440,61500
5467,404002,405502,60,61440,7,"""95""",61500,61560
5467,405502,409102,60,61440,7,"""95""",61560,61620
5467,409102,400902,60,61440,7,"""95""",61620,61680
5467,400902,404502,60,61440,7,"""95""",61680,61740
5467,404502,406401,60,61440,7,"""95""",61740,61800
5467,406401,405103,60,61440,7,"""95""",61800,61860
5467,405103,407602,60,61440,7,"""95""",61860,61920
5467,407602,409003,120,61440,7,"""95""",61920,62040
5467,409003,403803,60,61440,7,"""95""",62040,62100
5467,403803,101103,120,61440,7,"""95""",62100,62220
5467,101103,115100,60,61440,7,"""95""",62220,62280
5467,115100,109015,120,61440,7,"""95""",62280,62400
5467,109015,112104,120,61440,7,"""95""",62400,62520
5467,112104,403102,60,61440,7,"""95""",62520,62580
5467,408703,404002,60,62640,7,"""95""",62640,62700
5467,404002,405502,60,62640,7,"""95""",62700,62760
5467,405502,409102,60,62640,7,"""95""",62760,62820
5467,409102,400902,60,62640,7,"""95""",62820,62880
5467,400902,404502,60,62640,7,"""95""",62880,62940
5467,404502,406401,60,62640,7,"""95""",62940,63000
5467,406401,405103,60,62640,7,"""95""",63000,63060
5467,405103,407602,60,62640,7,"""95""",63060,63120
5467,407602,409003,120,62640,7,"""95""",63120,63240
5467,409003,403803,60,62640,7,"""95""",63240,63300
5467,403803,101103,120,62640,7,"""95""",63300,63420
5467,101103,115100,60,62640,7,"""95""",63420,63480
5467,115100,109015,120,62640,7,"""95""",63480,63600
5467,109015,112104,120,62640,7,"""95""",63600,63720
5467,112104,403102,60,62640,7,"""95""",63720,63780
5467,408703,404002,60,63840,7,"""95""",63840,63900
5467,404002,405502,60,63840,7,"""95""",63900,63960
5467,405502,409102,60,63840,7,"""95""",63960,64020
5467,409102,400902,60,63840,7,"""95""",64020,64080
5467,400902,404502,60,63840,7,"""95""",64080,64140
5467,404502,406401,60,63840,7,"""95""",64140,64200
5467,406401,405103,60,63840,7,"""95""",64200,64260
5467,405103,407602,60,63840,7,"""95""",64260,64320
5467,407602,409003,120,63840,7,"""95""",64320,64440
5467,409003,403803,60,63840,7,"""95""",64440,64500
5467,403803,101103,120,63840,7,"""95""",64500,64620
5467,101103,115100,60,63840,7,"""95""",64620,64680
5467,115100,109015,120,63840,7,"""95""",64680,64800
5467,109015,112104,120,63840,7,"""95""",64800,64920
5467,112104,403102,60,63840,7,"""95""",64920,64980
5468,408703,404002,60,18720,7,"""23""",18720,18780
5468,404002,405502,60,18720,7,"""23""",18780,18840
5468,405502,409102,60,18720,7,"""23""",18840,18900
5468,409102,400902,60,18720,7,"""23""",18900,18960
5468,400902,404502,60,18720,7,"""23""",18960,19020
5468,404502,406401,60,18720,7,"""23""",19020,19080
5468,406401,405103,60,18720,7,"""23""",19080,19140
5468,405103,407602,60,18720,7,"""23""",19140,19200
5468,407602,409003,60,18720,7,"""23""",19200,19260
5468,409003,403803,60,18720,7,"""23""",19260,19320
5468,403803,101103,120,18720,7,"""23""",19320,19440
5468,101103,115100,60,18720,7,"""23""",19440,19500
5468,115100,109015,120,18720,7,"""23""",19500,19620
5468,109015,112104,120,18720,7,"""23""",19620,19740
5470,112102,101101,120,20640,7,"""28""",20640,20760
5470,101101,403801,120,20640,7,"""28""",20760,20880
5470,403801,409002,60,20640,7,"""28""",20880,20940
5470,409002,407601,60,20640,7,"""28""",20940,21000
5470,407601,405106,120,20640,7,"""28""",21000,21120
5470,405106,404501,60,20640,7,"""28""",21120,21180
5470,404501,400901,60,20640,7,"""28""",21180,21240
5470,400901,409101,60,20640,7,"""28""",21240,21300
5470,409101,405501,60,20640,7,"""28""",21300,21360
5470,405501,404001,60,20640,7,"""28""",21360,21420
5470,404001,408704,60,20640,7,"""28""",21420,21480
5470,408704,601,0,20640,7,"""28""",21480,21480
5470,601,201,60,20640,7,"""28""",21480,21540
5470,201,501,60,20640,7,"""28""",21540,21600
5470,501,304,60,20640,7,"""28""",21600,21660
5470,304,100,120,20640,7,"""28""",21660,21780
5471,403104,112102,120,25860,7,"""76""",25860,25980
5471,112102,101101,120,25860,7,"""76""",25980,26100
5471,101101,403801,120,25860,7,"""76""",26100,26220
5471,403801,409002,60,25860,7,"""76""",26220,26280
5471,409002,407601,60,25860,7,"""76""",26280,26340
5471,407601,405106,120,25860,7,"""76""",26340,26460
5471,405106,404501,60,25860,7,"""76""",26460,26520
5471,404501,400901,60,25860,7,"""76""",26520,26580
5471,400901,409101,60,25860,7,"""76""",26580,26640
5471,409101,405501,60,25860,7,"""76""",26640,26700
5471,405501,404001,60,25860,7,"""76""",26700,26760
5471,404001,408704,120,25860,7,"""76""",26760,26880
5471,403104,112102,120,27060,7,"""76""",27060,27180
5471,112102,101101,120,27060,7,"""76""",27180,27300
5471,101101,403801,120,27060,7,"""76""",27300,27420
5471,403801,409002,60,27060,7,"""76""",27420,27480
5471,409002,407601,60,27060,7,"""76""",27480,27540
5471,407601,405106,120,27060,7,"""76""",27540,27660
5471,405106,404501,60,27060,7,"""76""",27660,27720
5471,404501,400901,60,27060,7,"""76""",27720,27780
5471,400901,409101,60,27060,7,"""76""",27780,27840
5471,409101,405501,60,27060,7,"""76""",27840,27900
5471,405501,404001,60,27060,7,"""76""",27900,27960
5471,404001,408704,120,27060,7,"""76""",27960,28080
5471,403104,112102,120,28260,7,"""76""",28260,28380
5471,112102,101101,120,28260,7,"""76""",28380,28500
5471,101101,403801,120,28260,7,"""76""",28500,28620
5471,403801,409002,60,28260,7,"""76""",28620,28680
5471,409002,407601,60,28260,7,"""76""",28680,28740
5471,407601,405106,120,28260,7,"""76""",28740,28860
5471,405106,404501,60,28260,7,"""76""",28860,28920
5471,404501,400901,60,28260,7,"""76""",28920,28980
5471,400901,409101,60,28260,7,"""76""",28980,29040
5471,409101,405501,60,28260,7,"""76""",29040,29100
5471,405501,404001,60,28260,7,"""76""",29100,29160
5471,404001,408704,120,28260,7,"""76""",29160,29280
5471,403104,112102,120,29460,7,"""76""",29460,29580
5471,112102,101101,120,29460,7,"""76""",29580,29700
5471,101101,403801,120,29460,7,"""76""",29700,29820
5471,403801,409002,60,29460,7,"""76""",29820,29880
5471,409002,407601,60,29460,7,"""76""",29880,29940
5471,407601,405106,120,29460,7,"""76""",29940,30060
5471,405106,404501,60,29460,7,"""76""",30060,30120
5471,404501,400901,60,29460,7,"""76""",30120,30180
5471,400901,409101,60,29460,7,"""76""",30180,30240
5471,409101,405501,60,29460,7,"""76""",30240,30300
5471,405501,404001,60,29460,7,"""76""",30300,30360
5471,404001,408704,120,29460,7,"""76""",30360,30480
5471,403104,112102,120,30660,7,"""76""",30660,30780
5471,112102,101101,120,30660,7,"""76""",30780,30900
5471,101101,403801,120,30660,7,"""76""",30900,31020
5471,403801,409002,60,30660,7,"""76""",31020,31080
5471,409002,407601,60,30660,7,"""76""",31080,31140
5471,407601,405106,120,30660,7,"""76""",31140,31260
5471,405106,404501,60,30660,7,"""76""",31260,31320
5471,404501,400901,60,30660,7,"""76""",31320,31380
5471,400901,409101,60,30660,7,"""76""",31380,31440
5471,409101,405501,60,30660,7,"""76""",31440,31500
5471,405501,404001,60,30660,7,"""76""",31500,31560
5471,404001,408704,120,30660,7,"""76""",31560,31680
5471,403104,112102,120,54660,7,"""76""",54660,54780
5471,112102,101101,120,54660,7,"""76""",54780,54900
5471,101101,403801,120,54660,7,"""76""",54900,55020
5471,403801,409002,60,54660,7,"""76""",55020,55080
5471,409002,407601,60,54660,7,"""76""",55080,55140
5471,407601,405106,120,54660,7,"""76""",55140,55260
5471,405106,404501,60,54660,7,"""76""",55260,55320
5471,404501,400901,60,54660,7,"""76""",55320,55380
5471,400901,409101,60,54660,7,"""76""",55380,55440
5471,409101,405501,60,54660,7,"""76""",55440,55500
5471,405501,404001,60,54660,7,"""76""",55500,55560
5471,404001,408704,120,54660,7,"""76""",55560,55680
5471,403104,112102,120,55860,7,"""76""",55860,55980
5471,112102,101101,120,55860,7,"""76""",55980,56100
5471,101101,403801,120,55860,7,"""76""",56100,56220
5471,403801,409002,60,55860,7,"""76""",56220,56280
5471,409002,407601,60,55860,7,"""76""",56280,56340
5471,407601,405106,120,55860,7,"""76""",56340,56460
5471,405106,404501,60,55860,7,"""76""",56460,56520
5471,404501,400901,60,55860,7,"""76""",56520,56580
5471,400901,409101,60,55860,7,"""76""",56580,56640
5471,409101,405501,60,55860,7,"""76""",56640,56700
5471,405501,404001,60,55860,7,"""76""",56700,56760
5471,404001,408704,120,55860,7,"""76""",56760,56880
5471,403104,112102,120,57060,7,"""76""",57060,57180
5471,112102,101101,120,57060,7,"""76""",57180,57300
5471,101101,403801,120,57060,7,"""76""",57300,57420
5471,403801,409002,60,57060,7,"""76""",57420,57480
5471,409002,407601,60,57060,7,"""76""",57480,57540
5471,407601,405106,120,57060,7,"""76""",57540,57660
5471,405106,404501,60,57060,7,"""76""",57660,57720
5471,404501,400901,60,57060,7,"""76""",57720,57780
5471,400901,409101,60,57060,7,"""76""",57780,57840
5471,409101,405501,60,57060,7,"""76""",57840,57900
5471,405501,404001,60,57060,7,"""76""",57900,57960
5471,404001,408704,120,57060,7,"""76""",57960,58080
5471,403104,112102,120,58260,7,"""76""",58260,58380
5471,112102,101101,120,58260,7,"""76""",58380,58500
5471,101101,403801,120,58260,7,"""76""",58500,58620
5471,403801,409002,60,58260,7,"""76""",58620,58680
5471,409002,407601,60,58260,7,"""76""",58680,58740
5471,407601,405106,120,58260,7,"""76""",58740,58860
5471,405106,404501,60,58260,7,"""76""",58860,58920
5471,404501,400901,60,58260,7,"""76""",58920,58980
5471,400901,409101,60,58260,7,"""76""",58980,59040
5471,409101,405501,60,58260,7,"""76""",59040,59100
5471,405501,404001,60,58260,7,"""76""",59100,59160
5471,404001,408704,120,58260,7,"""76""",59160,59280
5471,403104,112102,120,59460,7,"""76""",59460,59580
5471,112102,101101,120,59460,7,"""76""",59580,59700
5471,101101,403801,120,59460,7,"""76""",59700,59820
5471,403801,409002,60,59460,7,"""76""",59820,59880
5471,409002,407601,60,59460,7,"""76""",59880,59940
5471,407601,405106,120,59460,7,"""76""",59940,60060
5471,405106,404501,60,59460,7,"""76""",60060,60120
5471,404501,400901,60,59460,7,"""76""",60120,60180
5471,400901,409101,60,59460,7,"""76""",60180,60240
5471,409101,405501,60,59460,7,"""76""",60240,60300
5471,405501,404001,60,59460,7,"""76""",60300,60360
5471,404001,408704,120,59460,7,"""76""",60360,60480
5471,403104,112102,120,60660,7,"""76""",60660,60780
5471,112102,101101,120,60660,7,"""76""",60780,60900
5471,101101,403801,120,60660,7,"""76""",60900,61020
5471,403801,409002,60,60660,7,"""76""",61020,61080
5471,409002,407601,60,60660,7,"""76""",61080,61140
5471,407601,405106,120,60660,7,"""76""",61140,61260
5471,405106,404501,60,60660,7,"""76""",61260,61320
5471,404501,400901,60,60660,7,"""76""",61320,61380
5471,400901,409101,60,60660,7,"""76""",61380,61440
5471,409101,405501,60,60660,7,"""76""",61440,61500
5471,405501,404001,60,60660,7,"""76""",61500,61560
5471,404001,408704,120,60660,7,"""76""",61560,61680
5471,403104,112102,120,61860,7,"""76""",61860,61980
5471,112102,101101,120,61860,7,"""76""",61980,62100
5471,101101,403801,120,61860,7,"""76""",62100,62220
5471,403801,409002,60,61860,7,"""76""",62220,62280
5471,409002,407601,60,61860,7,"""76""",62280,62340
5471,407601,405106,120,61860,7,"""76""",62340,62460
5471,405106,404501,60,61860,7,"""76""",62460,62520
5471,404501,400901,60,61860,7,"""76""",62520,62580
5471,400901,409101,60,61860,7,"""76""",62580,62640
5471,409101,405501,60,61860,7,"""76""",62640,62700
5471,405501,404001,60,61860,7,"""76""",62700,62760
5471,404001,408704,120,61860,7,"""76""",62760,62880
5471,403104,112102,120,63060,7,"""76""",63060,63180
5471,112102,101101,120,63060,7,"""76""",63180,63300
5471,101101,403801,120,63060,7,"""76""",63300,63420
5471,403801,409002,60,63060,7,"""76""",63420,63480
5471,409002,407601,60,63060,7,"""76""",63480,63540
5471,407601,405106,120,63060,7,"""76""",63540,63660
5471,405106,404501,60,63060,7,"""76""",63660,63720
5471,404501,400901,60,63060,7,"""76""",63720,63780
5471,400901,409101,60,63060,7,"""76""",63780,63840
5471,409101,405501,60,63060,7,"""76""",63840,63900
5471,405501,404001,60,63060,7,"""76""",63900,63960
5471,404001,408704,120,63060,7,"""76""",63960,64080
5471,403104,112102,120,64260,7,"""76""",64260,64380
5471,112102,101101,120,64260,7,"""76""",64380,64500
5471,101101,403801,120,64260,7,"""76""",64500,64620
5471,403801,409002,60,64260,7,"""76""",64620,64680
5471,409002,407601,60,64260,7,"""76""",64680,64740
5471,407601,405106,120,64260,7,"""76""",64740,64860
5471,405106,404501,60,64260,7,"""76""",64860,64920
5471,404501,400901,60,64260,7,"""76""",64920,64980
5471,400901,409101,60,64260,7,"""76""",64980,65040
5471,409101,405501,60,64260,7,"""76""",65040,65100
5471,405501,404001,60,64260,7,"""76""",65100,65160
5471,404001,408704,120,64260,7,"""76""",65160,65280
5471,403104,112102,120,65460,7,"""76""",65460,65580
5471,112102,101101,120,65460,7,"""76""",65580,65700
5471,101101,403801,120,65460,7,"""76""",65700,65820
5471,403801,409002,60,65460,7,"""76""",65820,65880
5471,409002,407601,60,65460,7,"""76""",65880,65940
5471,407601,405106,120,65460,7,"""76""",65940,66060
5471,405106,404501,60,65460,7,"""76""",66060,66120
5471,404501,400901,60,65460,7,"""76""",66120,66180
5471,400901,409101,60,65460,7,"""76""",66180,66240
5471,409101,405501,60,65460,7,"""76""",66240,66300
5471,405501,404001,60,65460,7,"""76""",66300,66360
5471,404001,408704,120,65460,7,"""76""",66360,66480
5484,302,502,60,26760,54,"""1""",26760,26820
5484,502,202,60,26760,54,"""1""",26820,26880
5484,202,602,60,26760,54,"""1""",26880,26940
5484,602,408703,60,26760,54,"""1""",26940,27000
5484,408703,404002,60,26760,54,"""1""",27000,27060
5484,404002,405502,60,26760,54,"""1""",27060,27120
5484,405502,409102,60,26760,54,"""1""",27120,27180
5484,409102,400902,60,26760,54,"""1""",27180,27240
5484,400902,404502,60,26760,54,"""1""",27240,27300
5484,404502,406401,60,26760,54,"""1""",27300,27360
5484,406401,402203,60,26760,54,"""1""",27360,27420
5484,402203,500701,60,26760,54,"""1""",27420,27480
5484,500701,402001,60,26760,54,"""1""",27480,27540
5484,402001,400401,120,26760,54,"""1""",27540,27660
5484,400401,501702,120,26760,54,"""1""",27660,27780
5484,501702,500903,300,26760,54,"""1""",27780,28080
5484,500903,502801,60,26760,54,"""1""",28080,28140
5485,500102,500801,60,47100,54,"""2""",47100,47160
5485,500801,500904,180,47100,54,"""2""",47160,47340
5485,500904,501701,180,47100,54,"""2""",47340,47520
5485,501701,400402,120,47100,54,"""2""",47520,47640
5485,400402,402002,60,47100,54,"""2""",47640,47700
5485,402002,500702,120,47100,54,"""2""",47700,47820
5485,500702,402204,60,47100,54,"""2""",47820,47880
5485,402204,405100,120,47100,54,"""2""",47880,48000
5485,405100,404501,60,47100,54,"""2""",48000,48060
5485,404501,400901,60,47100,54,"""2""",48060,48120
5485,400901,409101,60,47100,54,"""2""",48120,48180
5485,409101,405501,60,47100,54,"""2""",48180,48240
5485,405501,404001,60,47100,54,"""2""",48240,48300
5485,404001,408704,120,47100,54,"""2""",48300,48420
5485,408704,601,0,47100,54,"""2""",48420,48420
5485,601,201,60,47100,54,"""2""",48420,48480
5485,201,501,60,47100,54,"""2""",48480,48540
5485,501,304,60,47100,54,"""2""",48540,48600
5486,500903,502801,60,47160,54,"""6""",47160,47220
5486,502801,101101,120,47160,54,"""6""",47220,47340
5486,101101,403801,120,47160,54,"""6""",47340,47460
5486,403801,409002,60,47160,54,"""6""",47460,47520
5486,409002,407601,60,47160,54,"""6""",47520,47580
5486,407601,405106,120,47160,54,"""6""",47580,47700
5486,405106,404501,60,47160,54,"""6""",47700,47760
5486,404501,400901,60,47160,54,"""6""",47760,47820
5486,400901,409101,60,47160,54,"""6""",47820,47880
5486,409101,405501,60,47160,54,"""6""",47880,47940
5486,405501,404001,60,47160,54,"""6""",47940,48000
5486,404001,408704,120,47160,54,"""6""",48000,48120
5486,408704,601,0,47160,54,"""6""",48120,48120
5486,601,201,60,47160,54,"""6""",48120,48180
5486,201,501,60,47160,54,"""6""",48180,48240
5486,501,304,60,47160,54,"""6""",48240,48300
5499,304302,109202,0,47460,9,"""11""",47460,47460
5499,109202,304803,60,47460,9,"""11""",47460,47520
5499,304803,306001,60,47460,9,"""11""",47520,47580
5499,306001,304401,180,47460,9,"""11""",47580,47760
5499,304401,305202,120,47460,9,"""11""",47760,47880
5499,305202,301101,60,47460,9,"""11""",47880,47940
5499,301101,301502,120,47460,9,"""11""",47940,48060
5499,301502,301201,0,47460,9,"""11""",48060,48060
5499,301201,301600,60,47460,9,"""11""",48060,48120
5499,301600,301001,60,47460,9,"""11""",48120,48180
5499,301001,301302,60,47460,9,"""11""",48180,48240
5499,301302,305001,120,47460,9,"""11""",48240,48360
5499,305001,33902,120,47460,9,"""11""",48360,48480
5499,33902,26502,120,47460,9,"""11""",48480,48600
5499,26502,401302,60,47460,9,"""11""",48600,48660
5504,401303,26503,60,47460,9,"""8""",48660,48720
5504,26503,33903,120,47460,9,"""8""",48720,48840
5504,33903,305002,120,47460,9,"""8""",48840,48960
5504,305002,301301,120,47460,9,"""8""",48960,49080
5504,301301,301002,120,47460,9,"""8""",49080,49200
5504,301002,301202,60,47460,9,"""8""",49200,49260
5504,301202,301503,60,47460,9,"""8""",49260,49320
5520,400200,400402,60,23820,10,"""31""",23820,23880
5520,400402,402002,60,23820,10,"""31""",23880,23940
5520,402002,500702,120,23820,10,"""31""",23940,24060
5520,500702,402204,60,23820,10,"""31""",24060,24120
5520,402204,402900,60,23820,10,"""31""",24120,24180
5520,402900,405300,120,23820,10,"""31""",24180,24300
5520,405300,402800,60,23820,10,"""31""",24300,24360
5520,402800,405100,60,23820,10,"""31""",24360,24420
5520,405100,405902,60,23820,10,"""31""",24420,24480
5520,405902,406500,60,23820,10,"""31""",24480,24540
5520,406500,400601,120,23820,10,"""31""",24540,24660
5520,400601,404300,60,23820,10,"""31""",24660,24720
5520,404300,407401,60,23820,10,"""31""",24720,24780
5520,407401,404103,120,23820,10,"""31""",24780,24900
5520,404103,403104,120,23820,10,"""31""",24900,25020
5520,403104,112101,180,23820,10,"""31""",25020,25200
5520,112101,103001,180,23820,10,"""31""",25200,25380
5520,103001,106501,60,23820,10,"""31""",25380,25440
5520,106501,119006,180,23820,10,"""31""",25440,25620
5520,119006,302501,120,23820,10,"""31""",25620,25740
5520,302501,303001,60,23820,10,"""31""",25740,25800
5520,303001,302201,120,23820,10,"""31""",25800,25920
5520,302201,302001,60,23820,10,"""31""",25920,25980
5520,302001,302100,120,23820,10,"""31""",25980,26100
5520,400200,400402,60,25020,10,"""31""",25020,25080
5520,400402,402002,60,25020,10,"""31""",25080,25140
5520,402002,500702,120,25020,10,"""31""",25140,25260
5520,500702,402204,60,25020,10,"""31""",25260,25320
5520,402204,402900,60,25020,10,"""31""",25320,25380
5520,402900,405300,120,25020,10,"""31""",25380,25500
5520,405300,402800,60,25020,10,"""31""",25500,25560
5520,402800,405100,60,25020,10,"""31""",25560,25620
5520,405100,405902,60,25020,10,"""31""",25620,25680
5520,405902,406500,60,25020,10,"""31""",25680,25740
5520,406500,400601,120,25020,10,"""31""",25740,25860
5520,400601,404300,60,25020,10,"""31""",25860,25920
5520,404300,407401,60,25020,10,"""31""",25920,25980
5520,407401,404103,120,25020,10,"""31""",25980,26100
5520,404103,403104,120,25020,10,"""31""",26100,26220
5520,403104,112101,180,25020,10,"""31""",26220,26400
5520,112101,103001,180,25020,10,"""31""",26400,26580
5520,103001,106501,60,25020,10,"""31""",26580,26640
5520,106501,119006,180,25020,10,"""31""",26640,26820
5520,119006,302501,120,25020,10,"""31""",26820,26940
5520,302501,303001,60,25020,10,"""31""",26940,27000
5520,303001,302201,120,25020,10,"""31""",27000,27120
5520,302201,302001,60,25020,10,"""31""",27120,27180
5520,302001,302100,120,25020,10,"""31""",27180,27300
5520,400200,400402,60,26220,10,"""31""",26220,26280
5520,400402,402002,60,26220,10,"""31""",26280,26340
5520,402002,500702,120,26220,10,"""31""",26340,26460
5520,500702,402204,60,26220,10,"""31""",26460,26520
5520,402204,402900,60,26220,10,"""31""",26520,26580
5520,402900,405300,120,26220,10,"""31""",26580,26700
5520,405300,402800,60,26220,10,"""31""",26700,26760
5520,402800,405100,60,26220,10,"""31""",26760,26820
5520,405100,405902,60,26220,10,"""31""",26820,26880
5520,405902,406500,60,26220,10,"""31""",26880,26940
5520,406500,400601,120,26220,10,"""31""",26940,27060
5520,400601,404300,60,26220,10,"""31""",27060,27120
5520,404300,407401,60,26220,10,"""31""",27120,27180
5520,407401,404103,120,26220,10,"""31""",27180,27300
5520,404103,403104,120,26220,10,"""31""",27300,27420
5520,403104,112101,180,26220,10,"""31""",27420,27600
5520,112101,103001,180,26220,10,"""31""",27600,27780
5520,103001,106501,60,26220,10,"""31""",27780,27840
5520,106501,119006,180,26220,10,"""31""",27840,28020
5520,119006,302501,120,26220,10,"""31""",28020,28140
5520,302501,303001,60,26220,10,"""31""",28140,28200
5520,303001,302201,120,26220,10,"""31""",28200,28320
5520,302201,302001,60,26220,10,"""31""",28320,28380
5520,302001,302100,120,26220,10,"""31""",28380,28500
5520,400200,400402,60,26820,10,"""31""",26820,26880
5520,400402,402002,60,26820,10,"""31""",26880,26940
5520,402002,500702,120,26820,10,"""31""",26940,27060
5520,500702,402204,60,26820,10,"""31""",27060,27120
5520,402204,402900,60,26820,10,"""31""",27120,27180
5520,402900,405300,120,26820,10,"""31""",27180,27300
5520,405300,402800,60,26820,10,"""31""",27300,27360
5520,402800,405100,60,26820,10,"""31""",27360,27420
5520,405100,405902,60,26820,10,"""31""",27420,27480
5520,405902,406500,60,26820,10,"""31""",27480,27540
5520,406500,400601,120,26820,10,"""31""",27540,27660
5520,400601,404300,60,26820,10,"""31""",27660,27720
5520,404300,407401,60,26820,10,"""31""",27720,27780
5520,407401,404103,120,26820,10,"""31""",27780,27900
5520,404103,403104,120,26820,10,"""31""",27900,28020
5520,403104,112101,180,26820,10,"""31""",28020,28200
5520,112101,103001,180,26820,10,"""31""",28200,28380
5520,103001,106501,60,26820,10,"""31""",28380,28440
5520,106501,119006,180,26820,10,"""31""",28440,28620
5520,119006,302501,120,26820,10,"""31""",28620,28740
5520,302501,303001,60,26820,10,"""31""",28740,28800
5520,303001,302201,120,26820,10,"""31""",28800,28920
5520,302201,302001,60,26820,10,"""31""",28920,28980
5520,302001,302100,120,26820,10,"""31""",28980,29100
5520,400200,400402,60,27420,10,"""31""",27420,27480
5520,400402,402002,60,27420,10,"""31""",27480,27540
5520,402002,500702,120,27420,10,"""31""",27540,27660
5520,500702,402204,60,27420,10,"""31""",27660,27720
5520,402204,402900,60,27420,10,"""31""",27720,27780
5520,402900,405300,120,27420,10,"""31""",27780,27900
5520,405300,402800,60,27420,10,"""31""",27900,27960
5520,402800,405100,60,27420,10,"""31""",27960,28020
5520,405100,405902,60,27420,10,"""31""",28020,28080
5520,405902,406500,60,27420,10,"""31""",28080,28140
5520,406500,400601,120,27420,10,"""31""",28140,28260
5520,400601,404300,60,27420,10,"""31""",28260,28320
5520,404300,407401,60,27420,10,"""31""",28320,28380
5520,407401,404103,120,27420,10,"""31""",28380,28500
5520,404103,403104,120,27420,10,"""31""",28500,28620
5520,403104,112101,180,27420,10,"""31""",28620,28800
5520,112101,103001,180,27420,10,"""31""",28800,28980
5520,103001,106501,60,27420,10,"""31""",28980,29040
5520,106501,119006,180,27420,10,"""31""",29040,29220
5520,119006,302501,120,27420,10,"""31""",29220,29340
5520,302501,303001,60,27420,10,"""31""",29340,29400
5520,303001,302201,120,27420,10,"""31""",29400,29520
5520,302201,302001,60,27420,10,"""31""",29520,29580
5520,302001,302100,120,27420,10,"""31""",29580,29700
5520,400200,400402,60,28620,10,"""31""",28620,28680
5520,400402,402002,60,28620,10,"""31""",28680,28740
5520,402002,500702,120,28620,10,"""31""",28740,28860
5520,500702,402204,60,28620,10,"""31""",28860,28920
5520,402204,402900,60,28620,10,"""31""",28920,28980
5520,402900,405300,120,28620,10,"""31""",28980,29100
5520,405300,402800,60,28620,10,"""31""",29100,29160
5520,402800,405100,60,28620,10,"""31""",29160,29220
5520,405100,405902,60,28620,10,"""31""",29220,29280
5520,405902,406500,60,28620,10,"""31""",29280,29340
5520,406500,400601,120,28620,10,"""31""",29340,29460
5520,400601,404300,60,28620,10,"""31""",29460,29520
5520,404300,407401,60,28620,10,"""31""",29520,29580
5520,407401,404103,120,28620,10,"""31""",29580,29700
5520,404103,403104,120,28620,10,"""31""",29700,29820
5520,403104,112101,180,28620,10,"""31""",29820,30000
5520,112101,103001,180,28620,10,"""31""",30000,30180
5520,103001,106501,60,28620,10,"""31""",30180,30240
5520,106501,119006,180,28620,10,"""31""",30240,30420
5520,119006,302501,120,28620,10,"""31""",30420,30540
5520,302501,303001,60,28620,10,"""31""",30540,30600
5520,303001,302201,120,28620,10,"""31""",30600,30720
5520,302201,302001,60,28620,10,"""31""",30720,30780
5520,302001,302100,120,28620,10,"""31""",30780,30900
5520,400200,400402,60,29820,10,"""31""",29820,29880
5520,400402,402002,60,29820,10,"""31""",29880,29940
5520,402002,500702,120,29820,10,"""31""",29940,30060
5520,500702,402204,60,29820,10,"""31""",30060,30120
5520,402204,402900,60,29820,10,"""31""",30120,30180
5520,402900,405300,120,29820,10,"""31""",30180,30300
5520,405300,402800,60,29820,10,"""31""",30300,30360
5520,402800,405100,60,29820,10,"""31""",30360,30420
5520,405100,405902,60,29820,10,"""31""",30420,30480
5520,405902,406500,60,29820,10,"""31""",30480,30540
5520,406500,400601,120,29820,10,"""31""",30540,30660
5520,400601,404300,60,29820,10,"""31""",30660,30720
5520,404300,407401,60,29820,10,"""31""",30720,30780
5520,407401,404103,120,29820,10,"""31""",30780,30900
5520,404103,403104,120,29820,10,"""31""",30900,31020
5520,403104,112101,180,29820,10,"""31""",31020,31200
5520,112101,103001,180,29820,10,"""31""",31200,31380
5520,103001,106501,60,29820,10,"""31""",31380,31440
5520,106501,119006,180,29820,10,"""31""",31440,31620
5520,119006,302501,120,29820,10,"""31""",31620,31740
5520,302501,303001,60,29820,10,"""31""",31740,31800
5520,303001,302201,120,29820,10,"""31""",31800,31920
5520,302201,302001,60,29820,10,"""31""",31920,31980
5520,302001,302100,120,29820,10,"""31""",31980,32100
5520,400200,400402,60,31020,10,"""31""",31020,31080
5520,400402,402002,60,31020,10,"""31""",31080,31140
5520,402002,500702,120,31020,10,"""31""",31140,31260
5520,500702,402204,60,31020,10,"""31""",31260,31320
5520,402204,402900,60,31020,10,"""31""",31320,31380
5520,402900,405300,120,31020,10,"""31""",31380,31500
5520,405300,402800,60,31020,10,"""31""",31500,31560
5520,402800,405100,60,31020,10,"""31""",31560,31620
5520,405100,405902,60,31020,10,"""31""",31620,31680
5520,405902,406500,60,31020,10,"""31""",31680,31740
5520,406500,400601,120,31020,10,"""31""",31740,31860
5520,400601,404300,60,31020,10,"""31""",31860,31920
5520,404300,407401,60,31020,10,"""31""",31920,31980
5520,407401,404103,120,31020,10,"""31""",31980,32100
5520,404103,403104,120,31020,10,"""31""",32100,32220
5520,403104,112101,180,31020,10,"""31""",32220,32400
5520,112101,103001,180,31020,10,"""31""",32400,32580
5520,103001,106501,60,31020,10,"""31""",32580,32640
5520,106501,119006,180,31020,10,"""31""",32640,32820
5520,119006,302501,120,31020,10,"""31""",32820,32940
5520,302501,303001,60,31020,10,"""31""",32940,33000
5520,303001,302201,120,31020,10,"""31""",33000,33120
5520,302201,302001,60,31020,10,"""31""",33120,33180
5520,302001,302100,120,31020,10,"""31""",33180,33300
5520,400200,400402,60,68760,10,"""31""",68760,68820
5520,400402,402002,60,68760,10,"""31""",68820,68880
5520,402002,500702,120,68760,10,"""31""",68880,69000
5520,500702,402204,60,68760,10,"""31""",69000,69060
5520,402204,402900,60,68760,10,"""31""",69060,69120
5520,402900,405300,120,68760,10,"""31""",69120,69240
5520,405300,402800,60,68760,10,"""31""",69240,69300
5520,402800,405100,60,68760,10,"""31""",69300,69360
5520,405100,405902,60,68760,10,"""31""",69360,69420
5520,405902,406500,60,68760,10,"""31""",69420,69480
5520,406500,400601,120,68760,10,"""31""",69480,69600
5520,400601,404300,60,68760,10,"""31""",69600,69660
5520,404300,407401,60,68760,10,"""31""",69660,69720
5520,407401,404103,120,68760,10,"""31""",69720,69840
5520,404103,403104,120,68760,10,"""31""",69840,69960
5520,403104,112101,180,68760,10,"""31""",69960,70140
5520,112101,103001,180,68760,10,"""31""",70140,70320
5520,103001,106501,60,68760,10,"""31""",70320,70380
5520,106501,119006,180,68760,10,"""31""",70380,70560
5520,119006,302501,120,68760,10,"""31""",70560,70680
5520,302501,303001,60,68760,10,"""31""",70680,70740
5520,303001,302201,120,68760,10,"""31""",70740,70860
5520,302201,302001,60,68760,10,"""31""",70860,70920
5520,302001,302100,120,68760,10,"""31""",70920,71040
5521,400200,400402,60,18780,10,"""31""",18780,18840
5521,400402,402002,60,18780,10,"""31""",18840,18900
5521,402002,500702,60,18780,10,"""31""",18900,18960
5521,500702,402204,60,18780,10,"""31""",18960,19020
5521,402204,402900,60,18780,10,"""31""",19020,19080
5521,402900,405300,120,18780,10,"""31""",19080,19200
5521,405300,402800,60,18780,10,"""31""",19200,19260
5521,402800,405100,60,18780,10,"""31""",19260,19320
5521,405100,405902,60,18780,10,"""31""",19320,19380
5521,405902,406500,60,18780,10,"""31""",19380,19440
5521,406500,400601,120,18780,10,"""31""",19440,19560
5521,400601,404300,60,18780,10,"""31""",19560,19620
5521,404300,407401,60,18780,10,"""31""",19620,19680
5521,407401,404103,120,18780,10,"""31""",19680,19800
5521,404103,403104,60,18780,10,"""31""",19800,19860
5521,403104,112101,180,18780,10,"""31""",19860,20040
5521,112101,103001,180,18780,10,"""31""",20040,20220
5521,103001,106501,60,18780,10,"""31""",20220,20280
5521,106501,119006,180,18780,10,"""31""",20280,20460
5521,119006,302501,120,18780,10,"""31""",20460,20580
5521,302501,303001,60,18780,10,"""31""",20580,20640
5521,303001,302201,120,18780,10,"""31""",20640,20760
5521,302201,302001,60,18780,10,"""31""",20760,20820
5521,302001,302100,120,18780,10,"""31""",20820,20940
5521,400200,400402,60,21540,10,"""31""",21540,21600
5521,400402,402002,60,21540,10,"""31""",21600,21660
5521,402002,500702,60,21540,10,"""31""",21660,21720
5521,500702,402204,60,21540,10,"""31""",21720,21780
5521,402204,402900,60,21540,10,"""31""",21780,21840
5521,402900,405300,120,21540,10,"""31""",21840,21960
5521,405300,402800,60,21540,10,"""31""",21960,22020
5521,402800,405100,60,21540,10,"""31""",22020,22080
5521,405100,405902,60,21540,10,"""31""",22080,22140
5521,405902,406500,60,21540,10,"""31""",22140,22200
5521,406500,400601,120,21540,10,"""31""",22200,22320
5521,400601,404300,60,21540,10,"""31""",22320,22380
5521,404300,407401,60,21540,10,"""31""",22380,22440
5521,407401,404103,120,21540,10,"""31""",22440,22560
5521,404103,403104,60,21540,10,"""31""",22560,22620
5521,403104,112101,180,21540,10,"""31""",22620,22800
5521,112101,103001,180,21540,10,"""31""",22800,22980
5521,103001,106501,60,21540,10,"""31""",22980,23040
5521,106501,119006,180,21540,10,"""31""",23040,23220
5521,119006,302501,120,21540,10,"""31""",23220,23340
5521,302501,303001,60,21540,10,"""31""",23340,23400
5521,303001,302201,120,21540,10,"""31""",23400,23520
5521,302201,302001,60,21540,10,"""31""",23520,23580
5521,302001,302100,120,21540,10,"""31""",23580,23700
5521,400200,400402,60,22740,10,"""31""",22740,22800
5521,400402,402002,60,22740,10,"""31""",22800,22860
5521,402002,500702,60,22740,10,"""31""",22860,22920
5521,500702,402204,60,22740,10,"""31""",22920,22980
5521,402204,402900,60,22740,10,"""31""",22980,23040
5521,402900,405300,120,22740,10,"""31""",23040,23160
5521,405300,402800,60,22740,10,"""31""",23160,23220
5521,402800,405100,60,22740,10,"""31""",23220,23280
5521,405100,405902,60,22740,10,"""31""",23280,23340
5521,405902,406500,60,22740,10,"""31""",23340,23400
5521,406500,400601,120,22740,10,"""31""",23400,23520
5521,400601,404300,60,22740,10,"""31""",23520,23580
5521,404300,407401,60,22740,10,"""31""",23580,23640
5521,407401,404103,120,22740,10,"""31""",23640,23760
5521,404103,403104,60,22740,10,"""31""",23760,23820
5521,403104,112101,180,22740,10,"""31""",23820,24000
5521,112101,103001,180,22740,10,"""31""",24000,24180
5521,103001,106501,60,22740,10,"""31""",24180,24240
5521,106501,119006,180,22740,10,"""31""",24240,24420
5521,119006,302501,120,22740,10,"""31""",24420,24540
5521,302501,303001,60,22740,10,"""31""",24540,24600
5521,303001,302201,120,22740,10,"""31""",24600,24720
5521,302201,302001,60,22740,10,"""31""",24720,24780
5521,302001,302100,120,22740,10,"""31""",24780,24900
5522,405300,402800,60,22560,10,"""26""",22560,22620
5522,402800,405100,60,22560,10,"""26""",22620,22680
5522,405100,405902,60,22560,10,"""26""",22680,22740
5522,405902,406500,60,22560,10,"""26""",22740,22800
5522,406500,400601,120,22560,10,"""26""",22800,22920
5522,400601,404300,60,22560,10,"""26""",22920,22980
5522,404300,407401,60,22560,10,"""26""",22980,23040
5522,407401,404103,120,22560,10,"""26""",23040,23160
5522,404103,403104,60,22560,10,"""26""",23160,23220
5522,403104,112101,180,22560,10,"""26""",23220,23400
5522,112101,103001,180,22560,10,"""26""",23400,23580
5522,103001,106501,60,22560,10,"""26""",23580,23640
5522,106501,119006,180,22560,10,"""26""",23640,23820
5522,119006,302501,120,22560,10,"""26""",23820,23940
5522,302501,303001,60,22560,10,"""26""",23940,24000
5522,303001,302201,120,22560,10,"""26""",24000,24120
5522,302201,302001,60,22560,10,"""26""",24120,24180
5522,302001,302100,120,22560,10,"""26""",24180,24300
5522,302100,300302,180,22560,10,"""26""",24300,24480
5522,300302,302402,60,22560,10,"""26""",24480,24540
5522,302402,302702,60,22560,10,"""26""",24540,24600
5522,302702,302300,60,22560,10,"""26""",24600,24660
5523,405300,402800,60,19980,10,"""33""",19980,20040
5523,402800,405100,60,19980,10,"""33""",20040,20100
5523,405100,405902,60,19980,10,"""33""",20100,20160
5523,405902,406500,60,19980,10,"""33""",20160,20220
5523,406500,400601,120,19980,10,"""33""",20220,20340
5523,400601,404300,60,19980,10,"""33""",20340,20400
5523,404300,407401,60,19980,10,"""33""",20400,20460
5523,407401,404103,120,19980,10,"""33""",20460,20580
5523,404103,403104,60,19980,10,"""33""",20580,20640
5523,403104,112101,180,19980,10,"""33""",20640,20820
5523,112101,103001,180,19980,10,"""33""",20820,21000
5523,103001,106501,60,19980,10,"""33""",21000,21060
5523,106501,119006,180,19980,10,"""33""",21060,21240
5523,119006,302501,120,19980,10,"""33""",21240,21360
5523,302501,303001,60,19980,10,"""33""",21360,21420
5523,303001,302201,120,19980,10,"""33""",21420,21540
5523,302201,302001,60,19980,10,"""33""",21540,21600
5523,302001,302100,120,19980,10,"""33""",21600,21720
5523,405300,402800,60,21360,10,"""33""",21360,21420
5523,402800,405100,60,21360,10,"""33""",21420,21480
5523,405100,405902,60,21360,10,"""33""",21480,21540
5523,405902,406500,60,21360,10,"""33""",21540,21600
5523,406500,400601,120,21360,10,"""33""",21600,21720
5523,400601,404300,60,21360,10,"""33""",21720,21780
5523,404300,407401,60,21360,10,"""33""",21780,21840
5523,407401,404103,120,21360,10,"""33""",21840,21960
5523,404103,403104,60,21360,10,"""33""",21960,22020
5523,403104,112101,180,21360,10,"""33""",22020,22200
5523,112101,103001,180,21360,10,"""33""",22200,22380
5523,103001,106501,60,21360,10,"""33""",22380,22440
5523,106501,119006,180,21360,10,"""33""",22440,22620
5523,119006,302501,120,21360,10,"""33""",22620,22740
5523,302501,303001,60,21360,10,"""33""",22740,22800
5523,303001,302201,120,21360,10,"""33""",22800,22920
5523,302201,302001,60,21360,10,"""33""",22920,22980
5523,302001,302100,120,21360,10,"""33""",22980,23100
5523,405300,402800,60,23760,10,"""33""",23760,23820
5523,402800,405100,60,23760,10,"""33""",23820,23880
5523,405100,405902,60,23760,10,"""33""",23880,23940
5523,405902,406500,60,23760,10,"""33""",23940,24000
5523,406500,400601,120,23760,10,"""33""",24000,24120
5523,400601,404300,60,23760,10,"""33""",24120,24180
5523,404300,407401,60,23760,10,"""33""",24180,24240
5523,407401,404103,120,23760,10,"""33""",24240,24360
5523,404103,403104,60,23760,10,"""33""",24360,24420
5523,403104,112101,180,23760,10,"""33""",24420,24600
5523,112101,103001,180,23760,10,"""33""",24600,24780
5523,103001,106501,60,23760,10,"""33""",24780,24840
5523,106501,119006,180,23760,10,"""33""",24840,25020
5523,119006,302501,120,23760,10,"""33""",25020,25140
5523,302501,303001,60,23760,10,"""33""",25140,25200
5523,303001,302201,120,23760,10,"""33""",25200,25320
5523,302201,302001,60,23760,10,"""33""",25320,25380
5523,302001,302100,120,23760,10,"""33""",25380,25500
5524,400200,400402,60,65220,10,"""11""",65220,65280
5524,400402,402002,60,65220,10,"""11""",65280,65340
5524,402002,500702,120,65220,10,"""11""",65340,65460
5524,500702,402204,60,65220,10,"""11""",65460,65520
5524,402204,402900,60,65220,10,"""11""",65520,65580
5524,402900,405300,120,65220,10,"""11""",65580,65700
5524,405300,402800,60,65220,10,"""11""",65700,65760
5524,402800,405100,60,65220,10,"""11""",65760,65820
5524,405100,405902,60,65220,10,"""11""",65820,65880
5524,405902,406500,60,65220,10,"""11""",65880,65940
5524,406500,400601,120,65220,10,"""11""",65940,66060
5524,400601,404300,60,65220,10,"""11""",66060,66120
5524,404300,407401,60,65220,10,"""11""",66120,66180
5524,407401,404103,120,65220,10,"""11""",66180,66300
5524,404103,403104,120,65220,10,"""11""",66300,66420
5524,403104,112101,180,65220,10,"""11""",66420,66600
5525,302100,302002,60,24720,10,"""4""",24720,24780
5525,302002,302202,120,24720,10,"""4""",24780,24900
5525,302202,303002,60,24720,10,"""4""",24900,24960
5525,303002,302502,120,24720,10,"""4""",24960,25080
5525,302502,119005,120,24720,10,"""4""",25080,25200
5525,119005,106503,60,24720,10,"""4""",25200,25260
5525,106503,103005,180,24720,10,"""4""",25260,25440
5525,103005,112107,120,24720,10,"""4""",25440,25560
5525,112107,403102,60,24720,10,"""4""",25560,25620
5525,403102,404102,120,24720,10,"""4""",25620,25740
5525,404102,407402,60,24720,10,"""4""",25740,25800
5525,407402,406604,60,24720,10,"""4""",25800,25860
5525,406604,400602,60,24720,10,"""4""",25860,25920
5525,400602,408300,120,24720,10,"""4""",25920,26040
5525,408300,406501,60,24720,10,"""4""",26040,26100
5525,406501,405901,60,24720,10,"""4""",26100,26160
5525,405901,405101,60,24720,10,"""4""",26160,26220
5525,405101,402900,60,24720,10,"""4""",26220,26280
5525,402900,405300,120,24720,10,"""4""",26280,26400
5525,405300,402800,60,24720,10,"""4""",26400,26460
5525,402800,402203,60,24720,10,"""4""",26460,26520
5525,402203,500701,60,24720,10,"""4""",26520,26580
5525,500701,402001,60,24720,10,"""4""",26580,26640
5525,402001,400401,120,24720,10,"""4""",26640,26760
5525,400401,400200,60,24720,10,"""4""",26760,26820
5525,302100,302002,60,25920,10,"""4""",25920,25980
5525,302002,302202,120,25920,10,"""4""",25980,26100
5525,302202,303002,60,25920,10,"""4""",26100,26160
5525,303002,302502,120,25920,10,"""4""",26160,26280
5525,302502,119005,120,25920,10,"""4""",26280,26400
5525,119005,106503,60,25920,10,"""4""",26400,26460
5525,106503,103005,180,25920,10,"""4""",26460,26640
5525,103005,112107,120,25920,10,"""4""",26640,26760
5525,112107,403102,60,25920,10,"""4""",26760,26820
5525,403102,404102,120,25920,10,"""4""",26820,26940
5525,404102,407402,60,25920,10,"""4""",26940,27000
5525,407402,406604,60,25920,10,"""4""",27000,27060
5525,406604,400602,60,25920,10,"""4""",27060,27120
5525,400602,408300,120,25920,10,"""4""",27120,27240
5525,408300,406501,60,25920,10,"""4""",27240,27300
5525,406501,405901,60,25920,10,"""4""",27300,27360
5525,405901,405101,60,25920,10,"""4""",27360,27420
5525,405101,402900,60,25920,10,"""4""",27420,27480
5525,402900,405300,120,25920,10,"""4""",27480,27600
5525,405300,402800,60,25920,10,"""4""",27600,27660
5525,402800,402203,60,25920,10,"""4""",27660,27720
5525,402203,500701,60,25920,10,"""4""",27720,27780
5525,500701,402001,60,25920,10,"""4""",27780,27840
5525,402001,400401,120,25920,10,"""4""",27840,27960
5525,400401,400200,60,25920,10,"""4""",27960,28020
5525,302100,302002,60,27120,10,"""4""",27120,27180
5525,302002,302202,120,27120,10,"""4""",27180,27300
5525,302202,303002,60,27120,10,"""4""",27300,27360
5525,303002,302502,120,27120,10,"""4""",27360,27480
5525,302502,119005,120,27120,10,"""4""",27480,27600
5525,119005,106503,60,27120,10,"""4""",27600,27660
5525,106503,103005,180,27120,10,"""4""",27660,27840
5525,103005,112107,120,27120,10,"""4""",27840,27960
5525,112107,403102,60,27120,10,"""4""",27960,28020
5525,403102,404102,120,27120,10,"""4""",28020,28140
5525,404102,407402,60,27120,10,"""4""",28140,28200
5525,407402,406604,60,27120,10,"""4""",28200,28260
5525,406604,400602,60,27120,10,"""4""",28260,28320
5525,400602,408300,120,27120,10,"""4""",28320,28440
5525,408300,406501,60,27120,10,"""4""",28440,28500
5525,406501,405901,60,27120,10,"""4""",28500,28560
5525,405901,405101,60,27120,10,"""4""",28560,28620
5525,405101,402900,60,27120,10,"""4""",28620,28680
5525,402900,405300,120,27120,10,"""4""",28680,28800
5525,405300,402800,60,27120,10,"""4""",28800,28860
5525,402800,402203,60,27120,10,"""4""",28860,28920
5525,402203,500701,60,27120,10,"""4""",28920,28980
5525,500701,402001,60,27120,10,"""4""",28980,29040
5525,402001,400401,120,27120,10,"""4""",29040,29160
5525,400401,400200,60,27120,10,"""4""",29160,29220
5525,302100,302002,60,28320,10,"""4""",28320,28380
5525,302002,302202,120,28320,10,"""4""",28380,28500
5525,302202,303002,60,28320,10,"""4""",28500,28560
5525,303002,302502,120,28320,10,"""4""",28560,28680
5525,302502,119005,120,28320,10,"""4""",28680,28800
5525,119005,106503,60,28320,10,"""4""",28800,28860
5525,106503,103005,180,28320,10,"""4""",28860,29040
5525,103005,112107,120,28320,10,"""4""",29040,29160
5525,112107,403102,60,28320,10,"""4""",29160,29220
5525,403102,404102,120,28320,10,"""4""",29220,29340
5525,404102,407402,60,28320,10,"""4""",29340,29400
5525,407402,406604,60,28320,10,"""4""",29400,29460
5525,406604,400602,60,28320,10,"""4""",29460,29520
5525,400602,408300,120,28320,10,"""4""",29520,29640
5525,408300,406501,60,28320,10,"""4""",29640,29700
5525,406501,405901,60,28320,10,"""4""",29700,29760
5525,405901,405101,60,28320,10,"""4""",29760,29820
5525,405101,402900,60,28320,10,"""4""",29820,29880
5525,402900,405300,120,28320,10,"""4""",29880,30000
5525,405300,402800,60,28320,10,"""4""",30000,30060
5525,402800,402203,60,28320,10,"""4""",30060,30120
5525,402203,500701,60,28320,10,"""4""",30120,30180
5525,500701,402001,60,28320,10,"""4""",30180,30240
5525,402001,400401,120,28320,10,"""4""",30240,30360
5525,400401,400200,60,28320,10,"""4""",30360,30420
5525,302100,302002,60,29520,10,"""4""",29520,29580
5525,302002,302202,120,29520,10,"""4""",29580,29700
5525,302202,303002,60,29520,10,"""4""",29700,29760
5525,303002,302502,120,29520,10,"""4""",29760,29880
5525,302502,119005,120,29520,10,"""4""",29880,30000
5525,119005,106503,60,29520,10,"""4""",30000,30060
5525,106503,103005,180,29520,10,"""4""",30060,30240
5525,103005,112107,120,29520,10,"""4""",30240,30360
5525,112107,403102,60,29520,10,"""4""",30360,30420
5525,403102,404102,120,29520,10,"""4""",30420,30540
5525,404102,407402,60,29520,10,"""4""",30540,30600
5525,407402,406604,60,29520,10,"""4""",30600,30660
5525,406604,400602,60,29520,10,"""4""",30660,30720
5525,400602,408300,120,29520,10,"""4""",30720,30840
5525,408300,406501,60,29520,10,"""4""",30840,30900
5525,406501,405901,60,29520,10,"""4""",30900,30960
5525,405901,405101,60,29520,10,"""4""",30960,31020
5525,405101,402900,60,29520,10,"""4""",31020,31080
5525,402900,405300,120,29520,10,"""4""",31080,31200
5525,405300,402800,60,29520,10,"""4""",31200,31260
5525,402800,402203,60,29520,10,"""4""",31260,31320
5525,402203,500701,60,29520,10,"""4""",31320,31380
5525,500701,402001,60,29520,10,"""4""",31380,31440
5525,402001,400401,120,29520,10,"""4""",31440,31560
5525,400401,400200,60,29520,10,"""4""",31560,31620
5525,302100,302002,60,64320,10,"""4""",64320,64380
5525,302002,302202,120,64320,10,"""4""",64380,64500
5525,302202,303002,60,64320,10,"""4""",64500,64560
5525,303002,302502,120,64320,10,"""4""",64560,64680
5525,302502,119005,120,64320,10,"""4""",64680,64800
5525,119005,106503,60,64320,10,"""4""",64800,64860
5525,106503,103005,180,64320,10,"""4""",64860,65040
5525,103005,112107,120,64320,10,"""4""",65040,65160
5525,112107,403102,60,64320,10,"""4""",65160,65220
5525,403102,404102,120,64320,10,"""4""",65220,65340
5525,404102,407402,60,64320,10,"""4""",65340,65400
5525,407402,406604,60,64320,10,"""4""",65400,65460
5525,406604,400602,60,64320,10,"""4""",65460,65520
5525,400602,408300,120,64320,10,"""4""",65520,65640
5525,408300,406501,60,64320,10,"""4""",65640,65700
5525,406501,405901,60,64320,10,"""4""",65700,65760
5525,405901,405101,60,64320,10,"""4""",65760,65820
5525,405101,402900,60,64320,10,"""4""",65820,65880
5525,402900,405300,120,64320,10,"""4""",65880,66000
5525,405300,402800,60,64320,10,"""4""",66000,66060
5525,402800,402203,60,64320,10,"""4""",66060,66120
5525,402203,500701,60,64320,10,"""4""",66120,66180
5525,500701,402001,60,64320,10,"""4""",66180,66240
5525,402001,400401,120,64320,10,"""4""",66240,66360
5525,400401,400200,60,64320,10,"""4""",66360,66420
5525,302100,302002,60,70200,10,"""4""",70200,70260
5525,302002,302202,120,70200,10,"""4""",70260,70380
5525,302202,303002,60,70200,10,"""4""",70380,70440
5525,303002,302502,120,70200,10,"""4""",70440,70560
5525,302502,119005,120,70200,10,"""4""",70560,70680
5525,119005,106503,60,70200,10,"""4""",70680,70740
5525,106503,103005,180,70200,10,"""4""",70740,70920
5525,103005,112107,120,70200,10,"""4""",70920,71040
5525,112107,403102,60,70200,10,"""4""",71040,71100
5525,403102,404102,120,70200,10,"""4""",71100,71220
5525,404102,407402,60,70200,10,"""4""",71220,71280
5525,407402,406604,60,70200,10,"""4""",71280,71340
5525,406604,400602,60,70200,10,"""4""",71340,71400
5525,400602,408300,120,70200,10,"""4""",71400,71520
5525,408300,406501,60,70200,10,"""4""",71520,71580
5525,406501,405901,60,70200,10,"""4""",71580,71640
5525,405901,405101,60,70200,10,"""4""",71640,71700
5525,405101,402900,60,70200,10,"""4""",71700,71760
5525,402900,405300,120,70200,10,"""4""",71760,71880
5525,405300,402800,60,70200,10,"""4""",71880,71940
5525,402800,402203,60,70200,10,"""4""",71940,72000
5525,402203,500701,60,70200,10,"""4""",72000,72060
5525,500701,402001,60,70200,10,"""4""",72060,72120
5525,402001,400401,120,70200,10,"""4""",72120,72240
5525,400401,400200,60,70200,10,"""4""",72240,72300
5526,302100,302002,60,21360,10,"""4""",21360,21420
5526,302002,302202,60,21360,10,"""4""",21420,21480
5526,302202,303002,60,21360,10,"""4""",21480,21540
5526,303002,302502,120,21360,10,"""4""",21540,21660
5526,302502,119005,120,21360,10,"""4""",21660,21780
5526,119005,106503,60,21360,10,"""4""",21780,21840
5526,106503,103005,120,21360,10,"""4""",21840,21960
5526,103005,112107,120,21360,10,"""4""",21960,22080
5526,112107,403102,60,21360,10,"""4""",22080,22140
5526,403102,404102,60,21360,10,"""4""",22140,22200
5526,404102,407402,60,21360,10,"""4""",22200,22260
5526,407402,406604,60,21360,10,"""4""",22260,22320
5526,406604,400602,60,21360,10,"""4""",22320,22380
5526,400602,408300,120,21360,10,"""4""",22380,22500
5526,408300,406501,60,21360,10,"""4""",22500,22560
5526,406501,405901,60,21360,10,"""4""",22560,22620
5526,405901,405101,60,21360,10,"""4""",22620,22680
5526,405101,402900,60,21360,10,"""4""",22680,22740
5526,402900,405300,120,21360,10,"""4""",22740,22860
5526,405300,402800,60,21360,10,"""4""",22860,22920
5526,402800,402203,60,21360,10,"""4""",22920,22980
5526,402203,500701,60,21360,10,"""4""",22980,23040
5526,500701,402001,60,21360,10,"""4""",23040,23100
5526,402001,400401,120,21360,10,"""4""",23100,23220
5526,400401,400200,60,21360,10,"""4""",23220,23280
5526,302100,302002,60,22440,10,"""4""",22440,22500
5526,302002,302202,60,22440,10,"""4""",22500,22560
5526,302202,303002,60,22440,10,"""4""",22560,22620
5526,303002,302502,120,22440,10,"""4""",22620,22740
5526,302502,119005,120,22440,10,"""4""",22740,22860
5526,119005,106503,60,22440,10,"""4""",22860,22920
5526,106503,103005,120,22440,10,"""4""",22920,23040
5526,103005,112107,120,22440,10,"""4""",23040,23160
5526,112107,403102,60,22440,10,"""4""",23160,23220
5526,403102,404102,60,22440,10,"""4""",23220,23280
5526,404102,407402,60,22440,10,"""4""",23280,23340
5526,407402,406604,60,22440,10,"""4""",23340,23400
5526,406604,400602,60,22440,10,"""4""",23400,23460
5526,400602,408300,120,22440,10,"""4""",23460,23580
5526,408300,406501,60,22440,10,"""4""",23580,23640
5526,406501,405901,60,22440,10,"""4""",23640,23700
5526,405901,405101,60,22440,10,"""4""",23700,23760
5526,405101,402900,60,22440,10,"""4""",23760,23820
5526,402900,405300,120,22440,10,"""4""",23820,23940
5526,405300,402800,60,22440,10,"""4""",23940,24000
5526,402800,402203,60,22440,10,"""4""",24000,24060
5526,402203,500701,60,22440,10,"""4""",24060,24120
5526,500701,402001,60,22440,10,"""4""",24120,24180
5526,402001,400401,120,22440,10,"""4""",24180,24300
5526,400401,400200,60,22440,10,"""4""",24300,24360
5526,302100,302002,60,23640,10,"""4""",23640,23700
5526,302002,302202,60,23640,10,"""4""",23700,23760
5526,302202,303002,60,23640,10,"""4""",23760,23820
5526,303002,302502,120,23640,10,"""4""",23820,23940
5526,302502,119005,120,23640,10,"""4""",23940,24060
5526,119005,106503,60,23640,10,"""4""",24060,24120
5526,106503,103005,120,23640,10,"""4""",24120,24240
5526,103005,112107,120,23640,10,"""4""",24240,24360
5526,112107,403102,60,23640,10,"""4""",24360,24420
5526,403102,404102,60,23640,10,"""4""",24420,24480
5526,404102,407402,60,23640,10,"""4""",24480,24540
5526,407402,406604,60,23640,10,"""4""",24540,24600
5526,406604,400602,60,23640,10,"""4""",24600,24660
5526,400602,408300,120,23640,10,"""4""",24660,24780
5526,408300,406501,60,23640,10,"""4""",24780,24840
5526,406501,405901,60,23640,10,"""4""",24840,24900
5526,405901,405101,60,23640,10,"""4""",24900,24960
5526,405101,402900,60,23640,10,"""4""",24960,25020
5526,402900,405300,120,23640,10,"""4""",25020,25140
5526,405300,402800,60,23640,10,"""4""",25140,25200
5526,402800,402203,60,23640,10,"""4""",25200,25260
5526,402203,500701,60,23640,10,"""4""",25260,25320
5526,500701,402001,60,23640,10,"""4""",25320,25380
5526,402001,400401,120,23640,10,"""4""",25380,25500
5526,400401,400200,60,23640,10,"""4""",25500,25560
5527,302100,302002,60,20220,10,"""4""",20220,20280
5527,302002,302202,60,20220,10,"""4""",20280,20340
5527,302202,303002,60,20220,10,"""4""",20340,20400
5527,303002,302502,60,20220,10,"""4""",20400,20460
5527,302502,119005,120,20220,10,"""4""",20460,20580
5527,119005,106503,60,20220,10,"""4""",20580,20640
5527,106503,103005,120,20220,10,"""4""",20640,20760
5527,103005,112107,120,20220,10,"""4""",20760,20880
5527,112107,403102,60,20220,10,"""4""",20880,20940
5527,403102,404102,60,20220,10,"""4""",20940,21000
5527,404102,407402,60,20220,10,"""4""",21000,21060
5527,407402,406604,60,20220,10,"""4""",21060,21120
5527,406604,400602,60,20220,10,"""4""",21120,21180
5527,400602,408300,60,20220,10,"""4""",21180,21240
5527,408300,406501,60,20220,10,"""4""",21240,21300
5527,406501,405901,60,20220,10,"""4""",21300,21360
5527,405901,405101,60,20220,10,"""4""",21360,21420
5527,405101,402900,60,20220,10,"""4""",21420,21480
5527,402900,405300,120,20220,10,"""4""",21480,21600
5527,405300,402800,60,20220,10,"""4""",21600,21660
5527,402800,402203,60,20220,10,"""4""",21660,21720
5527,402203,500701,60,20220,10,"""4""",21720,21780
5527,500701,402001,60,20220,10,"""4""",21780,21840
5527,402001,400401,60,20220,10,"""4""",21840,21900
5527,400401,400200,60,20220,10,"""4""",21900,21960
5528,302100,302002,60,30720,10,"""6""",30720,30780
5528,302002,302202,120,30720,10,"""6""",30780,30900
5528,302202,303002,60,30720,10,"""6""",30900,30960
5528,303002,302502,120,30720,10,"""6""",30960,31080
5528,302502,119005,120,30720,10,"""6""",31080,31200
5528,119005,106503,60,30720,10,"""6""",31200,31260
5528,106503,103005,180,30720,10,"""6""",31260,31440
5528,103005,112107,120,30720,10,"""6""",31440,31560
5528,112107,403102,60,30720,10,"""6""",31560,31620
5528,403102,404102,120,30720,10,"""6""",31620,31740
5528,404102,407402,60,30720,10,"""6""",31740,31800
5528,407402,406604,60,30720,10,"""6""",31800,31860
5528,406604,400602,60,30720,10,"""6""",31860,31920
5528,400602,408300,120,30720,10,"""6""",31920,32040
5528,408300,406501,60,30720,10,"""6""",32040,32100
5528,406501,405901,60,30720,10,"""6""",32100,32160
5528,405901,405101,60,30720,10,"""6""",32160,32220
5528,405101,402900,60,30720,10,"""6""",32220,32280
5528,402900,405300,120,30720,10,"""6""",32280,32400
5528,405300,402800,60,30720,10,"""6""",32400,32460
5528,402800,402202,120,30720,10,"""6""",32460,32580
5528,402202,33703,60,30720,10,"""6""",32580,32640
5528,33703,400200,180,30720,10,"""6""",32640,32820
5528,302100,302002,60,31920,10,"""6""",31920,31980
5528,302002,302202,120,31920,10,"""6""",31980,32100
5528,302202,303002,60,31920,10,"""6""",32100,32160
5528,303002,302502,120,31920,10,"""6""",32160,32280
5528,302502,119005,120,31920,10,"""6""",32280,32400
5528,119005,106503,60,31920,10,"""6""",32400,32460
5528,106503,103005,180,31920,10,"""6""",32460,32640
5528,103005,112107,120,31920,10,"""6""",32640,32760
5528,112107,403102,60,31920,10,"""6""",32760,32820
5528,403102,404102,120,31920,10,"""6""",32820,32940
5528,404102,407402,60,31920,10,"""6""",32940,33000
5528,407402,406604,60,31920,10,"""6""",33000,33060
5528,406604,400602,60,31920,10,"""6""",33060,33120
5528,400602,408300,120,31920,10,"""6""",33120,33240
5528,408300,406501,60,31920,10,"""6""",33240,33300
5528,406501,405901,60,31920,10,"""6""",33300,33360
5528,405901,405101,60,31920,10,"""6""",33360,33420
5528,405101,402900,60,31920,10,"""6""",33420,33480
5528,402900,405300,120,31920,10,"""6""",33480,33600
5528,405300,402800,60,31920,10,"""6""",33600,33660
5528,402800,402202,120,31920,10,"""6""",33660,33780
5528,402202,33703,60,31920,10,"""6""",33780,33840
5528,33703,400200,180,31920,10,"""6""",33840,34020
5528,302100,302002,60,33120,10,"""6""",33120,33180
5528,302002,302202,120,33120,10,"""6""",33180,33300
5528,302202,303002,60,33120,10,"""6""",33300,33360
5528,303002,302502,120,33120,10,"""6""",33360,33480
5528,302502,119005,120,33120,10,"""6""",33480,33600
5528,119005,106503,60,33120,10,"""6""",33600,33660
5528,106503,103005,180,33120,10,"""6""",33660,33840
5528,103005,112107,120,33120,10,"""6""",33840,33960
5528,112107,403102,60,33120,10,"""6""",33960,34020
5528,403102,404102,120,33120,10,"""6""",34020,34140
5528,404102,407402,60,33120,10,"""6""",34140,34200
5528,407402,406604,60,33120,10,"""6""",34200,34260
5528,406604,400602,60,33120,10,"""6""",34260,34320
5528,400602,408300,120,33120,10,"""6""",34320,34440
5528,408300,406501,60,33120,10,"""6""",34440,34500
5528,406501,405901,60,33120,10,"""6""",34500,34560
5528,405901,405101,60,33120,10,"""6""",34560,34620
5528,405101,402900,60,33120,10,"""6""",34620,34680
5528,402900,405300,120,33120,10,"""6""",34680,34800
5528,405300,402800,60,33120,10,"""6""",34800,34860
5528,402800,402202,120,33120,10,"""6""",34860,34980
5528,402202,33703,60,33120,10,"""6""",34980,35040
5528,33703,400200,180,33120,10,"""6""",35040,35220
5528,302100,302002,60,34320,10,"""6""",34320,34380
5528,302002,302202,120,34320,10,"""6""",34380,34500
5528,302202,303002,60,34320,10,"""6""",34500,34560
5528,303002,302502,120,34320,10,"""6""",34560,34680
5528,302502,119005,120,34320,10,"""6""",34680,34800
5528,119005,106503,60,34320,10,"""6""",34800,34860
5528,106503,103005,180,34320,10,"""6""",34860,35040
5528,103005,112107,120,34320,10,"""6""",35040,35160
5528,112107,403102,60,34320,10,"""6""",35160,35220
5528,403102,404102,120,34320,10,"""6""",35220,35340
5528,404102,407402,60,34320,10,"""6""",35340,35400
5528,407402,406604,60,34320,10,"""6""",35400,35460
5528,406604,400602,60,34320,10,"""6""",35460,35520
5528,400602,408300,120,34320,10,"""6""",35520,35640
5528,408300,406501,60,34320,10,"""6""",35640,35700
5528,406501,405901,60,34320,10,"""6""",35700,35760
5528,405901,405101,60,34320,10,"""6""",35760,35820
5528,405101,402900,60,34320,10,"""6""",35820,35880
5528,402900,405300,120,34320,10,"""6""",35880,36000
5528,405300,402800,60,34320,10,"""6""",36000,36060
5528,402800,402202,120,34320,10,"""6""",36060,36180
5528,402202,33703,60,34320,10,"""6""",36180,36240
5528,33703,400200,180,34320,10,"""6""",36240,36420
5528,302100,302002,60,35520,10,"""6""",35520,35580
5528,302002,302202,120,35520,10,"""6""",35580,35700
5528,302202,303002,60,35520,10,"""6""",35700,35760
5528,303002,302502,120,35520,10,"""6""",35760,35880
5528,302502,119005,120,35520,10,"""6""",35880,36000
5528,119005,106503,60,35520,10,"""6""",36000,36060
5528,106503,103005,180,35520,10,"""6""",36060,36240
5528,103005,112107,120,35520,10,"""6""",36240,36360
5528,112107,403102,60,35520,10,"""6""",36360,36420
5528,403102,404102,120,35520,10,"""6""",36420,36540
5528,404102,407402,60,35520,10,"""6""",36540,36600
5528,407402,406604,60,35520,10,"""6""",36600,36660
5528,406604,400602,60,35520,10,"""6""",36660,36720
5528,400602,408300,120,35520,10,"""6""",36720,36840
5528,408300,406501,60,35520,10,"""6""",36840,36900
5528,406501,405901,60,35520,10,"""6""",36900,36960
5528,405901,405101,60,35520,10,"""6""",36960,37020
5528,405101,402900,60,35520,10,"""6""",37020,37080
5528,402900,405300,120,35520,10,"""6""",37080,37200
5528,405300,402800,60,35520,10,"""6""",37200,37260
5528,402800,402202,120,35520,10,"""6""",37260,37380
5528,402202,33703,60,35520,10,"""6""",37380,37440
5528,33703,400200,180,35520,10,"""6""",37440,37620
5528,302100,302002,60,36720,10,"""6""",36720,36780
5528,302002,302202,120,36720,10,"""6""",36780,36900
5528,302202,303002,60,36720,10,"""6""",36900,36960
5528,303002,302502,120,36720,10,"""6""",36960,37080
5528,302502,119005,120,36720,10,"""6""",37080,37200
5528,119005,106503,60,36720,10,"""6""",37200,37260
5528,106503,103005,180,36720,10,"""6""",37260,37440
5528,103005,112107,120,36720,10,"""6""",37440,37560
5528,112107,403102,60,36720,10,"""6""",37560,37620
5528,403102,404102,120,36720,10,"""6""",37620,37740
5528,404102,407402,60,36720,10,"""6""",37740,37800
5528,407402,406604,60,36720,10,"""6""",37800,37860
5528,406604,400602,60,36720,10,"""6""",37860,37920
5528,400602,408300,120,36720,10,"""6""",37920,38040
5528,408300,406501,60,36720,10,"""6""",38040,38100
5528,406501,405901,60,36720,10,"""6""",38100,38160
5528,405901,405101,60,36720,10,"""6""",38160,38220
5528,405101,402900,60,36720,10,"""6""",38220,38280
5528,402900,405300,120,36720,10,"""6""",38280,38400
5528,405300,402800,60,36720,10,"""6""",38400,38460
5528,402800,402202,120,36720,10,"""6""",38460,38580
5528,402202,33703,60,36720,10,"""6""",38580,38640
5528,33703,400200,180,36720,10,"""6""",38640,38820
5528,302100,302002,60,37920,10,"""6""",37920,37980
5528,302002,302202,120,37920,10,"""6""",37980,38100
5528,302202,303002,60,37920,10,"""6""",38100,38160
5528,303002,302502,120,37920,10,"""6""",38160,38280
5528,302502,119005,120,37920,10,"""6""",38280,38400
5528,119005,106503,60,37920,10,"""6""",38400,38460
5528,106503,103005,180,37920,10,"""6""",38460,38640
5528,103005,112107,120,37920,10,"""6""",38640,38760
5528,112107,403102,60,37920,10,"""6""",38760,38820
5528,403102,404102,120,37920,10,"""6""",38820,38940
5528,404102,407402,60,37920,10,"""6""",38940,39000
5528,407402,406604,60,37920,10,"""6""",39000,39060
5528,406604,400602,60,37920,10,"""6""",39060,39120
5528,400602,408300,120,37920,10,"""6""",39120,39240
5528,408300,406501,60,37920,10,"""6""",39240,39300
5528,406501,405901,60,37920,10,"""6""",39300,39360
5528,405901,405101,60,37920,10,"""6""",39360,39420
5528,405101,402900,60,37920,10,"""6""",39420,39480
5528,402900,405300,120,37920,10,"""6""",39480,39600
5528,405300,402800,60,37920,10,"""6""",39600,39660
5528,402800,402202,120,37920,10,"""6""",39660,39780
5528,402202,33703,60,37920,10,"""6""",39780,39840
5528,33703,400200,180,37920,10,"""6""",39840,40020
5528,302100,302002,60,39120,10,"""6""",39120,39180
5528,302002,302202,120,39120,10,"""6""",39180,39300
5528,302202,303002,60,39120,10,"""6""",39300,39360
5528,303002,302502,120,39120,10,"""6""",39360,39480
5528,302502,119005,120,39120,10,"""6""",39480,39600
5528,119005,106503,60,39120,10,"""6""",39600,39660
5528,106503,103005,180,39120,10,"""6""",39660,39840
5528,103005,112107,120,39120,10,"""6""",39840,39960
5528,112107,403102,60,39120,10,"""6""",39960,40020
5528,403102,404102,120,39120,10,"""6""",40020,40140
5528,404102,407402,60,39120,10,"""6""",40140,40200
5528,407402,406604,60,39120,10,"""6""",40200,40260
5528,406604,400602,60,39120,10,"""6""",40260,40320
5528,400602,408300,120,39120,10,"""6""",40320,40440
5528,408300,406501,60,39120,10,"""6""",40440,40500
5528,406501,405901,60,39120,10,"""6""",40500,40560
5528,405901,405101,60,39120,10,"""6""",40560,40620
5528,405101,402900,60,39120,10,"""6""",40620,40680
5528,402900,405300,120,39120,10,"""6""",40680,40800
5528,405300,402800,60,39120,10,"""6""",40800,40860
5528,402800,402202,120,39120,10,"""6""",40860,40980
5528,402202,33703,60,39120,10,"""6""",40980,41040
5528,33703,400200,180,39120,10,"""6""",41040,41220
5528,302100,302002,60,40320,10,"""6""",40320,40380
5528,302002,302202,120,40320,10,"""6""",40380,40500
5528,302202,303002,60,40320,10,"""6""",40500,40560
5528,303002,302502,120,40320,10,"""6""",40560,40680
5528,302502,119005,120,40320,10,"""6""",40680,40800
5528,119005,106503,60,40320,10,"""6""",40800,40860
5528,106503,103005,180,40320,10,"""6""",40860,41040
5528,103005,112107,120,40320,10,"""6""",41040,41160
5528,112107,403102,60,40320,10,"""6""",41160,41220
5528,403102,404102,120,40320,10,"""6""",41220,41340
5528,404102,407402,60,40320,10,"""6""",41340,41400
5528,407402,406604,60,40320,10,"""6""",41400,41460
5528,406604,400602,60,40320,10,"""6""",41460,41520
5528,400602,408300,120,40320,10,"""6""",41520,41640
5528,408300,406501,60,40320,10,"""6""",41640,41700
5528,406501,405901,60,40320,10,"""6""",41700,41760
5528,405901,405101,60,40320,10,"""6""",41760,41820
5528,405101,402900,60,40320,10,"""6""",41820,41880
5528,402900,405300,120,40320,10,"""6""",41880,42000
5528,405300,402800,60,40320,10,"""6""",42000,42060
5528,402800,402202,120,40320,10,"""6""",42060,42180
5528,402202,33703,60,40320,10,"""6""",42180,42240
5528,33703,400200,180,40320,10,"""6""",42240,42420
5528,302100,302002,60,41520,10,"""6""",41520,41580
5528,302002,302202,120,41520,10,"""6""",41580,41700
5528,302202,303002,60,41520,10,"""6""",41700,41760
5528,303002,302502,120,41520,10,"""6""",41760,41880
5528,302502,119005,120,41520,10,"""6""",41880,42000
5528,119005,106503,60,41520,10,"""6""",42000,42060
5528,106503,103005,180,41520,10,"""6""",42060,42240
5528,103005,112107,120,41520,10,"""6""",42240,42360
5528,112107,403102,60,41520,10,"""6""",42360,42420
5528,403102,404102,120,41520,10,"""6""",42420,42540
5528,404102,407402,60,41520,10,"""6""",42540,42600
5528,407402,406604,60,41520,10,"""6""",42600,42660
5528,406604,400602,60,41520,10,"""6""",42660,42720
5528,400602,408300,120,41520,10,"""6""",42720,42840
5528,408300,406501,60,41520,10,"""6""",42840,42900
5528,406501,405901,60,41520,10,"""6""",42900,42960
5528,405901,405101,60,41520,10,"""6""",42960,43020
5528,405101,402900,60,41520,10,"""6""",43020,43080
5528,402900,405300,120,41520,10,"""6""",43080,43200
5528,405300,402800,60,41520,10,"""6""",43200,43260
5528,402800,402202,120,41520,10,"""6""",43260,43380
5528,402202,33703,60,41520,10,"""6""",43380,43440
5528,33703,400200,180,41520,10,"""6""",43440,43620
5528,302100,302002,60,42720,10,"""6""",42720,42780
5528,302002,302202,120,42720,10,"""6""",42780,42900
5528,302202,303002,60,42720,10,"""6""",42900,42960
5528,303002,302502,120,42720,10,"""6""",42960,43080
5528,302502,119005,120,42720,10,"""6""",43080,43200
5528,119005,106503,60,42720,10,"""6""",43200,43260
5528,106503,103005,180,42720,10,"""6""",43260,43440
5528,103005,112107,120,42720,10,"""6""",43440,43560
5528,112107,403102,60,42720,10,"""6""",43560,43620
5528,403102,404102,120,42720,10,"""6""",43620,43740
5528,404102,407402,60,42720,10,"""6""",43740,43800
5528,407402,406604,60,42720,10,"""6""",43800,43860
5528,406604,400602,60,42720,10,"""6""",43860,43920
5528,400602,408300,120,42720,10,"""6""",43920,44040
5528,408300,406501,60,42720,10,"""6""",44040,44100
5528,406501,405901,60,42720,10,"""6""",44100,44160
5528,405901,405101,60,42720,10,"""6""",44160,44220
5528,405101,402900,60,42720,10,"""6""",44220,44280
5528,402900,405300,120,42720,10,"""6""",44280,44400
5528,405300,402800,60,42720,10,"""6""",44400,44460
5528,402800,402202,120,42720,10,"""6""",44460,44580
5528,402202,33703,60,42720,10,"""6""",44580,44640
5528,33703,400200,180,42720,10,"""6""",44640,44820
5528,302100,302002,60,43920,10,"""6""",43920,43980
5528,302002,302202,120,43920,10,"""6""",43980,44100
5528,302202,303002,60,43920,10,"""6""",44100,44160
5528,303002,302502,120,43920,10,"""6""",44160,44280
5528,302502,119005,120,43920,10,"""6""",44280,44400
5528,119005,106503,60,43920,10,"""6""",44400,44460
5528,106503,103005,180,43920,10,"""6""",44460,44640
5528,103005,112107,120,43920,10,"""6""",44640,44760
5528,112107,403102,60,43920,10,"""6""",44760,44820
5528,403102,404102,120,43920,10,"""6""",44820,44940
5528,404102,407402,60,43920,10,"""6""",44940,45000
5528,407402,406604,60,43920,10,"""6""",45000,45060
5528,406604,400602,60,43920,10,"""6""",45060,45120
5528,400602,408300,120,43920,10,"""6""",45120,45240
5528,408300,406501,60,43920,10,"""6""",45240,45300
5528,406501,405901,60,43920,10,"""6""",45300,45360
5528,405901,405101,60,43920,10,"""6""",45360,45420
5528,405101,402900,60,43920,10,"""6""",45420,45480
5528,402900,405300,120,43920,10,"""6""",45480,45600
5528,405300,402800,60,43920,10,"""6""",45600,45660
5528,402800,402202,120,43920,10,"""6""",45660,45780
5528,402202,33703,60,43920,10,"""6""",45780,45840
5528,33703,400200,180,43920,10,"""6""",45840,46020
5528,302100,302002,60,45120,10,"""6""",45120,45180
5528,302002,302202,120,45120,10,"""6""",45180,45300
5528,302202,303002,60,45120,10,"""6""",45300,45360
5528,303002,302502,120,45120,10,"""6""",45360,45480
5528,302502,119005,120,45120,10,"""6""",45480,45600
5528,119005,106503,60,45120,10,"""6""",45600,45660
5528,106503,103005,180,45120,10,"""6""",45660,45840
5528,103005,112107,120,45120,10,"""6""",45840,45960
5528,112107,403102,60,45120,10,"""6""",45960,46020
5528,403102,404102,120,45120,10,"""6""",46020,46140
5528,404102,407402,60,45120,10,"""6""",46140,46200
5528,407402,406604,60,45120,10,"""6""",46200,46260
5528,406604,400602,60,45120,10,"""6""",46260,46320
5528,400602,408300,120,45120,10,"""6""",46320,46440
5528,408300,406501,60,45120,10,"""6""",46440,46500
5528,406501,405901,60,45120,10,"""6""",46500,46560
5528,405901,405101,60,45120,10,"""6""",46560,46620
5528,405101,402900,60,45120,10,"""6""",46620,46680
5528,402900,405300,120,45120,10,"""6""",46680,46800
5528,405300,402800,60,45120,10,"""6""",46800,46860
5528,402800,402202,120,45120,10,"""6""",46860,46980
5528,402202,33703,60,45120,10,"""6""",46980,47040
5528,33703,400200,180,45120,10,"""6""",47040,47220
5528,302100,302002,60,46320,10,"""6""",46320,46380
5528,302002,302202,120,46320,10,"""6""",46380,46500
5528,302202,303002,60,46320,10,"""6""",46500,46560
5528,303002,302502,120,46320,10,"""6""",46560,46680
5528,302502,119005,120,46320,10,"""6""",46680,46800
5528,119005,106503,60,46320,10,"""6""",46800,46860
5528,106503,103005,180,46320,10,"""6""",46860,47040
5528,103005,112107,120,46320,10,"""6""",47040,47160
5528,112107,403102,60,46320,10,"""6""",47160,47220
5528,403102,404102,120,46320,10,"""6""",47220,47340
5528,404102,407402,60,46320,10,"""6""",47340,47400
5528,407402,406604,60,46320,10,"""6""",47400,47460
5528,406604,400602,60,46320,10,"""6""",47460,47520
5528,400602,408300,120,46320,10,"""6""",47520,47640
5528,408300,406501,60,46320,10,"""6""",47640,47700
5528,406501,405901,60,46320,10,"""6""",47700,47760
5528,405901,405101,60,46320,10,"""6""",47760,47820
5528,405101,402900,60,46320,10,"""6""",47820,47880
5528,402900,405300,120,46320,10,"""6""",47880,48000
5528,405300,402800,60,46320,10,"""6""",48000,48060
5528,402800,402202,120,46320,10,"""6""",48060,48180
5528,402202,33703,60,46320,10,"""6""",48180,48240
5528,33703,400200,180,46320,10,"""6""",48240,48420
5528,302100,302002,60,47520,10,"""6""",47520,47580
5528,302002,302202,120,47520,10,"""6""",47580,47700
5528,302202,303002,60,47520,10,"""6""",47700,47760
5528,303002,302502,120,47520,10,"""6""",47760,47880
5528,302502,119005,120,47520,10,"""6""",47880,48000
5528,119005,106503,60,47520,10,"""6""",48000,48060
5528,106503,103005,180,47520,10,"""6""",48060,48240
5528,103005,112107,120,47520,10,"""6""",48240,48360
5528,112107,403102,60,47520,10,"""6""",48360,48420
5528,403102,404102,120,47520,10,"""6""",48420,48540
5528,404102,407402,60,47520,10,"""6""",48540,48600
5528,407402,406604,60,47520,10,"""6""",48600,48660
5528,406604,400602,60,47520,10,"""6""",48660,48720
5528,400602,408300,120,47520,10,"""6""",48720,48840
5528,408300,406501,60,47520,10,"""6""",48840,48900
5528,406501,405901,60,47520,10,"""6""",48900,48960
5528,405901,405101,60,47520,10,"""6""",48960,49020
5528,405101,402900,60,47520,10,"""6""",49020,49080
5528,402900,405300,120,47520,10,"""6""",49080,49200
5528,405300,402800,60,47520,10,"""6""",49200,49260
5528,402800,402202,120,47520,10,"""6""",49260,49380
5528,402202,33703,60,47520,10,"""6""",49380,49440
5528,33703,400200,180,47520,10,"""6""",49440,49620
5528,302100,302002,60,48720,10,"""6""",48720,48780
5528,302002,302202,120,48720,10,"""6""",48780,48900
5528,302202,303002,60,48720,10,"""6""",48900,48960
5528,303002,302502,120,48720,10,"""6""",48960,49080
5528,302502,119005,120,48720,10,"""6""",49080,49200
5528,119005,106503,60,48720,10,"""6""",49200,49260
5528,106503,103005,180,48720,10,"""6""",49260,49440
5528,103005,112107,120,48720,10,"""6""",49440,49560
5528,112107,403102,60,48720,10,"""6""",49560,49620
5528,403102,404102,120,48720,10,"""6""",49620,49740
5528,404102,407402,60,48720,10,"""6""",49740,49800
5528,407402,406604,60,48720,10,"""6""",49800,49860
5528,406604,400602,60,48720,10,"""6""",49860,49920
5528,400602,408300,120,48720,10,"""6""",49920,50040
5528,408300,406501,60,48720,10,"""6""",50040,50100
5528,406501,405901,60,48720,10,"""6""",50100,50160
5528,405901,405101,60,48720,10,"""6""",50160,50220
5528,405101,402900,60,48720,10,"""6""",50220,50280
5528,402900,405300,120,48720,10,"""6""",50280,50400
5528,405300,402800,60,48720,10,"""6""",50400,50460
5528,402800,402202,120,48720,10,"""6""",50460,50580
5528,402202,33703,60,48720,10,"""6""",50580,50640
5528,33703,400200,180,48720,10,"""6""",50640,50820
5528,302100,302002,60,49920,10,"""6""",49920,49980
5528,302002,302202,120,49920,10,"""6""",49980,50100
5528,302202,303002,60,49920,10,"""6""",50100,50160
5528,303002,302502,120,49920,10,"""6""",50160,50280
5528,302502,119005,120,49920,10,"""6""",50280,50400
5528,119005,106503,60,49920,10,"""6""",50400,50460
5528,106503,103005,180,49920,10,"""6""",50460,50640
5528,103005,112107,120,49920,10,"""6""",50640,50760
5528,112107,403102,60,49920,10,"""6""",50760,50820
5528,403102,404102,120,49920,10,"""6""",50820,50940
5528,404102,407402,60,49920,10,"""6""",50940,51000
5528,407402,406604,60,49920,10,"""6""",51000,51060
5528,406604,400602,60,49920,10,"""6""",51060,51120
5528,400602,408300,120,49920,10,"""6""",51120,51240
5528,408300,406501,60,49920,10,"""6""",51240,51300
5528,406501,405901,60,49920,10,"""6""",51300,51360
5528,405901,405101,60,49920,10,"""6""",51360,51420
5528,405101,402900,60,49920,10,"""6""",51420,51480
5528,402900,405300,120,49920,10,"""6""",51480,51600
5528,405300,402800,60,49920,10,"""6""",51600,51660
5528,402800,402202,120,49920,10,"""6""",51660,51780
5528,402202,33703,60,49920,10,"""6""",51780,51840
5528,33703,400200,180,49920,10,"""6""",51840,52020
5528,302100,302002,60,51120,10,"""6""",51120,51180
5528,302002,302202,120,51120,10,"""6""",51180,51300
5528,302202,303002,60,51120,10,"""6""",51300,51360
5528,303002,302502,120,51120,10,"""6""",51360,51480
5528,302502,119005,120,51120,10,"""6""",51480,51600
5528,119005,106503,60,51120,10,"""6""",51600,51660
5528,106503,103005,180,51120,10,"""6""",51660,51840
5528,103005,112107,120,51120,10,"""6""",51840,51960
5528,112107,403102,60,51120,10,"""6""",51960,52020
5528,403102,404102,120,51120,10,"""6""",52020,52140
5528,404102,407402,60,51120,10,"""6""",52140,52200
5528,407402,406604,60,51120,10,"""6""",52200,52260
5528,406604,400602,60,51120,10,"""6""",52260,52320
5528,400602,408300,120,51120,10,"""6""",52320,52440
5528,408300,406501,60,51120,10,"""6""",52440,52500
5528,406501,405901,60,51120,10,"""6""",52500,52560
5528,405901,405101,60,51120,10,"""6""",52560,52620
5528,405101,402900,60,51120,10,"""6""",52620,52680
5528,402900,405300,120,51120,10,"""6""",52680,52800
5528,405300,402800,60,51120,10,"""6""",52800,52860
5528,402800,402202,120,51120,10,"""6""",52860,52980
5528,402202,33703,60,51120,10,"""6""",52980,53040
5528,33703,400200,180,51120,10,"""6""",53040,53220
5528,302100,302002,60,52320,10,"""6""",52320,52380
5528,302002,302202,120,52320,10,"""6""",52380,52500
5528,302202,303002,60,52320,10,"""6""",52500,52560
5528,303002,302502,120,52320,10,"""6""",52560,52680
5528,302502,119005,120,52320,10,"""6""",52680,52800
5528,119005,106503,60,52320,10,"""6""",52800,52860
5528,106503,103005,180,52320,10,"""6""",52860,53040
5528,103005,112107,120,52320,10,"""6""",53040,53160
5528,112107,403102,60,52320,10,"""6""",53160,53220
5528,403102,404102,120,52320,10,"""6""",53220,53340
5528,404102,407402,60,52320,10,"""6""",53340,53400
5528,407402,406604,60,52320,10,"""6""",53400,53460
5528,406604,400602,60,52320,10,"""6""",53460,53520
5528,400602,408300,120,52320,10,"""6""",53520,53640
5528,408300,406501,60,52320,10,"""6""",53640,53700
5528,406501,405901,60,52320,10,"""6""",53700,53760
5528,405901,405101,60,52320,10,"""6""",53760,53820
5528,405101,402900,60,52320,10,"""6""",53820,53880
5528,402900,405300,120,52320,10,"""6""",53880,54000
5528,405300,402800,60,52320,10,"""6""",54000,54060
5528,402800,402202,120,52320,10,"""6""",54060,54180
5528,402202,33703,60,52320,10,"""6""",54180,54240
5528,33703,400200,180,52320,10,"""6""",54240,54420
5528,302100,302002,60,53520,10,"""6""",53520,53580
5528,302002,302202,120,53520,10,"""6""",53580,53700
5528,302202,303002,60,53520,10,"""6""",53700,53760
5528,303002,302502,120,53520,10,"""6""",53760,53880
5528,302502,119005,120,53520,10,"""6""",53880,54000
5528,119005,106503,60,53520,10,"""6""",54000,54060
5528,106503,103005,180,53520,10,"""6""",54060,54240
5528,103005,112107,120,53520,10,"""6""",54240,54360
5528,112107,403102,60,53520,10,"""6""",54360,54420
5528,403102,404102,120,53520,10,"""6""",54420,54540
5528,404102,407402,60,53520,10,"""6""",54540,54600
5528,407402,406604,60,53520,10,"""6""",54600,54660
5528,406604,400602,60,53520,10,"""6""",54660,54720
5528,400602,408300,120,53520,10,"""6""",54720,54840
5528,408300,406501,60,53520,10,"""6""",54840,54900
5528,406501,405901,60,53520,10,"""6""",54900,54960
5528,405901,405101,60,53520,10,"""6""",54960,55020
5528,405101,402900,60,53520,10,"""6""",55020,55080
5528,402900,405300,120,53520,10,"""6""",55080,55200
5528,405300,402800,60,53520,10,"""6""",55200,55260
5528,402800,402202,120,53520,10,"""6""",55260,55380
5528,402202,33703,60,53520,10,"""6""",55380,55440
5528,33703,400200,180,53520,10,"""6""",55440,55620
5528,302100,302002,60,54720,10,"""6""",54720,54780
5528,302002,302202,120,54720,10,"""6""",54780,54900
5528,302202,303002,60,54720,10,"""6""",54900,54960
5528,303002,302502,120,54720,10,"""6""",54960,55080
5528,302502,119005,120,54720,10,"""6""",55080,55200
5528,119005,106503,60,54720,10,"""6""",55200,55260
5528,106503,103005,180,54720,10,"""6""",55260,55440
5528,103005,112107,120,54720,10,"""6""",55440,55560
5528,112107,403102,60,54720,10,"""6""",55560,55620
5528,403102,404102,120,54720,10,"""6""",55620,55740
5528,404102,407402,60,54720,10,"""6""",55740,55800
5528,407402,406604,60,54720,10,"""6""",55800,55860
5528,406604,400602,60,54720,10,"""6""",55860,55920
5528,400602,408300,120,54720,10,"""6""",55920,56040
5528,408300,406501,60,54720,10,"""6""",56040,56100
5528,406501,405901,60,54720,10,"""6""",56100,56160
5528,405901,405101,60,54720,10,"""6""",56160,56220
5528,405101,402900,60,54720,10,"""6""",56220,56280
5528,402900,405300,120,54720,10,"""6""",56280,56400
5528,405300,402800,60,54720,10,"""6""",56400,56460
5528,402800,402202,120,54720,10,"""6""",56460,56580
5528,402202,33703,60,54720,10,"""6""",56580,56640
5528,33703,400200,180,54720,10,"""6""",56640,56820
5528,302100,302002,60,55920,10,"""6""",55920,55980
5528,302002,302202,120,55920,10,"""6""",55980,56100
5528,302202,303002,60,55920,10,"""6""",56100,56160
5528,303002,302502,120,55920,10,"""6""",56160,56280
5528,302502,119005,120,55920,10,"""6""",56280,56400
5528,119005,106503,60,55920,10,"""6""",56400,56460
5528,106503,103005,180,55920,10,"""6""",56460,56640
5528,103005,112107,120,55920,10,"""6""",56640,56760
5528,112107,403102,60,55920,10,"""6""",56760,56820
5528,403102,404102,120,55920,10,"""6""",56820,56940
5528,404102,407402,60,55920,10,"""6""",56940,57000
5528,407402,406604,60,55920,10,"""6""",57000,57060
5528,406604,400602,60,55920,10,"""6""",57060,57120
5528,400602,408300,120,55920,10,"""6""",57120,57240
5528,408300,406501,60,55920,10,"""6""",57240,57300
5528,406501,405901,60,55920,10,"""6""",57300,57360
5528,405901,405101,60,55920,10,"""6""",57360,57420
5528,405101,402900,60,55920,10,"""6""",57420,57480
5528,402900,405300,120,55920,10,"""6""",57480,57600
5528,405300,402800,60,55920,10,"""6""",57600,57660
5528,402800,402202,120,55920,10,"""6""",57660,57780
5528,402202,33703,60,55920,10,"""6""",57780,57840
5528,33703,400200,180,55920,10,"""6""",57840,58020
5528,302100,302002,60,57120,10,"""6""",57120,57180
5528,302002,302202,120,57120,10,"""6""",57180,57300
5528,302202,303002,60,57120,10,"""6""",57300,57360
5528,303002,302502,120,57120,10,"""6""",57360,57480
5528,302502,119005,120,57120,10,"""6""",57480,57600
5528,119005,106503,60,57120,10,"""6""",57600,57660
5528,106503,103005,180,57120,10,"""6""",57660,57840
5528,103005,112107,120,57120,10,"""6""",57840,57960
5528,112107,403102,60,57120,10,"""6""",57960,58020
5528,403102,404102,120,57120,10,"""6""",58020,58140
5528,404102,407402,60,57120,10,"""6""",58140,58200
5528,407402,406604,60,57120,10,"""6""",58200,58260
5528,406604,400602,60,57120,10,"""6""",58260,58320
5528,400602,408300,120,57120,10,"""6""",58320,58440
5528,408300,406501,60,57120,10,"""6""",58440,58500
5528,406501,405901,60,57120,10,"""6""",58500,58560
5528,405901,405101,60,57120,10,"""6""",58560,58620
5528,405101,402900,60,57120,10,"""6""",58620,58680
5528,402900,405300,120,57120,10,"""6""",58680,58800
5528,405300,402800,60,57120,10,"""6""",58800,58860
5528,402800,402202,120,57120,10,"""6""",58860,58980
5528,402202,33703,60,57120,10,"""6""",58980,59040
5528,33703,400200,180,57120,10,"""6""",59040,59220
5528,302100,302002,60,58320,10,"""6""",58320,58380
5528,302002,302202,120,58320,10,"""6""",58380,58500
5528,302202,303002,60,58320,10,"""6""",58500,58560
5528,303002,302502,120,58320,10,"""6""",58560,58680
5528,302502,119005,120,58320,10,"""6""",58680,58800
5528,119005,106503,60,58320,10,"""6""",58800,58860
5528,106503,103005,180,58320,10,"""6""",58860,59040
5528,103005,112107,120,58320,10,"""6""",59040,59160
5528,112107,403102,60,58320,10,"""6""",59160,59220
5528,403102,404102,120,58320,10,"""6""",59220,59340
5528,404102,407402,60,58320,10,"""6""",59340,59400
5528,407402,406604,60,58320,10,"""6""",59400,59460
5528,406604,400602,60,58320,10,"""6""",59460,59520
5528,400602,408300,120,58320,10,"""6""",59520,59640
5528,408300,406501,60,58320,10,"""6""",59640,59700
5528,406501,405901,60,58320,10,"""6""",59700,59760
5528,405901,405101,60,58320,10,"""6""",59760,59820
5528,405101,402900,60,58320,10,"""6""",59820,59880
5528,402900,405300,120,58320,10,"""6""",59880,60000
5528,405300,402800,60,58320,10,"""6""",60000,60060
5528,402800,402202,120,58320,10,"""6""",60060,60180
5528,402202,33703,60,58320,10,"""6""",60180,60240
5528,33703,400200,180,58320,10,"""6""",60240,60420
5528,302100,302002,60,59520,10,"""6""",59520,59580
5528,302002,302202,120,59520,10,"""6""",59580,59700
5528,302202,303002,60,59520,10,"""6""",59700,59760
5528,303002,302502,120,59520,10,"""6""",59760,59880
5528,302502,119005,120,59520,10,"""6""",59880,60000
5528,119005,106503,60,59520,10,"""6""",60000,60060
5528,106503,103005,180,59520,10,"""6""",60060,60240
5528,103005,112107,120,59520,10,"""6""",60240,60360
5528,112107,403102,60,59520,10,"""6""",60360,60420
5528,403102,404102,120,59520,10,"""6""",60420,60540
5528,404102,407402,60,59520,10,"""6""",60540,60600
5528,407402,406604,60,59520,10,"""6""",60600,60660
5528,406604,400602,60,59520,10,"""6""",60660,60720
5528,400602,408300,120,59520,10,"""6""",60720,60840
5528,408300,406501,60,59520,10,"""6""",60840,60900
5528,406501,405901,60,59520,10,"""6""",60900,60960
5528,405901,405101,60,59520,10,"""6""",60960,61020
5528,405101,402900,60,59520,10,"""6""",61020,61080
5528,402900,405300,120,59520,10,"""6""",61080,61200
5528,405300,402800,60,59520,10,"""6""",61200,61260
5528,402800,402202,120,59520,10,"""6""",61260,61380
5528,402202,33703,60,59520,10,"""6""",61380,61440
5528,33703,400200,180,59520,10,"""6""",61440,61620
5528,302100,302002,60,60720,10,"""6""",60720,60780
5528,302002,302202,120,60720,10,"""6""",60780,60900
5528,302202,303002,60,60720,10,"""6""",60900,60960
5528,303002,302502,120,60720,10,"""6""",60960,61080
5528,302502,119005,120,60720,10,"""6""",61080,61200
5528,119005,106503,60,60720,10,"""6""",61200,61260
5528,106503,103005,180,60720,10,"""6""",61260,61440
5528,103005,112107,120,60720,10,"""6""",61440,61560
5528,112107,403102,60,60720,10,"""6""",61560,61620
5528,403102,404102,120,60720,10,"""6""",61620,61740
5528,404102,407402,60,60720,10,"""6""",61740,61800
5528,407402,406604,60,60720,10,"""6""",61800,61860
5528,406604,400602,60,60720,10,"""6""",61860,61920
5528,400602,408300,120,60720,10,"""6""",61920,62040
5528,408300,406501,60,60720,10,"""6""",62040,62100
5528,406501,405901,60,60720,10,"""6""",62100,62160
5528,405901,405101,60,60720,10,"""6""",62160,62220
5528,405101,402900,60,60720,10,"""6""",62220,62280
5528,402900,405300,120,60720,10,"""6""",62280,62400
5528,405300,402800,60,60720,10,"""6""",62400,62460
5528,402800,402202,120,60720,10,"""6""",62460,62580
5528,402202,33703,60,60720,10,"""6""",62580,62640
5528,33703,400200,180,60720,10,"""6""",62640,62820
5528,302100,302002,60,61920,10,"""6""",61920,61980
5528,302002,302202,120,61920,10,"""6""",61980,62100
5528,302202,303002,60,61920,10,"""6""",62100,62160
5528,303002,302502,120,61920,10,"""6""",62160,62280
5528,302502,119005,120,61920,10,"""6""",62280,62400
5528,119005,106503,60,61920,10,"""6""",62400,62460
5528,106503,103005,180,61920,10,"""6""",62460,62640
5528,103005,112107,120,61920,10,"""6""",62640,62760
5528,112107,403102,60,61920,10,"""6""",62760,62820
5528,403102,404102,120,61920,10,"""6""",62820,62940
5528,404102,407402,60,61920,10,"""6""",62940,63000
5528,407402,406604,60,61920,10,"""6""",63000,63060
5528,406604,400602,60,61920,10,"""6""",63060,63120
5528,400602,408300,120,61920,10,"""6""",63120,63240
5528,408300,406501,60,61920,10,"""6""",63240,63300
5528,406501,405901,60,61920,10,"""6""",63300,63360
5528,405901,405101,60,61920,10,"""6""",63360,63420
5528,405101,402900,60,61920,10,"""6""",63420,63480
5528,402900,405300,120,61920,10,"""6""",63480,63600
5528,405300,402800,60,61920,10,"""6""",63600,63660
5528,402800,402202,120,61920,10,"""6""",63660,63780
5528,402202,33703,60,61920,10,"""6""",63780,63840
5528,33703,400200,180,61920,10,"""6""",63840,64020
5528,302100,302002,60,63120,10,"""6""",63120,63180
5528,302002,302202,120,63120,10,"""6""",63180,63300
5528,302202,303002,60,63120,10,"""6""",63300,63360
5528,303002,302502,120,63120,10,"""6""",63360,63480
5528,302502,119005,120,63120,10,"""6""",63480,63600
5528,119005,106503,60,63120,10,"""6""",63600,63660
5528,106503,103005,180,63120,10,"""6""",63660,63840
5528,103005,112107,120,63120,10,"""6""",63840,63960
5528,112107,403102,60,63120,10,"""6""",63960,64020
5528,403102,404102,120,63120,10,"""6""",64020,64140
5528,404102,407402,60,63120,10,"""6""",64140,64200
5528,407402,406604,60,63120,10,"""6""",64200,64260
5528,406604,400602,60,63120,10,"""6""",64260,64320
5528,400602,408300,120,63120,10,"""6""",64320,64440
5528,408300,406501,60,63120,10,"""6""",64440,64500
5528,406501,405901,60,63120,10,"""6""",64500,64560
5528,405901,405101,60,63120,10,"""6""",64560,64620
5528,405101,402900,60,63120,10,"""6""",64620,64680
5528,402900,405300,120,63120,10,"""6""",64680,64800
5528,405300,402800,60,63120,10,"""6""",64800,64860
5528,402800,402202,120,63120,10,"""6""",64860,64980
5528,402202,33703,60,63120,10,"""6""",64980,65040
5528,33703,400200,180,63120,10,"""6""",65040,65220
5529,302300,302703,60,82440,10,"""14""",82440,82500
5529,302703,302401,60,82440,10,"""14""",82500,82560
5529,302401,300301,120,82440,10,"""14""",82560,82680
5529,300301,302100,180,82440,10,"""14""",82680,82860
5529,302100,302002,60,82440,10,"""14""",82860,82920
5529,302002,302202,60,82440,10,"""14""",82920,82980
5529,302202,303002,60,82440,10,"""14""",82980,83040
5529,303002,302502,60,82440,10,"""14""",83040,83100
5529,302502,119005,120,82440,10,"""14""",83100,83220
5529,119005,106503,60,82440,10,"""14""",83220,83280
5529,106503,103005,120,82440,10,"""14""",83280,83400
5529,103005,112107,120,82440,10,"""14""",83400,83520
5529,112107,403102,60,82440,10,"""14""",83520,83580
5529,403102,404102,120,82440,10,"""14""",83580,83700
5529,404102,407402,60,82440,10,"""14""",83700,83760
5529,407402,406604,60,82440,10,"""14""",83760,83820
5529,406604,400602,60,82440,10,"""14""",83820,83880
5529,400602,408300,60,82440,10,"""14""",83880,83940
5529,408300,406501,60,82440,10,"""14""",83940,84000
5529,406501,405901,60,82440,10,"""14""",84000,84060
5529,405901,405101,60,82440,10,"""14""",84060,84120
5529,405101,402900,60,82440,10,"""14""",84120,84180
5529,402900,405300,60,82440,10,"""14""",84180,84240
5530,302100,302002,60,25320,10,"""8""",25320,25380
5530,302002,302202,120,25320,10,"""8""",25380,25500
5530,302202,303002,60,25320,10,"""8""",25500,25560
5530,303002,302502,120,25320,10,"""8""",25560,25680
5530,302502,119005,120,25320,10,"""8""",25680,25800
5530,119005,106503,60,25320,10,"""8""",25800,25860
5530,106503,103005,180,25320,10,"""8""",25860,26040
5530,103005,112107,120,25320,10,"""8""",26040,26160
5530,112107,403102,60,25320,10,"""8""",26160,26220
5530,403102,404102,120,25320,10,"""8""",26220,26340
5530,404102,407402,60,25320,10,"""8""",26340,26400
5530,407402,406604,60,25320,10,"""8""",26400,26460
5530,406604,400602,60,25320,10,"""8""",26460,26520
5530,400602,408300,120,25320,10,"""8""",26520,26640
5530,408300,406501,60,25320,10,"""8""",26640,26700
5530,406501,405901,60,25320,10,"""8""",26700,26760
5530,405901,405101,60,25320,10,"""8""",26760,26820
5530,405101,402900,60,25320,10,"""8""",26820,26880
5530,402900,405300,120,25320,10,"""8""",26880,27000
5530,302100,302002,60,26520,10,"""8""",26520,26580
5530,302002,302202,120,26520,10,"""8""",26580,26700
5530,302202,303002,60,26520,10,"""8""",26700,26760
5530,303002,302502,120,26520,10,"""8""",26760,26880
5530,302502,119005,120,26520,10,"""8""",26880,27000
5530,119005,106503,60,26520,10,"""8""",27000,27060
5530,106503,103005,180,26520,10,"""8""",27060,27240
5530,103005,112107,120,26520,10,"""8""",27240,27360
5530,112107,403102,60,26520,10,"""8""",27360,27420
5530,403102,404102,120,26520,10,"""8""",27420,27540
5530,404102,407402,60,26520,10,"""8""",27540,27600
5530,407402,406604,60,26520,10,"""8""",27600,27660
5530,406604,400602,60,26520,10,"""8""",27660,27720
5530,400602,408300,120,26520,10,"""8""",27720,27840
5530,408300,406501,60,26520,10,"""8""",27840,27900
5530,406501,405901,60,26520,10,"""8""",27900,27960
5530,405901,405101,60,26520,10,"""8""",27960,28020
5530,405101,402900,60,26520,10,"""8""",28020,28080
5530,402900,405300,120,26520,10,"""8""",28080,28200
5530,302100,302002,60,27720,10,"""8""",27720,27780
5530,302002,302202,120,27720,10,"""8""",27780,27900
5530,302202,303002,60,27720,10,"""8""",27900,27960
5530,303002,302502,120,27720,10,"""8""",27960,28080
5530,302502,119005,120,27720,10,"""8""",28080,28200
5530,119005,106503,60,27720,10,"""8""",28200,28260
5530,106503,103005,180,27720,10,"""8""",28260,28440
5530,103005,112107,120,27720,10,"""8""",28440,28560
5530,112107,403102,60,27720,10,"""8""",28560,28620
5530,403102,404102,120,27720,10,"""8""",28620,28740
5530,404102,407402,60,27720,10,"""8""",28740,28800
5530,407402,406604,60,27720,10,"""8""",28800,28860
5530,406604,400602,60,27720,10,"""8""",28860,28920
5530,400602,408300,120,27720,10,"""8""",28920,29040
5530,408300,406501,60,27720,10,"""8""",29040,29100
5530,406501,405901,60,27720,10,"""8""",29100,29160
5530,405901,405101,60,27720,10,"""8""",29160,29220
5530,405101,402900,60,27720,10,"""8""",29220,29280
5530,402900,405300,120,27720,10,"""8""",29280,29400
5530,302100,302002,60,28920,10,"""8""",28920,28980
5530,302002,302202,120,28920,10,"""8""",28980,29100
5530,302202,303002,60,28920,10,"""8""",29100,29160
5530,303002,302502,120,28920,10,"""8""",29160,29280
5530,302502,119005,120,28920,10,"""8""",29280,29400
5530,119005,106503,60,28920,10,"""8""",29400,29460
5530,106503,103005,180,28920,10,"""8""",29460,29640
5530,103005,112107,120,28920,10,"""8""",29640,29760
5530,112107,403102,60,28920,10,"""8""",29760,29820
5530,403102,404102,120,28920,10,"""8""",29820,29940
5530,404102,407402,60,28920,10,"""8""",29940,30000
5530,407402,406604,60,28920,10,"""8""",30000,30060
5530,406604,400602,60,28920,10,"""8""",30060,30120
5530,400602,408300,120,28920,10,"""8""",30120,30240
5530,408300,406501,60,28920,10,"""8""",30240,30300
5530,406501,405901,60,28920,10,"""8""",30300,30360
5530,405901,405101,60,28920,10,"""8""",30360,30420
5530,405101,402900,60,28920,10,"""8""",30420,30480
5530,402900,405300,120,28920,10,"""8""",30480,30600
5530,302100,302002,60,30120,10,"""8""",30120,30180
5530,302002,302202,120,30120,10,"""8""",30180,30300
5530,302202,303002,60,30120,10,"""8""",30300,30360
5530,303002,302502,120,30120,10,"""8""",30360,30480
5530,302502,119005,120,30120,10,"""8""",30480,30600
5530,119005,106503,60,30120,10,"""8""",30600,30660
5530,106503,103005,180,30120,10,"""8""",30660,30840
5530,103005,112107,120,30120,10,"""8""",30840,30960
5530,112107,403102,60,30120,10,"""8""",30960,31020
5530,403102,404102,120,30120,10,"""8""",31020,31140
5530,404102,407402,60,30120,10,"""8""",31140,31200
5530,407402,406604,60,30120,10,"""8""",31200,31260
5530,406604,400602,60,30120,10,"""8""",31260,31320
5530,400602,408300,120,30120,10,"""8""",31320,31440
5530,408300,406501,60,30120,10,"""8""",31440,31500
5530,406501,405901,60,30120,10,"""8""",31500,31560
5530,405901,405101,60,30120,10,"""8""",31560,31620
5530,405101,402900,60,30120,10,"""8""",31620,31680
5530,402900,405300,120,30120,10,"""8""",31680,31800
5530,302100,302002,60,31320,10,"""8""",31320,31380
5530,302002,302202,120,31320,10,"""8""",31380,31500
5530,302202,303002,60,31320,10,"""8""",31500,31560
5530,303002,302502,120,31320,10,"""8""",31560,31680
5530,302502,119005,120,31320,10,"""8""",31680,31800
5530,119005,106503,60,31320,10,"""8""",31800,31860
5530,106503,103005,180,31320,10,"""8""",31860,32040
5530,103005,112107,120,31320,10,"""8""",32040,32160
5530,112107,403102,60,31320,10,"""8""",32160,32220
5530,403102,404102,120,31320,10,"""8""",32220,32340
5530,404102,407402,60,31320,10,"""8""",32340,32400
5530,407402,406604,60,31320,10,"""8""",32400,32460
5530,406604,400602,60,31320,10,"""8""",32460,32520
5530,400602,408300,120,31320,10,"""8""",32520,32640
5530,408300,406501,60,31320,10,"""8""",32640,32700
5530,406501,405901,60,31320,10,"""8""",32700,32760
5530,405901,405101,60,31320,10,"""8""",32760,32820
5530,405101,402900,60,31320,10,"""8""",32820,32880
5530,402900,405300,120,31320,10,"""8""",32880,33000
5530,302100,302002,60,32520,10,"""8""",32520,32580
5530,302002,302202,120,32520,10,"""8""",32580,32700
5530,302202,303002,60,32520,10,"""8""",32700,32760
5530,303002,302502,120,32520,10,"""8""",32760,32880
5530,302502,119005,120,32520,10,"""8""",32880,33000
5530,119005,106503,60,32520,10,"""8""",33000,33060
5530,106503,103005,180,32520,10,"""8""",33060,33240
5530,103005,112107,120,32520,10,"""8""",33240,33360
5530,112107,403102,60,32520,10,"""8""",33360,33420
5530,403102,404102,120,32520,10,"""8""",33420,33540
5530,404102,407402,60,32520,10,"""8""",33540,33600
5530,407402,406604,60,32520,10,"""8""",33600,33660
5530,406604,400602,60,32520,10,"""8""",33660,33720
5530,400602,408300,120,32520,10,"""8""",33720,33840
5530,408300,406501,60,32520,10,"""8""",33840,33900
5530,406501,405901,60,32520,10,"""8""",33900,33960
5530,405901,405101,60,32520,10,"""8""",33960,34020
5530,405101,402900,60,32520,10,"""8""",34020,34080
5530,402900,405300,120,32520,10,"""8""",34080,34200
5530,302100,302002,60,33720,10,"""8""",33720,33780
5530,302002,302202,120,33720,10,"""8""",33780,33900
5530,302202,303002,60,33720,10,"""8""",33900,33960
5530,303002,302502,120,33720,10,"""8""",33960,34080
5530,302502,119005,120,33720,10,"""8""",34080,34200
5530,119005,106503,60,33720,10,"""8""",34200,34260
5530,106503,103005,180,33720,10,"""8""",34260,34440
5530,103005,112107,120,33720,10,"""8""",34440,34560
5530,112107,403102,60,33720,10,"""8""",34560,34620
5530,403102,404102,120,33720,10,"""8""",34620,34740
5530,404102,407402,60,33720,10,"""8""",34740,34800
5530,407402,406604,60,33720,10,"""8""",34800,34860
5530,406604,400602,60,33720,10,"""8""",34860,34920
5530,400602,408300,120,33720,10,"""8""",34920,35040
5530,408300,406501,60,33720,10,"""8""",35040,35100
5530,406501,405901,60,33720,10,"""8""",35100,35160
5530,405901,405101,60,33720,10,"""8""",35160,35220
5530,405101,402900,60,33720,10,"""8""",35220,35280
5530,402900,405300,120,33720,10,"""8""",35280,35400
5530,302100,302002,60,34920,10,"""8""",34920,34980
5530,302002,302202,120,34920,10,"""8""",34980,35100
5530,302202,303002,60,34920,10,"""8""",35100,35160
5530,303002,302502,120,34920,10,"""8""",35160,35280
5530,302502,119005,120,34920,10,"""8""",35280,35400
5530,119005,106503,60,34920,10,"""8""",35400,35460
5530,106503,103005,180,34920,10,"""8""",35460,35640
5530,103005,112107,120,34920,10,"""8""",35640,35760
5530,112107,403102,60,34920,10,"""8""",35760,35820
5530,403102,404102,120,34920,10,"""8""",35820,35940
5530,404102,407402,60,34920,10,"""8""",35940,36000
5530,407402,406604,60,34920,10,"""8""",36000,36060
5530,406604,400602,60,34920,10,"""8""",36060,36120
5530,400602,408300,120,34920,10,"""8""",36120,36240
5530,408300,406501,60,34920,10,"""8""",36240,36300
5530,406501,405901,60,34920,10,"""8""",36300,36360
5530,405901,405101,60,34920,10,"""8""",36360,36420
5530,405101,402900,60,34920,10,"""8""",36420,36480
5530,402900,405300,120,34920,10,"""8""",36480,36600
5530,302100,302002,60,36120,10,"""8""",36120,36180
5530,302002,302202,120,36120,10,"""8""",36180,36300
5530,302202,303002,60,36120,10,"""8""",36300,36360
5530,303002,302502,120,36120,10,"""8""",36360,36480
5530,302502,119005,120,36120,10,"""8""",36480,36600
5530,119005,106503,60,36120,10,"""8""",36600,36660
5530,106503,103005,180,36120,10,"""8""",36660,36840
5530,103005,112107,120,36120,10,"""8""",36840,36960
5530,112107,403102,60,36120,10,"""8""",36960,37020
5530,403102,404102,120,36120,10,"""8""",37020,37140
5530,404102,407402,60,36120,10,"""8""",37140,37200
5530,407402,406604,60,36120,10,"""8""",37200,37260
5530,406604,400602,60,36120,10,"""8""",37260,37320
5530,400602,408300,120,36120,10,"""8""",37320,37440
5530,408300,406501,60,36120,10,"""8""",37440,37500
5530,406501,405901,60,36120,10,"""8""",37500,37560
5530,405901,405101,60,36120,10,"""8""",37560,37620
5530,405101,402900,60,36120,10,"""8""",37620,37680
5530,402900,405300,120,36120,10,"""8""",37680,37800
5530,302100,302002,60,37320,10,"""8""",37320,37380
5530,302002,302202,120,37320,10,"""8""",37380,37500
5530,302202,303002,60,37320,10,"""8""",37500,37560
5530,303002,302502,120,37320,10,"""8""",37560,37680
5530,302502,119005,120,37320,10,"""8""",37680,37800
5530,119005,106503,60,37320,10,"""8""",37800,37860
5530,106503,103005,180,37320,10,"""8""",37860,38040
5530,103005,112107,120,37320,10,"""8""",38040,38160
5530,112107,403102,60,37320,10,"""8""",38160,38220
5530,403102,404102,120,37320,10,"""8""",38220,38340
5530,404102,407402,60,37320,10,"""8""",38340,38400
5530,407402,406604,60,37320,10,"""8""",38400,38460
5530,406604,400602,60,37320,10,"""8""",38460,38520
5530,400602,408300,120,37320,10,"""8""",38520,38640
5530,408300,406501,60,37320,10,"""8""",38640,38700
5530,406501,405901,60,37320,10,"""8""",38700,38760
5530,405901,405101,60,37320,10,"""8""",38760,38820
5530,405101,402900,60,37320,10,"""8""",38820,38880
5530,402900,405300,120,37320,10,"""8""",38880,39000
5530,302100,302002,60,38520,10,"""8""",38520,38580
5530,302002,302202,120,38520,10,"""8""",38580,38700
5530,302202,303002,60,38520,10,"""8""",38700,38760
5530,303002,302502,120,38520,10,"""8""",38760,38880
5530,302502,119005,120,38520,10,"""8""",38880,39000
5530,119005,106503,60,38520,10,"""8""",39000,39060
5530,106503,103005,180,38520,10,"""8""",39060,39240
5530,103005,112107,120,38520,10,"""8""",39240,39360
5530,112107,403102,60,38520,10,"""8""",39360,39420
5530,403102,404102,120,38520,10,"""8""",39420,39540
5530,404102,407402,60,38520,10,"""8""",39540,39600
5530,407402,406604,60,38520,10,"""8""",39600,39660
5530,406604,400602,60,38520,10,"""8""",39660,39720
5530,400602,408300,120,38520,10,"""8""",39720,39840
5530,408300,406501,60,38520,10,"""8""",39840,39900
5530,406501,405901,60,38520,10,"""8""",39900,39960
5530,405901,405101,60,38520,10,"""8""",39960,40020
5530,405101,402900,60,38520,10,"""8""",40020,40080
5530,402900,405300,120,38520,10,"""8""",40080,40200
5530,302100,302002,60,39720,10,"""8""",39720,39780
5530,302002,302202,120,39720,10,"""8""",39780,39900
5530,302202,303002,60,39720,10,"""8""",39900,39960
5530,303002,302502,120,39720,10,"""8""",39960,40080
5530,302502,119005,120,39720,10,"""8""",40080,40200
5530,119005,106503,60,39720,10,"""8""",40200,40260
5530,106503,103005,180,39720,10,"""8""",40260,40440
5530,103005,112107,120,39720,10,"""8""",40440,40560
5530,112107,403102,60,39720,10,"""8""",40560,40620
5530,403102,404102,120,39720,10,"""8""",40620,40740
5530,404102,407402,60,39720,10,"""8""",40740,40800
5530,407402,406604,60,39720,10,"""8""",40800,40860
5530,406604,400602,60,39720,10,"""8""",40860,40920
5530,400602,408300,120,39720,10,"""8""",40920,41040
5530,408300,406501,60,39720,10,"""8""",41040,41100
5530,406501,405901,60,39720,10,"""8""",41100,41160
5530,405901,405101,60,39720,10,"""8""",41160,41220
5530,405101,402900,60,39720,10,"""8""",41220,41280
5530,402900,405300,120,39720,10,"""8""",41280,41400
5530,302100,302002,60,40920,10,"""8""",40920,40980
5530,302002,302202,120,40920,10,"""8""",40980,41100
5530,302202,303002,60,40920,10,"""8""",41100,41160
5530,303002,302502,120,40920,10,"""8""",41160,41280
5530,302502,119005,120,40920,10,"""8""",41280,41400
5530,119005,106503,60,40920,10,"""8""",41400,41460
5530,106503,103005,180,40920,10,"""8""",41460,41640
5530,103005,112107,120,40920,10,"""8""",41640,41760
5530,112107,403102,60,40920,10,"""8""",41760,41820
5530,403102,404102,120,40920,10,"""8""",41820,41940
5530,404102,407402,60,40920,10,"""8""",41940,42000
5530,407402,406604,60,40920,10,"""8""",42000,42060
5530,406604,400602,60,40920,10,"""8""",42060,42120
5530,400602,408300,120,40920,10,"""8""",42120,42240
5530,408300,406501,60,40920,10,"""8""",42240,42300
5530,406501,405901,60,40920,10,"""8""",42300,42360
5530,405901,405101,60,40920,10,"""8""",42360,42420
5530,405101,402900,60,40920,10,"""8""",42420,42480
5530,402900,405300,120,40920,10,"""8""",42480,42600
5530,302100,302002,60,42120,10,"""8""",42120,42180
5530,302002,302202,120,42120,10,"""8""",42180,42300
5530,302202,303002,60,42120,10,"""8""",42300,42360
5530,303002,302502,120,42120,10,"""8""",42360,42480
5530,302502,119005,120,42120,10,"""8""",42480,42600
5530,119005,106503,60,42120,10,"""8""",42600,42660
5530,106503,103005,180,42120,10,"""8""",42660,42840
5530,103005,112107,120,42120,10,"""8""",42840,42960
5530,112107,403102,60,42120,10,"""8""",42960,43020
5530,403102,404102,120,42120,10,"""8""",43020,43140
5530,404102,407402,60,42120,10,"""8""",43140,43200
5530,407402,406604,60,42120,10,"""8""",43200,43260
5530,406604,400602,60,42120,10,"""8""",43260,43320
5530,400602,408300,120,42120,10,"""8""",43320,43440
5530,408300,406501,60,42120,10,"""8""",43440,43500
5530,406501,405901,60,42120,10,"""8""",43500,43560
5530,405901,405101,60,42120,10,"""8""",43560,43620
5530,405101,402900,60,42120,10,"""8""",43620,43680
5530,402900,405300,120,42120,10,"""8""",43680,43800
5530,302100,302002,60,43320,10,"""8""",43320,43380
5530,302002,302202,120,43320,10,"""8""",43380,43500
5530,302202,303002,60,43320,10,"""8""",43500,43560
5530,303002,302502,120,43320,10,"""8""",43560,43680
5530,302502,119005,120,43320,10,"""8""",43680,43800
5530,119005,106503,60,43320,10,"""8""",43800,43860
5530,106503,103005,180,43320,10,"""8""",43860,44040
5530,103005,112107,120,43320,10,"""8""",44040,44160
5530,112107,403102,60,43320,10,"""8""",44160,44220
5530,403102,404102,120,43320,10,"""8""",44220,44340
5530,404102,407402,60,43320,10,"""8""",44340,44400
5530,407402,406604,60,43320,10,"""8""",44400,44460
5530,406604,400602,60,43320,10,"""8""",44460,44520
5530,400602,408300,120,43320,10,"""8""",44520,44640
5530,408300,406501,60,43320,10,"""8""",44640,44700
5530,406501,405901,60,43320,10,"""8""",44700,44760
5530,405901,405101,60,43320,10,"""8""",44760,44820
5530,405101,402900,60,43320,10,"""8""",44820,44880
5530,402900,405300,120,43320,10,"""8""",44880,45000
5530,302100,302002,60,44520,10,"""8""",44520,44580
5530,302002,302202,120,44520,10,"""8""",44580,44700
5530,302202,303002,60,44520,10,"""8""",44700,44760
5530,303002,302502,120,44520,10,"""8""",44760,44880
5530,302502,119005,120,44520,10,"""8""",44880,45000
5530,119005,106503,60,44520,10,"""8""",45000,45060
5530,106503,103005,180,44520,10,"""8""",45060,45240
5530,103005,112107,120,44520,10,"""8""",45240,45360
5530,112107,403102,60,44520,10,"""8""",45360,45420
5530,403102,404102,120,44520,10,"""8""",45420,45540
5530,404102,407402,60,44520,10,"""8""",45540,45600
5530,407402,406604,60,44520,10,"""8""",45600,45660
5530,406604,400602,60,44520,10,"""8""",45660,45720
5530,400602,408300,120,44520,10,"""8""",45720,45840
5530,408300,406501,60,44520,10,"""8""",45840,45900
5530,406501,405901,60,44520,10,"""8""",45900,45960
5530,405901,405101,60,44520,10,"""8""",45960,46020
5530,405101,402900,60,44520,10,"""8""",46020,46080
5530,402900,405300,120,44520,10,"""8""",46080,46200
5530,302100,302002,60,45720,10,"""8""",45720,45780
5530,302002,302202,120,45720,10,"""8""",45780,45900
5530,302202,303002,60,45720,10,"""8""",45900,45960
5530,303002,302502,120,45720,10,"""8""",45960,46080
5530,302502,119005,120,45720,10,"""8""",46080,46200
5530,119005,106503,60,45720,10,"""8""",46200,46260
5530,106503,103005,180,45720,10,"""8""",46260,46440
5530,103005,112107,120,45720,10,"""8""",46440,46560
5530,112107,403102,60,45720,10,"""8""",46560,46620
5530,403102,404102,120,45720,10,"""8""",46620,46740
5530,404102,407402,60,45720,10,"""8""",46740,46800
5530,407402,406604,60,45720,10,"""8""",46800,46860
5530,406604,400602,60,45720,10,"""8""",46860,46920
5530,400602,408300,120,45720,10,"""8""",46920,47040
5530,408300,406501,60,45720,10,"""8""",47040,47100
5530,406501,405901,60,45720,10,"""8""",47100,47160
5530,405901,405101,60,45720,10,"""8""",47160,47220
5530,405101,402900,60,45720,10,"""8""",47220,47280
5530,402900,405300,120,45720,10,"""8""",47280,47400
5530,302100,302002,60,46920,10,"""8""",46920,46980
5530,302002,302202,120,46920,10,"""8""",46980,47100
5530,302202,303002,60,46920,10,"""8""",47100,47160
5530,303002,302502,120,46920,10,"""8""",47160,47280
5530,302502,119005,120,46920,10,"""8""",47280,47400
5530,119005,106503,60,46920,10,"""8""",47400,47460
5530,106503,103005,180,46920,10,"""8""",47460,47640
5530,103005,112107,120,46920,10,"""8""",47640,47760
5530,112107,403102,60,46920,10,"""8""",47760,47820
5530,403102,404102,120,46920,10,"""8""",47820,47940
5530,404102,407402,60,46920,10,"""8""",47940,48000
5530,407402,406604,60,46920,10,"""8""",48000,48060
5530,406604,400602,60,46920,10,"""8""",48060,48120
5530,400602,408300,120,46920,10,"""8""",48120,48240
5530,408300,406501,60,46920,10,"""8""",48240,48300
5530,406501,405901,60,46920,10,"""8""",48300,48360
5530,405901,405101,60,46920,10,"""8""",48360,48420
5530,405101,402900,60,46920,10,"""8""",48420,48480
5530,402900,405300,120,46920,10,"""8""",48480,48600
5530,302100,302002,60,48120,10,"""8""",48120,48180
5530,302002,302202,120,48120,10,"""8""",48180,48300
5530,302202,303002,60,48120,10,"""8""",48300,48360
5530,303002,302502,120,48120,10,"""8""",48360,48480
5530,302502,119005,120,48120,10,"""8""",48480,48600
5530,119005,106503,60,48120,10,"""8""",48600,48660
5530,106503,103005,180,48120,10,"""8""",48660,48840
5530,103005,112107,120,48120,10,"""8""",48840,48960
5530,112107,403102,60,48120,10,"""8""",48960,49020
5530,403102,404102,120,48120,10,"""8""",49020,49140
5530,404102,407402,60,48120,10,"""8""",49140,49200
5530,407402,406604,60,48120,10,"""8""",49200,49260
5530,406604,400602,60,48120,10,"""8""",49260,49320
5530,400602,408300,120,48120,10,"""8""",49320,49440
5530,408300,406501,60,48120,10,"""8""",49440,49500
5530,406501,405901,60,48120,10,"""8""",49500,49560
5530,405901,405101,60,48120,10,"""8""",49560,49620
5530,405101,402900,60,48120,10,"""8""",49620,49680
5530,402900,405300,120,48120,10,"""8""",49680,49800
5530,302100,302002,60,49320,10,"""8""",49320,49380
5530,302002,302202,120,49320,10,"""8""",49380,49500
5530,302202,303002,60,49320,10,"""8""",49500,49560
5530,303002,302502,120,49320,10,"""8""",49560,49680
5530,302502,119005,120,49320,10,"""8""",49680,49800
5530,119005,106503,60,49320,10,"""8""",49800,49860
5530,106503,103005,180,49320,10,"""8""",49860,50040
5530,103005,112107,120,49320,10,"""8""",50040,50160
5530,112107,403102,60,49320,10,"""8""",50160,50220
5530,403102,404102,120,49320,10,"""8""",50220,50340
5530,404102,407402,60,49320,10,"""8""",50340,50400
5530,407402,406604,60,49320,10,"""8""",50400,50460
5530,406604,400602,60,49320,10,"""8""",50460,50520
5530,400602,408300,120,49320,10,"""8""",50520,50640
5530,408300,406501,60,49320,10,"""8""",50640,50700
5530,406501,405901,60,49320,10,"""8""",50700,50760
5530,405901,405101,60,49320,10,"""8""",50760,50820
5530,405101,402900,60,49320,10,"""8""",50820,50880
5530,402900,405300,120,49320,10,"""8""",50880,51000
5530,302100,302002,60,50520,10,"""8""",50520,50580
5530,302002,302202,120,50520,10,"""8""",50580,50700
5530,302202,303002,60,50520,10,"""8""",50700,50760
5530,303002,302502,120,50520,10,"""8""",50760,50880
5530,302502,119005,120,50520,10,"""8""",50880,51000
5530,119005,106503,60,50520,10,"""8""",51000,51060
5530,106503,103005,180,50520,10,"""8""",51060,51240
5530,103005,112107,120,50520,10,"""8""",51240,51360
5530,112107,403102,60,50520,10,"""8""",51360,51420
5530,403102,404102,120,50520,10,"""8""",51420,51540
5530,404102,407402,60,50520,10,"""8""",51540,51600
5530,407402,406604,60,50520,10,"""8""",51600,51660
5530,406604,400602,60,50520,10,"""8""",51660,51720
5530,400602,408300,120,50520,10,"""8""",51720,51840
5530,408300,406501,60,50520,10,"""8""",51840,51900
5530,406501,405901,60,50520,10,"""8""",51900,51960
5530,405901,405101,60,50520,10,"""8""",51960,52020
5530,405101,402900,60,50520,10,"""8""",52020,52080
5530,402900,405300,120,50520,10,"""8""",52080,52200
5530,302100,302002,60,51720,10,"""8""",51720,51780
5530,302002,302202,120,51720,10,"""8""",51780,51900
5530,302202,303002,60,51720,10,"""8""",51900,51960
5530,303002,302502,120,51720,10,"""8""",51960,52080
5530,302502,119005,120,51720,10,"""8""",52080,52200
5530,119005,106503,60,51720,10,"""8""",52200,52260
5530,106503,103005,180,51720,10,"""8""",52260,52440
5530,103005,112107,120,51720,10,"""8""",52440,52560
5530,112107,403102,60,51720,10,"""8""",52560,52620
5530,403102,404102,120,51720,10,"""8""",52620,52740
5530,404102,407402,60,51720,10,"""8""",52740,52800
5530,407402,406604,60,51720,10,"""8""",52800,52860
5530,406604,400602,60,51720,10,"""8""",52860,52920
5530,400602,408300,120,51720,10,"""8""",52920,53040
5530,408300,406501,60,51720,10,"""8""",53040,53100
5530,406501,405901,60,51720,10,"""8""",53100,53160
5530,405901,405101,60,51720,10,"""8""",53160,53220
5530,405101,402900,60,51720,10,"""8""",53220,53280
5530,402900,405300,120,51720,10,"""8""",53280,53400
5530,302100,302002,60,52920,10,"""8""",52920,52980
5530,302002,302202,120,52920,10,"""8""",52980,53100
5530,302202,303002,60,52920,10,"""8""",53100,53160
5530,303002,302502,120,52920,10,"""8""",53160,53280
5530,302502,119005,120,52920,10,"""8""",53280,53400
5530,119005,106503,60,52920,10,"""8""",53400,53460
5530,106503,103005,180,52920,10,"""8""",53460,53640
5530,103005,112107,120,52920,10,"""8""",53640,53760
5530,112107,403102,60,52920,10,"""8""",53760,53820
5530,403102,404102,120,52920,10,"""8""",53820,53940
5530,404102,407402,60,52920,10,"""8""",53940,54000
5530,407402,406604,60,52920,10,"""8""",54000,54060
5530,406604,400602,60,52920,10,"""8""",54060,54120
5530,400602,408300,120,52920,10,"""8""",54120,54240
5530,408300,406501,60,52920,10,"""8""",54240,54300
5530,406501,405901,60,52920,10,"""8""",54300,54360
5530,405901,405101,60,52920,10,"""8""",54360,54420
5530,405101,402900,60,52920,10,"""8""",54420,54480
5530,402900,405300,120,52920,10,"""8""",54480,54600
5530,302100,302002,60,54120,10,"""8""",54120,54180
5530,302002,302202,120,54120,10,"""8""",54180,54300
5530,302202,303002,60,54120,10,"""8""",54300,54360
5530,303002,302502,120,54120,10,"""8""",54360,54480
5530,302502,119005,120,54120,10,"""8""",54480,54600
5530,119005,106503,60,54120,10,"""8""",54600,54660
5530,106503,103005,180,54120,10,"""8""",54660,54840
5530,103005,112107,120,54120,10,"""8""",54840,54960
5530,112107,403102,60,54120,10,"""8""",54960,55020
5530,403102,404102,120,54120,10,"""8""",55020,55140
5530,404102,407402,60,54120,10,"""8""",55140,55200
5530,407402,406604,60,54120,10,"""8""",55200,55260
5530,406604,400602,60,54120,10,"""8""",55260,55320
5530,400602,408300,120,54120,10,"""8""",55320,55440
5530,408300,406501,60,54120,10,"""8""",55440,55500
5530,406501,405901,60,54120,10,"""8""",55500,55560
5530,405901,405101,60,54120,10,"""8""",55560,55620
5530,405101,402900,60,54120,10,"""8""",55620,55680
5530,402900,405300,120,54120,10,"""8""",55680,55800
5530,302100,302002,60,55320,10,"""8""",55320,55380
5530,302002,302202,120,55320,10,"""8""",55380,55500
5530,302202,303002,60,55320,10,"""8""",55500,55560
5530,303002,302502,120,55320,10,"""8""",55560,55680
5530,302502,119005,120,55320,10,"""8""",55680,55800
5530,119005,106503,60,55320,10,"""8""",55800,55860
5530,106503,103005,180,55320,10,"""8""",55860,56040
5530,103005,112107,120,55320,10,"""8""",56040,56160
5530,112107,403102,60,55320,10,"""8""",56160,56220
5530,403102,404102,120,55320,10,"""8""",56220,56340
5530,404102,407402,60,55320,10,"""8""",56340,56400
5530,407402,406604,60,55320,10,"""8""",56400,56460
5530,406604,400602,60,55320,10,"""8""",56460,56520
5530,400602,408300,120,55320,10,"""8""",56520,56640
5530,408300,406501,60,55320,10,"""8""",56640,56700
5530,406501,405901,60,55320,10,"""8""",56700,56760
5530,405901,405101,60,55320,10,"""8""",56760,56820
5530,405101,402900,60,55320,10,"""8""",56820,56880
5530,402900,405300,120,55320,10,"""8""",56880,57000
5530,302100,302002,60,56520,10,"""8""",56520,56580
5530,302002,302202,120,56520,10,"""8""",56580,56700
5530,302202,303002,60,56520,10,"""8""",56700,56760
5530,303002,302502,120,56520,10,"""8""",56760,56880
5530,302502,119005,120,56520,10,"""8""",56880,57000
5530,119005,106503,60,56520,10,"""8""",57000,57060
5530,106503,103005,180,56520,10,"""8""",57060,57240
5530,103005,112107,120,56520,10,"""8""",57240,57360
5530,112107,403102,60,56520,10,"""8""",57360,57420
5530,403102,404102,120,56520,10,"""8""",57420,57540
5530,404102,407402,60,56520,10,"""8""",57540,57600
5530,407402,406604,60,56520,10,"""8""",57600,57660
5530,406604,400602,60,56520,10,"""8""",57660,57720
5530,400602,408300,120,56520,10,"""8""",57720,57840
5530,408300,406501,60,56520,10,"""8""",57840,57900
5530,406501,405901,60,56520,10,"""8""",57900,57960
5530,405901,405101,60,56520,10,"""8""",57960,58020
5530,405101,402900,60,56520,10,"""8""",58020,58080
5530,402900,405300,120,56520,10,"""8""",58080,58200
5530,302100,302002,60,57720,10,"""8""",57720,57780
5530,302002,302202,120,57720,10,"""8""",57780,57900
5530,302202,303002,60,57720,10,"""8""",57900,57960
5530,303002,302502,120,57720,10,"""8""",57960,58080
5530,302502,119005,120,57720,10,"""8""",58080,58200
5530,119005,106503,60,57720,10,"""8""",58200,58260
5530,106503,103005,180,57720,10,"""8""",58260,58440
5530,103005,112107,120,57720,10,"""8""",58440,58560
5530,112107,403102,60,57720,10,"""8""",58560,58620
5530,403102,404102,120,57720,10,"""8""",58620,58740
5530,404102,407402,60,57720,10,"""8""",58740,58800
5530,407402,406604,60,57720,10,"""8""",58800,58860
5530,406604,400602,60,57720,10,"""8""",58860,58920
5530,400602,408300,120,57720,10,"""8""",58920,59040
5530,408300,406501,60,57720,10,"""8""",59040,59100
5530,406501,405901,60,57720,10,"""8""",59100,59160
5530,405901,405101,60,57720,10,"""8""",59160,59220
5530,405101,402900,60,57720,10,"""8""",59220,59280
5530,402900,405300,120,57720,10,"""8""",59280,59400
5530,302100,302002,60,58920,10,"""8""",58920,58980
5530,302002,302202,120,58920,10,"""8""",58980,59100
5530,302202,303002,60,58920,10,"""8""",59100,59160
5530,303002,302502,120,58920,10,"""8""",59160,59280
5530,302502,119005,120,58920,10,"""8""",59280,59400
5530,119005,106503,60,58920,10,"""8""",59400,59460
5530,106503,103005,180,58920,10,"""8""",59460,59640
5530,103005,112107,120,58920,10,"""8""",59640,59760
5530,112107,403102,60,58920,10,"""8""",59760,59820
5530,403102,404102,120,58920,10,"""8""",59820,59940
5530,404102,407402,60,58920,10,"""8""",59940,60000
5530,407402,406604,60,58920,10,"""8""",60000,60060
5530,406604,400602,60,58920,10,"""8""",60060,60120
5530,400602,408300,120,58920,10,"""8""",60120,60240
5530,408300,406501,60,58920,10,"""8""",60240,60300
5530,406501,405901,60,58920,10,"""8""",60300,60360
5530,405901,405101,60,58920,10,"""8""",60360,60420
5530,405101,402900,60,58920,10,"""8""",60420,60480
5530,402900,405300,120,58920,10,"""8""",60480,60600
5530,302100,302002,60,60120,10,"""8""",60120,60180
5530,302002,302202,120,60120,10,"""8""",60180,60300
5530,302202,303002,60,60120,10,"""8""",60300,60360
5530,303002,302502,120,60120,10,"""8""",60360,60480
5530,302502,119005,120,60120,10,"""8""",60480,60600
5530,119005,106503,60,60120,10,"""8""",60600,60660
5530,106503,103005,180,60120,10,"""8""",60660,60840
5530,103005,112107,120,60120,10,"""8""",60840,60960
5530,112107,403102,60,60120,10,"""8""",60960,61020
5530,403102,404102,120,60120,10,"""8""",61020,61140
5530,404102,407402,60,60120,10,"""8""",61140,61200
5530,407402,406604,60,60120,10,"""8""",61200,61260
5530,406604,400602,60,60120,10,"""8""",61260,61320
5530,400602,408300,120,60120,10,"""8""",61320,61440
5530,408300,406501,60,60120,10,"""8""",61440,61500
5530,406501,405901,60,60120,10,"""8""",61500,61560
5530,405901,405101,60,60120,10,"""8""",61560,61620
5530,405101,402900,60,60120,10,"""8""",61620,61680
5530,402900,405300,120,60120,10,"""8""",61680,61800
5530,302100,302002,60,61320,10,"""8""",61320,61380
5530,302002,302202,120,61320,10,"""8""",61380,61500
5530,302202,303002,60,61320,10,"""8""",61500,61560
5530,303002,302502,120,61320,10,"""8""",61560,61680
5530,302502,119005,120,61320,10,"""8""",61680,61800
5530,119005,106503,60,61320,10,"""8""",61800,61860
5530,106503,103005,180,61320,10,"""8""",61860,62040
5530,103005,112107,120,61320,10,"""8""",62040,62160
5530,112107,403102,60,61320,10,"""8""",62160,62220
5530,403102,404102,120,61320,10,"""8""",62220,62340
5530,404102,407402,60,61320,10,"""8""",62340,62400
5530,407402,406604,60,61320,10,"""8""",62400,62460
5530,406604,400602,60,61320,10,"""8""",62460,62520
5530,400602,408300,120,61320,10,"""8""",62520,62640
5530,408300,406501,60,61320,10,"""8""",62640,62700
5530,406501,405901,60,61320,10,"""8""",62700,62760
5530,405901,405101,60,61320,10,"""8""",62760,62820
5530,405101,402900,60,61320,10,"""8""",62820,62880
5530,402900,405300,120,61320,10,"""8""",62880,63000
5530,302100,302002,60,62520,10,"""8""",62520,62580
5530,302002,302202,120,62520,10,"""8""",62580,62700
5530,302202,303002,60,62520,10,"""8""",62700,62760
5530,303002,302502,120,62520,10,"""8""",62760,62880
5530,302502,119005,120,62520,10,"""8""",62880,63000
5530,119005,106503,60,62520,10,"""8""",63000,63060
5530,106503,103005,180,62520,10,"""8""",63060,63240
5530,103005,112107,120,62520,10,"""8""",63240,63360
5530,112107,403102,60,62520,10,"""8""",63360,63420
5530,403102,404102,120,62520,10,"""8""",63420,63540
5530,404102,407402,60,62520,10,"""8""",63540,63600
5530,407402,406604,60,62520,10,"""8""",63600,63660
5530,406604,400602,60,62520,10,"""8""",63660,63720
5530,400602,408300,120,62520,10,"""8""",63720,63840
5530,408300,406501,60,62520,10,"""8""",63840,63900
5530,406501,405901,60,62520,10,"""8""",63900,63960
5530,405901,405101,60,62520,10,"""8""",63960,64020
5530,405101,402900,60,62520,10,"""8""",64020,64080
5530,402900,405300,120,62520,10,"""8""",64080,64200
5530,302100,302002,60,63720,10,"""8""",63720,63780
5530,302002,302202,120,63720,10,"""8""",63780,63900
5530,302202,303002,60,63720,10,"""8""",63900,63960
5530,303002,302502,120,63720,10,"""8""",63960,64080
5530,302502,119005,120,63720,10,"""8""",64080,64200
5530,119005,106503,60,63720,10,"""8""",64200,64260
5530,106503,103005,180,63720,10,"""8""",64260,64440
5530,103005,112107,120,63720,10,"""8""",64440,64560
5530,112107,403102,60,63720,10,"""8""",64560,64620
5530,403102,404102,120,63720,10,"""8""",64620,64740
5530,404102,407402,60,63720,10,"""8""",64740,64800
5530,407402,406604,60,63720,10,"""8""",64800,64860
5530,406604,400602,60,63720,10,"""8""",64860,64920
5530,400602,408300,120,63720,10,"""8""",64920,65040
5530,408300,406501,60,63720,10,"""8""",65040,65100
5530,406501,405901,60,63720,10,"""8""",65100,65160
5530,405901,405101,60,63720,10,"""8""",65160,65220
5530,405101,402900,60,63720,10,"""8""",65220,65280
5530,402900,405300,120,63720,10,"""8""",65280,65400
5530,302100,302002,60,64920,10,"""8""",64920,64980
5530,302002,302202,120,64920,10,"""8""",64980,65100
5530,302202,303002,60,64920,10,"""8""",65100,65160
5530,303002,302502,120,64920,10,"""8""",65160,65280
5530,302502,119005,120,64920,10,"""8""",65280,65400
5530,119005,106503,60,64920,10,"""8""",65400,65460
5530,106503,103005,180,64920,10,"""8""",65460,65640
5530,103005,112107,120,64920,10,"""8""",65640,65760
5530,112107,403102,60,64920,10,"""8""",65760,65820
5530,403102,404102,120,64920,10,"""8""",65820,65940
5530,404102,407402,60,64920,10,"""8""",65940,66000
5530,407402,406604,60,64920,10,"""8""",66000,66060
5530,406604,400602,60,64920,10,"""8""",66060,66120
5530,400602,408300,120,64920,10,"""8""",66120,66240
5530,408300,406501,60,64920,10,"""8""",66240,66300
5530,406501,405901,60,64920,10,"""8""",66300,66360
5530,405901,405101,60,64920,10,"""8""",66360,66420
5530,405101,402900,60,64920,10,"""8""",66420,66480
5530,402900,405300,120,64920,10,"""8""",66480,66600
5530,302100,302002,60,66120,10,"""8""",66120,66180
5530,302002,302202,120,66120,10,"""8""",66180,66300
5530,302202,303002,60,66120,10,"""8""",66300,66360
5530,303002,302502,120,66120,10,"""8""",66360,66480
5530,302502,119005,120,66120,10,"""8""",66480,66600
5530,119005,106503,60,66120,10,"""8""",66600,66660
5530,106503,103005,180,66120,10,"""8""",66660,66840
5530,103005,112107,120,66120,10,"""8""",66840,66960
5530,112107,403102,60,66120,10,"""8""",66960,67020
5530,403102,404102,120,66120,10,"""8""",67020,67140
5530,404102,407402,60,66120,10,"""8""",67140,67200
5530,407402,406604,60,66120,10,"""8""",67200,67260
5530,406604,400602,60,66120,10,"""8""",67260,67320
5530,400602,408300,120,66120,10,"""8""",67320,67440
5530,408300,406501,60,66120,10,"""8""",67440,67500
5530,406501,405901,60,66120,10,"""8""",67500,67560
5530,405901,405101,60,66120,10,"""8""",67560,67620
5530,405101,402900,60,66120,10,"""8""",67620,67680
5530,402900,405300,120,66120,10,"""8""",67680,67800
5530,302100,302002,60,68400,10,"""8""",68400,68460
5530,302002,302202,120,68400,10,"""8""",68460,68580
5530,302202,303002,60,68400,10,"""8""",68580,68640
5530,303002,302502,120,68400,10,"""8""",68640,68760
5530,302502,119005,120,68400,10,"""8""",68760,68880
5530,119005,106503,60,68400,10,"""8""",68880,68940
5530,106503,103005,180,68400,10,"""8""",68940,69120
5530,103005,112107,120,68400,10,"""8""",69120,69240
5530,112107,403102,60,68400,10,"""8""",69240,69300
5530,403102,404102,120,68400,10,"""8""",69300,69420
5530,404102,407402,60,68400,10,"""8""",69420,69480
5530,407402,406604,60,68400,10,"""8""",69480,69540
5530,406604,400602,60,68400,10,"""8""",69540,69600
5530,400602,408300,120,68400,10,"""8""",69600,69720
5530,408300,406501,60,68400,10,"""8""",69720,69780
5530,406501,405901,60,68400,10,"""8""",69780,69840
5530,405901,405101,60,68400,10,"""8""",69840,69900
5530,405101,402900,60,68400,10,"""8""",69900,69960
5530,402900,405300,120,68400,10,"""8""",69960,70080
5531,302100,302002,60,21840,10,"""8""",21840,21900
5531,302002,302202,60,21840,10,"""8""",21900,21960
5531,302202,303002,60,21840,10,"""8""",21960,22020
5531,303002,302502,120,21840,10,"""8""",22020,22140
5531,302502,119005,120,21840,10,"""8""",22140,22260
5531,119005,106503,60,21840,10,"""8""",22260,22320
5531,106503,103005,120,21840,10,"""8""",22320,22440
5531,103005,112107,120,21840,10,"""8""",22440,22560
5531,112107,403102,60,21840,10,"""8""",22560,22620
5531,403102,404102,60,21840,10,"""8""",22620,22680
5531,404102,407402,60,21840,10,"""8""",22680,22740
5531,407402,406604,60,21840,10,"""8""",22740,22800
5531,406604,400602,60,21840,10,"""8""",22800,22860
5531,400602,408300,120,21840,10,"""8""",22860,22980
5531,408300,406501,60,21840,10,"""8""",22980,23040
5531,406501,405901,60,21840,10,"""8""",23040,23100
5531,405901,405101,60,21840,10,"""8""",23100,23160
5531,405101,402900,60,21840,10,"""8""",23160,23220
5531,402900,405300,120,21840,10,"""8""",23220,23340
5531,302100,302002,60,23040,10,"""8""",23040,23100
5531,302002,302202,60,23040,10,"""8""",23100,23160
5531,302202,303002,60,23040,10,"""8""",23160,23220
5531,303002,302502,120,23040,10,"""8""",23220,23340
5531,302502,119005,120,23040,10,"""8""",23340,23460
5531,119005,106503,60,23040,10,"""8""",23460,23520
5531,106503,103005,120,23040,10,"""8""",23520,23640
5531,103005,112107,120,23040,10,"""8""",23640,23760
5531,112107,403102,60,23040,10,"""8""",23760,23820
5531,403102,404102,60,23040,10,"""8""",23820,23880
5531,404102,407402,60,23040,10,"""8""",23880,23940
5531,407402,406604,60,23040,10,"""8""",23940,24000
5531,406604,400602,60,23040,10,"""8""",24000,24060
5531,400602,408300,120,23040,10,"""8""",24060,24180
5531,408300,406501,60,23040,10,"""8""",24180,24240
5531,406501,405901,60,23040,10,"""8""",24240,24300
5531,405901,405101,60,23040,10,"""8""",24300,24360
5531,405101,402900,60,23040,10,"""8""",24360,24420
5531,402900,405300,120,23040,10,"""8""",24420,24540
5531,302100,302002,60,24240,10,"""8""",24240,24300
5531,302002,302202,60,24240,10,"""8""",24300,24360
5531,302202,303002,60,24240,10,"""8""",24360,24420
5531,303002,302502,120,24240,10,"""8""",24420,24540
5531,302502,119005,120,24240,10,"""8""",24540,24660
5531,119005,106503,60,24240,10,"""8""",24660,24720
5531,106503,103005,120,24240,10,"""8""",24720,24840
5531,103005,112107,120,24240,10,"""8""",24840,24960
5531,112107,403102,60,24240,10,"""8""",24960,25020
5531,403102,404102,60,24240,10,"""8""",25020,25080
5531,404102,407402,60,24240,10,"""8""",25080,25140
5531,407402,406604,60,24240,10,"""8""",25140,25200
5531,406604,400602,60,24240,10,"""8""",25200,25260
5531,400602,408300,120,24240,10,"""8""",25260,25380
5531,408300,406501,60,24240,10,"""8""",25380,25440
5531,406501,405901,60,24240,10,"""8""",25440,25500
5531,405901,405101,60,24240,10,"""8""",25500,25560
5531,405101,402900,60,24240,10,"""8""",25560,25620
5531,402900,405300,120,24240,10,"""8""",25620,25740
5532,112107,403102,60,66420,10,"""12""",66420,66480
5532,403102,404102,120,66420,10,"""12""",66480,66600
5532,404102,407402,60,66420,10,"""12""",66600,66660
5532,407402,406604,60,66420,10,"""12""",66660,66720
5532,406604,400602,60,66420,10,"""12""",66720,66780
5532,400602,408300,120,66420,10,"""12""",66780,66900
5532,408300,406501,60,66420,10,"""12""",66900,66960
5532,406501,405901,60,66420,10,"""12""",66960,67020
5532,405901,405101,60,66420,10,"""12""",67020,67080
5532,405101,402900,60,66420,10,"""12""",67080,67140
5532,402900,405300,120,66420,10,"""12""",67140,67260
5532,405300,402800,60,66420,10,"""12""",67260,67320
5532,402800,402203,60,66420,10,"""12""",67320,67380
5532,402203,500701,60,66420,10,"""12""",67380,67440
5532,500701,402001,60,66420,10,"""12""",67440,67500
5532,402001,400401,120,66420,10,"""12""",67500,67620
5532,400401,400200,60,66420,10,"""12""",67620,67680
5532,112107,403102,60,67620,10,"""12""",67620,67680
5532,403102,404102,120,67620,10,"""12""",67680,67800
5532,404102,407402,60,67620,10,"""12""",67800,67860
5532,407402,406604,60,67620,10,"""12""",67860,67920
5532,406604,400602,60,67620,10,"""12""",67920,67980
5532,400602,408300,120,67620,10,"""12""",67980,68100
5532,408300,406501,60,67620,10,"""12""",68100,68160
5532,406501,405901,60,67620,10,"""12""",68160,68220
5532,405901,405101,60,67620,10,"""12""",68220,68280
5532,405101,402900,60,67620,10,"""12""",68280,68340
5532,402900,405300,120,67620,10,"""12""",68340,68460
5532,405300,402800,60,67620,10,"""12""",68460,68520
5532,402800,402203,60,67620,10,"""12""",68520,68580
5532,402203,500701,60,67620,10,"""12""",68580,68640
5532,500701,402001,60,67620,10,"""12""",68640,68700
5532,402001,400401,120,67620,10,"""12""",68700,68820
5532,400401,400200,60,67620,10,"""12""",68820,68880
5543,205102,201401,120,27180,70,"""1""",27180,27300
5543,201401,203301,60,27180,70,"""1""",27300,27360
5543,203301,200600,180,27180,70,"""1""",27360,27540
5543,200600,204200,60,27180,70,"""1""",27540,27600
5543,204200,204500,60,27180,70,"""1""",27600,27660
5543,204500,200500,120,27180,70,"""1""",27660,27780
5543,200500,205300,420,27180,70,"""1""",27780,28200
5544,205300,205102,300,41400,70,"""2""",41400,41700
5544,205102,201401,120,41400,70,"""2""",41700,41820
5544,201401,203301,60,41400,70,"""2""",41820,41880
5544,203301,200600,180,41400,70,"""2""",41880,42060
5544,200600,204200,60,41400,70,"""2""",42060,42120
5544,204200,204500,60,41400,70,"""2""",42120,42180
5544,204500,200500,120,41400,70,"""2""",42180,42300
5544,205300,205102,300,44700,70,"""2""",44700,45000
5544,205102,201401,120,44700,70,"""2""",45000,45120
5544,201401,203301,60,44700,70,"""2""",45120,45180
5544,203301,200600,180,44700,70,"""2""",45180,45360
5544,200600,204200,60,44700,70,"""2""",45360,45420
5544,204200,204500,60,44700,70,"""2""",45420,45480
5544,204500,200500,120,44700,70,"""2""",45480,45600
5544,205300,205102,300,47400,70,"""2""",47400,47700
5544,205102,201401,120,47400,70,"""2""",47700,47820
5544,201401,203301,60,47400,70,"""2""",47820,47880
5544,203301,200600,180,47400,70,"""2""",47880,48060
5544,200600,204200,60,47400,70,"""2""",48060,48120
5544,204200,204500,60,47400,70,"""2""",48120,48180
5544,204500,200500,120,47400,70,"""2""",48180,48300
5545,32200,101103,600,47400,71,"""2""",48300,48900
5545,101103,109012,240,47400,71,"""2""",48900,49140
5545,32200,101103,600,58200,71,"""2""",58200,58800
5545,101103,109012,240,58200,71,"""2""",58800,59040
5546,406903,406702,60,25920,72,"""1""",25920,25980
5546,406702,302603,60,25920,72,"""1""",25980,26040
5546,302603,406002,60,25920,72,"""1""",26040,26100
5546,406002,404700,180,25920,72,"""1""",26100,26280
5546,404700,403601,60,25920,72,"""1""",26280,26340
5546,403601,402601,120,25920,72,"""1""",26340,26460
5546,402601,403700,60,25920,72,"""1""",26460,26520
5546,403700,403501,0,25920,72,"""1""",26520,26520
5546,403501,408402,60,25920,72,"""1""",26520,26580
5546,408402,407701,60,25920,72,"""1""",26580,26640
5546,407701,400601,120,25920,72,"""1""",26640,26760
5546,400601,407200,60,25920,72,"""1""",26760,26820
5546,407200,101102,120,25920,72,"""1""",26820,26940
5546,101102,502202,300,25920,72,"""1""",26940,27240
5546,502202,501003,60,25920,72,"""1""",27240,27300
5546,501003,16302,120,25920,72,"""1""",27300,27420
5547,16301,501001,60,47160,72,"""2""",47160,47220
5547,501001,502201,120,47160,72,"""2""",47220,47340
5547,502201,102002,240,47160,72,"""2""",47340,47580
5547,102002,101101,120,47160,72,"""2""",47580,47700
5547,101101,403802,120,47160,72,"""2""",47700,47820
5547,403802,408300,120,47160,72,"""2""",47820,47940
5547,408300,406502,60,47160,72,"""2""",47940,48000
5547,406502,407702,60,47160,72,"""2""",48000,48060
5547,407702,408403,60,47160,72,"""2""",48060,48120
5547,408403,403502,60,47160,72,"""2""",48120,48180
5547,403502,402602,120,47160,72,"""2""",48180,48300
5547,402602,403602,120,47160,72,"""2""",48300,48420
5547,403602,404701,120,47160,72,"""2""",48420,48540
5547,404701,32100,60,47160,72,"""2""",48540,48600
5547,32100,406001,60,47160,72,"""2""",48600,48660
5547,406001,302602,60,47160,72,"""2""",48660,48720
5547,302602,406701,60,47160,72,"""2""",48720,48780
5547,406701,406902,60,47160,72,"""2""",48780,48840
5553,503300,501900,120,47820,73,"""13""",47820,47940
5553,501900,501704,120,47820,73,"""13""",47940,48060
5553,501704,502502,60,47820,73,"""13""",48060,48120
5553,502502,501500,60,47820,73,"""13""",48120,48180
5553,501500,500500,60,47820,73,"""13""",48180,48240
5553,500500,500300,60,47820,73,"""13""",48240,48300
5553,500300,500200,60,47820,73,"""13""",48300,48360
5553,500200,502300,180,47820,73,"""13""",48360,48540
5554,109006,101104,180,27000,73,"""6""",27000,27180
5554,101104,102001,180,27000,73,"""6""",27180,27360
5554,102001,103801,600,27000,73,"""6""",27360,27960
5556,802501,802801,60,25920,74,"""1""",25920,25980
5556,802801,801202,120,25920,74,"""1""",25980,26100
5556,801202,801002,60,25920,74,"""1""",26100,26160
5556,801002,800801,120,25920,74,"""1""",26160,26280
5556,800801,803001,180,25920,74,"""1""",26280,26460
5556,803001,803101,120,25920,74,"""1""",26460,26580
5556,803101,107801,60,25920,74,"""1""",26580,26640
5556,107801,207201,120,25920,74,"""1""",26640,26760
5556,207201,207002,120,25920,74,"""1""",26760,26880
5556,207002,207302,120,25920,74,"""1""",26880,27000
5556,207302,207102,120,25920,74,"""1""",27000,27120
5556,207102,203002,60,25920,74,"""1""",27120,27180
5556,203002,201602,120,25920,74,"""1""",27180,27300
5556,201602,208004,120,25920,74,"""1""",27300,27420
5556,208004,203604,120,25920,74,"""1""",27420,27540
5556,203604,201903,60,25920,74,"""1""",27540,27600
5556,201903,203900,120,25920,74,"""1""",27600,27720
5556,203900,201503,60,25920,74,"""1""",27720,27780
5557,201902,208003,180,47040,74,"""2""",47040,47220
5557,208003,201601,60,47040,74,"""2""",47220,47280
5557,201601,203001,60,47040,74,"""2""",47280,47340
5557,203001,207101,60,47040,74,"""2""",47340,47400
5557,207101,207301,60,47040,74,"""2""",47400,47460
5557,207301,207001,60,47040,74,"""2""",47460,47520
5557,207001,207202,60,47040,74,"""2""",47520,47580
5560,33800,600203,60,26160,75,"""1""",26160,26220
5560,600203,600802,60,26160,75,"""1""",26220,26280
5560,600802,602802,120,26160,75,"""1""",26280,26400
5560,602802,600302,120,26160,75,"""1""",26400,26520
5560,600302,600502,120,26160,75,"""1""",26520,26640
5560,600502,601002,180,26160,75,"""1""",26640,26820
5560,601002,600903,240,26160,75,"""1""",26820,27060
5560,600903,601301,120,26160,75,"""1""",27060,27180
5560,601301,601401,240,26160,75,"""1""",27180,27420
5560,601401,601106,300,26160,75,"""1""",27420,27720
5560,601106,204703,120,26160,75,"""1""",27720,27840
5560,204703,204801,120,26160,75,"""1""",27840,27960
5560,204801,203903,120,26160,75,"""1""",27960,28080
5560,203903,201902,60,26160,75,"""1""",28080,28140
5561,201903,203904,120,47400,75,"""2""",47400,47520
5561,203904,204802,60,47400,75,"""2""",47520,47580
5561,204802,204704,60,47400,75,"""2""",47580,47640
5561,204704,601401,240,47400,75,"""2""",47640,47880
5561,601401,601103,240,47400,75,"""2""",47880,48120
5561,601103,601302,60,47400,75,"""2""",48120,48180
5561,601302,600904,60,47400,75,"""2""",48180,48240
5561,600904,601201,120,47400,75,"""2""",48240,48360
5561,601201,601001,60,47400,75,"""2""",48360,48420
5561,601001,601500,60,47400,75,"""2""",48420,48480
5561,601500,600501,120,47400,75,"""2""",48480,48600
5561,600501,600301,120,47400,75,"""2""",48600,48720
5561,600301,602801,120,47400,75,"""2""",48720,48840
5561,602801,600801,120,47400,75,"""2""",48840,48960
5561,600801,600202,120,47400,75,"""2""",48960,49080
5561,600202,33800,60,47400,75,"""2""",49080,49140
5562,109009,101104,180,47040,75,"""6""",47040,47220
5562,101104,502802,180,47040,75,"""6""",47220,47400
5562,502802,16301,120,47040,75,"""6""",47400,47520
5562,16301,501001,60,47040,75,"""6""",47520,47580
5562,501001,500802,120,47040,75,"""6""",47580,47700
5562,500802,500103,60,47040,75,"""6""",47700,47760
5562,500103,501202,60,47040,75,"""6""",47760,47820
5562,501202,601001,120,47040,75,"""6""",47820,47940
5562,601001,600501,120,47040,75,"""6""",47940,48060
5562,600501,600301,120,47040,75,"""6""",48060,48180
5562,600301,602801,120,47040,75,"""6""",48180,48300
5562,602801,600801,120,47040,75,"""6""",48300,48420
5562,600801,600202,120,47040,75,"""6""",48420,48540
5562,600202,33800,60,47040,75,"""6""",48540,48600
5573,109009,105202,60,26640,77,"""1""",26640,26700
5573,105202,117001,180,26640,77,"""1""",26700,26880
5573,117001,119003,120,26640,77,"""1""",26880,27000
5573,119003,208102,180,26640,77,"""1""",27000,27180
5573,208102,201502,120,26640,77,"""1""",27180,27300
5573,201502,203903,60,26640,77,"""1""",27300,27360
5573,203903,201902,60,26640,77,"""1""",27360,27420
5573,201902,203601,60,26640,77,"""1""",27420,27480
5573,203601,205602,120,26640,77,"""1""",27480,27600
5573,205602,201000,60,26640,77,"""1""",27600,27660
5573,201000,200400,60,26640,77,"""1""",27660,27720
5573,200400,204600,120,26640,77,"""1""",27720,27840
5573,204600,200600,0,26640,77,"""1""",27840,27840
5573,200600,208902,120,26640,77,"""1""",27840,27960
5573,208902,61604,60,26640,77,"""1""",27960,28020
5573,61604,203501,60,26640,77,"""1""",28020,28080
5573,203501,203401,60,26640,77,"""1""",28080,28140
5573,203401,204001,60,26640,77,"""1""",28140,28200
5573,204001,34601,60,26640,77,"""1""",28200,28260
5573,34601,202200,120,26640,77,"""1""",28260,28380
5574,109009,105202,60,19140,77,"""1""",19140,19200
5574,105202,117001,120,19140,77,"""1""",19200,19320
5574,117001,119003,120,19140,77,"""1""",19320,19440
5574,119003,208102,120,19140,77,"""1""",19440,19560
5574,208102,201502,120,19140,77,"""1""",19560,19680
5574,201502,203903,60,19140,77,"""1""",19680,19740
5574,203903,201902,60,19140,77,"""1""",19740,19800
5574,201902,203601,60,19140,77,"""1""",19800,19860
5574,203601,205602,120,19140,77,"""1""",19860,19980
5574,205602,201000,60,19140,77,"""1""",19980,20040
5574,201000,200400,60,19140,77,"""1""",20040,20100
5574,200400,204600,120,19140,77,"""1""",20100,20220
5574,204600,200600,0,19140,77,"""1""",20220,20220
5574,200600,208902,120,19140,77,"""1""",20220,20340
5574,208902,61604,60,19140,77,"""1""",20340,20400
5574,61604,203501,60,19140,77,"""1""",20400,20460
5574,203501,203401,60,19140,77,"""1""",20460,20520
5574,203401,204001,60,19140,77,"""1""",20520,20580
5574,204001,34601,60,19140,77,"""1""",20580,20640
5574,34601,202200,120,19140,77,"""1""",20640,20760
5575,109009,105202,60,20820,77,"""1""",20820,20880
5575,105202,117001,120,20820,77,"""1""",20880,21000
5575,117001,119003,120,20820,77,"""1""",21000,21120
5575,119003,208102,120,20820,77,"""1""",21120,21240
5575,208102,201502,120,20820,77,"""1""",21240,21360
5575,201502,203903,60,20820,77,"""1""",21360,21420
5575,203903,201902,60,20820,77,"""1""",21420,21480
5575,201902,203601,60,20820,77,"""1""",21480,21540
5575,203601,205602,120,20820,77,"""1""",21540,21660
5575,205602,201000,60,20820,77,"""1""",21660,21720
5575,201000,200400,60,20820,77,"""1""",21720,21780
5575,200400,204600,60,20820,77,"""1""",21780,21840
5575,204600,200600,0,20820,77,"""1""",21840,21840
5575,200600,208902,120,20820,77,"""1""",21840,21960
5575,208902,61604,60,20820,77,"""1""",21960,22020
5575,61604,203501,60,20820,77,"""1""",22020,22080
5575,203501,203401,60,20820,77,"""1""",22080,22140
5575,203401,204001,60,20820,77,"""1""",22140,22200
5575,204001,34601,60,20820,77,"""1""",22200,22260
5575,34601,202200,120,20820,77,"""1""",22260,22380
5575,109009,105202,60,23220,77,"""1""",23220,23280
5575,105202,117001,120,23220,77,"""1""",23280,23400
5575,117001,119003,120,23220,77,"""1""",23400,23520
5575,119003,208102,120,23220,77,"""1""",23520,23640
5575,208102,201502,120,23220,77,"""1""",23640,23760
5575,201502,203903,60,23220,77,"""1""",23760,23820
5575,203903,201902,60,23220,77,"""1""",23820,23880
5575,201902,203601,60,23220,77,"""1""",23880,23940
5575,203601,205602,120,23220,77,"""1""",23940,24060
5575,205602,201000,60,23220,77,"""1""",24060,24120
5575,201000,200400,60,23220,77,"""1""",24120,24180
5575,200400,204600,60,23220,77,"""1""",24180,24240
5575,204600,200600,0,23220,77,"""1""",24240,24240
5575,200600,208902,120,23220,77,"""1""",24240,24360
5575,208902,61604,60,23220,77,"""1""",24360,24420
5575,61604,203501,60,23220,77,"""1""",24420,24480
5575,203501,203401,60,23220,77,"""1""",24480,24540
5575,203401,204001,60,23220,77,"""1""",24540,24600
5575,204001,34601,60,23220,77,"""1""",24600,24660
5575,34601,202200,120,23220,77,"""1""",24660,24780
5578,202200,34602,120,23160,77,"""42""",23160,23280
5578,34602,204002,60,23160,77,"""42""",23280,23340
5578,204002,203402,60,23160,77,"""42""",23340,23400
5578,203402,203502,60,23160,77,"""42""",23400,23460
5578,203502,61603,60,23160,77,"""42""",23460,23520
5578,61603,208901,60,23160,77,"""42""",23520,23580
5578,208901,204602,120,23160,77,"""42""",23580,23700
5578,202200,34602,120,24900,77,"""42""",24900,25020
5578,34602,204002,60,24900,77,"""42""",25020,25080
5578,204002,203402,60,24900,77,"""42""",25080,25140
5578,203402,203502,60,24900,77,"""42""",25140,25200
5578,203502,61603,60,24900,77,"""42""",25200,25260
5578,61603,208901,60,24900,77,"""42""",25260,25320
5578,208901,204602,120,24900,77,"""42""",25320,25440
5578,202200,34602,120,27300,77,"""42""",27300,27420
5578,34602,204002,60,27300,77,"""42""",27420,27480
5578,204002,203402,60,27300,77,"""42""",27480,27540
5578,203402,203502,60,27300,77,"""42""",27540,27600
5578,203502,61603,60,27300,77,"""42""",27600,27660
5578,61603,208901,60,27300,77,"""42""",27660,27720
5578,208901,204602,120,27300,77,"""42""",27720,27840
5578,202200,34602,120,28500,77,"""42""",28500,28620
5578,34602,204002,60,28500,77,"""42""",28620,28680
5578,204002,203402,60,28500,77,"""42""",28680,28740
5578,203402,203502,60,28500,77,"""42""",28740,28800
5578,203502,61603,60,28500,77,"""42""",28800,28860
5578,61603,208901,60,28500,77,"""42""",28860,28920
5578,208901,204602,120,28500,77,"""42""",28920,29040
5578,202200,34602,120,29700,77,"""42""",29700,29820
5578,34602,204002,60,29700,77,"""42""",29820,29880
5578,204002,203402,60,29700,77,"""42""",29880,29940
5578,203402,203502,60,29700,77,"""42""",29940,30000
5578,203502,61603,60,29700,77,"""42""",30000,30060
5578,61603,208901,60,29700,77,"""42""",30060,30120
5578,208901,204602,120,29700,77,"""42""",30120,30240
5578,202200,34602,120,30900,77,"""42""",30900,31020
5578,34602,204002,60,30900,77,"""42""",31020,31080
5578,204002,203402,60,30900,77,"""42""",31080,31140
5578,203402,203502,60,30900,77,"""42""",31140,31200
5578,203502,61603,60,30900,77,"""42""",31200,31260
5578,61603,208901,60,30900,77,"""42""",31260,31320
5578,208901,204602,120,30900,77,"""42""",31320,31440
5578,202200,34602,120,40500,77,"""42""",40500,40620
5578,34602,204002,60,40500,77,"""42""",40620,40680
5578,204002,203402,60,40500,77,"""42""",40680,40740
5578,203402,203502,60,40500,77,"""42""",40740,40800
5578,203502,61603,60,40500,77,"""42""",40800,40860
5578,61603,208901,60,40500,77,"""42""",40860,40920
5578,208901,204602,120,40500,77,"""42""",40920,41040
5578,202200,34602,120,43500,77,"""42""",43500,43620
5578,34602,204002,60,43500,77,"""42""",43620,43680
5578,204002,203402,60,43500,77,"""42""",43680,43740
5578,203402,203502,60,43500,77,"""42""",43740,43800
5578,203502,61603,60,43500,77,"""42""",43800,43860
5578,61603,208901,60,43500,77,"""42""",43860,43920
5578,208901,204602,120,43500,77,"""42""",43920,44040
5578,202200,34602,120,44700,77,"""42""",44700,44820
5578,34602,204002,60,44700,77,"""42""",44820,44880
5578,204002,203402,60,44700,77,"""42""",44880,44940
5578,203402,203502,60,44700,77,"""42""",44940,45000
5578,203502,61603,60,44700,77,"""42""",45000,45060
5578,61603,208901,60,44700,77,"""42""",45060,45120
5578,208901,204602,120,44700,77,"""42""",45120,45240
5578,202200,34602,120,45900,77,"""42""",45900,46020
5578,34602,204002,60,45900,77,"""42""",46020,46080
5578,204002,203402,60,45900,77,"""42""",46080,46140
5578,203402,203502,60,45900,77,"""42""",46140,46200
5578,203502,61603,60,45900,77,"""42""",46200,46260
5578,61603,208901,60,45900,77,"""42""",46260,46320
5578,208901,204602,120,45900,77,"""42""",46320,46440
5578,202200,34602,120,47100,77,"""42""",47100,47220
5578,34602,204002,60,47100,77,"""42""",47220,47280
5578,204002,203402,60,47100,77,"""42""",47280,47340
5578,203402,203502,60,47100,77,"""42""",47340,47400
5578,203502,61603,60,47100,77,"""42""",47400,47460
5578,61603,208901,60,47100,77,"""42""",47460,47520
5578,208901,204602,120,47100,77,"""42""",47520,47640
5578,202200,34602,120,48300,77,"""42""",48300,48420
5578,34602,204002,60,48300,77,"""42""",48420,48480
5578,204002,203402,60,48300,77,"""42""",48480,48540
5578,203402,203502,60,48300,77,"""42""",48540,48600
5578,203502,61603,60,48300,77,"""42""",48600,48660
5578,61603,208901,60,48300,77,"""42""",48660,48720
5578,208901,204602,120,48300,77,"""42""",48720,48840
5578,202200,34602,120,49500,77,"""42""",49500,49620
5578,34602,204002,60,49500,77,"""42""",49620,49680
5578,204002,203402,60,49500,77,"""42""",49680,49740
5578,203402,203502,60,49500,77,"""42""",49740,49800
5578,203502,61603,60,49500,77,"""42""",49800,49860
5578,61603,208901,60,49500,77,"""42""",49860,49920
5578,208901,204602,120,49500,77,"""42""",49920,50040
5578,202200,34602,120,50700,77,"""42""",50700,50820
5578,34602,204002,60,50700,77,"""42""",50820,50880
5578,204002,203402,60,50700,77,"""42""",50880,50940
5578,203402,203502,60,50700,77,"""42""",50940,51000
5578,203502,61603,60,50700,77,"""42""",51000,51060
5578,61603,208901,60,50700,77,"""42""",51060,51120
5578,208901,204602,120,50700,77,"""42""",51120,51240
5578,202200,34602,120,51900,77,"""42""",51900,52020
5578,34602,204002,60,51900,77,"""42""",52020,52080
5578,204002,203402,60,51900,77,"""42""",52080,52140
5578,203402,203502,60,51900,77,"""42""",52140,52200
5578,203502,61603,60,51900,77,"""42""",52200,52260
5578,61603,208901,60,51900,77,"""42""",52260,52320
5578,208901,204602,120,51900,77,"""42""",52320,52440
5578,202200,34602,120,54900,77,"""42""",54900,55020
5578,34602,204002,60,54900,77,"""42""",55020,55080
5578,204002,203402,60,54900,77,"""42""",55080,55140
5578,203402,203502,60,54900,77,"""42""",55140,55200
5578,203502,61603,60,54900,77,"""42""",55200,55260
5578,61603,208901,60,54900,77,"""42""",55260,55320
5578,208901,204602,120,54900,77,"""42""",55320,55440
5578,202200,34602,120,56100,77,"""42""",56100,56220
5578,34602,204002,60,56100,77,"""42""",56220,56280
5578,204002,203402,60,56100,77,"""42""",56280,56340
5578,203402,203502,60,56100,77,"""42""",56340,56400
5578,203502,61603,60,56100,77,"""42""",56400,56460
5578,61603,208901,60,56100,77,"""42""",56460,56520
5578,208901,204602,120,56100,77,"""42""",56520,56640
5578,202200,34602,120,57300,77,"""42""",57300,57420
5578,34602,204002,60,57300,77,"""42""",57420,57480
5578,204002,203402,60,57300,77,"""42""",57480,57540
5578,203402,203502,60,57300,77,"""42""",57540,57600
5578,203502,61603,60,57300,77,"""42""",57600,57660
5578,61603,208901,60,57300,77,"""42""",57660,57720
5578,208901,204602,120,57300,77,"""42""",57720,57840
5578,202200,34602,120,58500,77,"""42""",58500,58620
5578,34602,204002,60,58500,77,"""42""",58620,58680
5578,204002,203402,60,58500,77,"""42""",58680,58740
5578,203402,203502,60,58500,77,"""42""",58740,58800
5578,203502,61603,60,58500,77,"""42""",58800,58860
5578,61603,208901,60,58500,77,"""42""",58860,58920
5578,208901,204602,120,58500,77,"""42""",58920,59040
5578,202200,34602,120,59700,77,"""42""",59700,59820
5578,34602,204002,60,59700,77,"""42""",59820,59880
5578,204002,203402,60,59700,77,"""42""",59880,59940
5578,203402,203502,60,59700,77,"""42""",59940,60000
5578,203502,61603,60,59700,77,"""42""",60000,60060
5578,61603,208901,60,59700,77,"""42""",60060,60120
5578,208901,204602,120,59700,77,"""42""",60120,60240
5578,202200,34602,120,60900,77,"""42""",60900,61020
5578,34602,204002,60,60900,77,"""42""",61020,61080
5578,204002,203402,60,60900,77,"""42""",61080,61140
5578,203402,203502,60,60900,77,"""42""",61140,61200
5578,203502,61603,60,60900,77,"""42""",61200,61260
5578,61603,208901,60,60900,77,"""42""",61260,61320
5578,208901,204602,120,60900,77,"""42""",61320,61440
5578,202200,34602,120,63300,77,"""42""",63300,63420
5578,34602,204002,60,63300,77,"""42""",63420,63480
5578,204002,203402,60,63300,77,"""42""",63480,63540
5578,203402,203502,60,63300,77,"""42""",63540,63600
5578,203502,61603,60,63300,77,"""42""",63600,63660
5578,61603,208901,60,63300,77,"""42""",63660,63720
5578,208901,204602,120,63300,77,"""42""",63720,63840
5579,202200,34602,60,79080,77,"""42""",79080,79140
5579,34602,204002,60,79080,77,"""42""",79140,79200
5579,204002,203402,60,79080,77,"""42""",79200,79260
5579,203402,203502,60,79080,77,"""42""",79260,79320
5579,203502,61603,60,79080,77,"""42""",79320,79380
5579,61603,208901,60,79080,77,"""42""",79380,79440
5579,208901,204602,120,79080,77,"""42""",79440,79560
5579,202200,34602,60,80880,77,"""42""",80880,80940
5579,34602,204002,60,80880,77,"""42""",80940,81000
5579,204002,203402,60,80880,77,"""42""",81000,81060
5579,203402,203502,60,80880,77,"""42""",81060,81120
5579,203502,61603,60,80880,77,"""42""",81120,81180
5579,61603,208901,60,80880,77,"""42""",81180,81240
5579,208901,204602,120,80880,77,"""42""",81240,81360
5594,408000,34202,180,28860,62,"""1""",28860,29040
5594,34202,407701,60,28860,62,"""1""",29040,29100
5594,407701,400601,120,28860,62,"""1""",29100,29220
5594,400601,407200,60,28860,62,"""1""",29220,29280
5594,407200,101102,120,28860,62,"""1""",29280,29400
5594,101102,102001,120,28860,62,"""1""",29400,29520
5594,102001,101001,120,28860,62,"""1""",29520,29640
5594,408000,34202,180,30060,62,"""1""",30060,30240
5594,34202,407701,60,30060,62,"""1""",30240,30300
5594,407701,400601,120,30060,62,"""1""",30300,30420
5594,400601,407200,60,30060,62,"""1""",30420,30480
5594,407200,101102,120,30060,62,"""1""",30480,30600
5594,101102,102001,120,30060,62,"""1""",30600,30720
5594,102001,101001,120,30060,62,"""1""",30720,30840
5594,408000,34202,180,31260,62,"""1""",31260,31440
5594,34202,407701,60,31260,62,"""1""",31440,31500
5594,407701,400601,120,31260,62,"""1""",31500,31620
5594,400601,407200,60,31260,62,"""1""",31620,31680
5594,407200,101102,120,31260,62,"""1""",31680,31800
5594,101102,102001,120,31260,62,"""1""",31800,31920
5594,102001,101001,120,31260,62,"""1""",31920,32040
5594,408000,34202,180,32460,62,"""1""",32460,32640
5594,34202,407701,60,32460,62,"""1""",32640,32700
5594,407701,400601,120,32460,62,"""1""",32700,32820
5594,400601,407200,60,32460,62,"""1""",32820,32880
5594,407200,101102,120,32460,62,"""1""",32880,33000
5594,101102,102001,120,32460,62,"""1""",33000,33120
5594,102001,101001,120,32460,62,"""1""",33120,33240
5594,408000,34202,180,33660,62,"""1""",33660,33840
5594,34202,407701,60,33660,62,"""1""",33840,33900
5594,407701,400601,120,33660,62,"""1""",33900,34020
5594,400601,407200,60,33660,62,"""1""",34020,34080
5594,407200,101102,120,33660,62,"""1""",34080,34200
5594,101102,102001,120,33660,62,"""1""",34200,34320
5594,102001,101001,120,33660,62,"""1""",34320,34440
5594,408000,34202,180,34860,62,"""1""",34860,35040
5594,34202,407701,60,34860,62,"""1""",35040,35100
5594,407701,400601,120,34860,62,"""1""",35100,35220
5594,400601,407200,60,34860,62,"""1""",35220,35280
5594,407200,101102,120,34860,62,"""1""",35280,35400
5594,101102,102001,120,34860,62,"""1""",35400,35520
5594,102001,101001,120,34860,62,"""1""",35520,35640
5594,408000,34202,180,36060,62,"""1""",36060,36240
5594,34202,407701,60,36060,62,"""1""",36240,36300
5594,407701,400601,120,36060,62,"""1""",36300,36420
5594,400601,407200,60,36060,62,"""1""",36420,36480
5594,407200,101102,120,36060,62,"""1""",36480,36600
5594,101102,102001,120,36060,62,"""1""",36600,36720
5594,102001,101001,120,36060,62,"""1""",36720,36840
5594,408000,34202,180,37260,62,"""1""",37260,37440
5594,34202,407701,60,37260,62,"""1""",37440,37500
5594,407701,400601,120,37260,62,"""1""",37500,37620
5594,400601,407200,60,37260,62,"""1""",37620,37680
5594,407200,101102,120,37260,62,"""1""",37680,37800
5594,101102,102001,120,37260,62,"""1""",37800,37920
5594,102001,101001,120,37260,62,"""1""",37920,38040
5594,408000,34202,180,38460,62,"""1""",38460,38640
5594,34202,407701,60,38460,62,"""1""",38640,38700
5594,407701,400601,120,38460,62,"""1""",38700,38820
5594,400601,407200,60,38460,62,"""1""",38820,38880
5594,407200,101102,120,38460,62,"""1""",38880,39000
5594,101102,102001,120,38460,62,"""1""",39000,39120
5594,102001,101001,120,38460,62,"""1""",39120,39240
5594,408000,34202,180,39660,62,"""1""",39660,39840
5594,34202,407701,60,39660,62,"""1""",39840,39900
5594,407701,400601,120,39660,62,"""1""",39900,40020
5594,400601,407200,60,39660,62,"""1""",40020,40080
5594,407200,101102,120,39660,62,"""1""",40080,40200
5594,101102,102001,120,39660,62,"""1""",40200,40320
5594,102001,101001,120,39660,62,"""1""",40320,40440
5594,408000,34202,180,40860,62,"""1""",40860,41040
5594,34202,407701,60,40860,62,"""1""",41040,41100
5594,407701,400601,120,40860,62,"""1""",41100,41220
5594,400601,407200,60,40860,62,"""1""",41220,41280
5594,407200,101102,120,40860,62,"""1""",41280,41400
5594,101102,102001,120,40860,62,"""1""",41400,41520
5594,102001,101001,120,40860,62,"""1""",41520,41640
5594,408000,34202,180,42060,62,"""1""",42060,42240
5594,34202,407701,60,42060,62,"""1""",42240,42300
5594,407701,400601,120,42060,62,"""1""",42300,42420
5594,400601,407200,60,42060,62,"""1""",42420,42480
5594,407200,101102,120,42060,62,"""1""",42480,42600
5594,101102,102001,120,42060,62,"""1""",42600,42720
5594,102001,101001,120,42060,62,"""1""",42720,42840
5594,408000,34202,180,43260,62,"""1""",43260,43440
5594,34202,407701,60,43260,62,"""1""",43440,43500
5594,407701,400601,120,43260,62,"""1""",43500,43620
5594,400601,407200,60,43260,62,"""1""",43620,43680
5594,407200,101102,120,43260,62,"""1""",43680,43800
5594,101102,102001,120,43260,62,"""1""",43800,43920
5594,102001,101001,120,43260,62,"""1""",43920,44040
5594,408000,34202,180,44460,62,"""1""",44460,44640
5594,34202,407701,60,44460,62,"""1""",44640,44700
5594,407701,400601,120,44460,62,"""1""",44700,44820
5594,400601,407200,60,44460,62,"""1""",44820,44880
5594,407200,101102,120,44460,62,"""1""",44880,45000
5594,101102,102001,120,44460,62,"""1""",45000,45120
5594,102001,101001,120,44460,62,"""1""",45120,45240
5594,408000,34202,180,45660,62,"""1""",45660,45840
5594,34202,407701,60,45660,62,"""1""",45840,45900
5594,407701,400601,120,45660,62,"""1""",45900,46020
5594,400601,407200,60,45660,62,"""1""",46020,46080
5594,407200,101102,120,45660,62,"""1""",46080,46200
5594,101102,102001,120,45660,62,"""1""",46200,46320
5594,102001,101001,120,45660,62,"""1""",46320,46440
5594,408000,34202,180,46860,62,"""1""",46860,47040
5594,34202,407701,60,46860,62,"""1""",47040,47100
5594,407701,400601,120,46860,62,"""1""",47100,47220
5594,400601,407200,60,46860,62,"""1""",47220,47280
5594,407200,101102,120,46860,62,"""1""",47280,47400
5594,101102,102001,120,46860,62,"""1""",47400,47520
5594,102001,101001,120,46860,62,"""1""",47520,47640
5594,408000,34202,180,48060,62,"""1""",48060,48240
5594,34202,407701,60,48060,62,"""1""",48240,48300
5594,407701,400601,120,48060,62,"""1""",48300,48420
5594,400601,407200,60,48060,62,"""1""",48420,48480
5594,407200,101102,120,48060,62,"""1""",48480,48600
5594,101102,102001,120,48060,62,"""1""",48600,48720
5594,102001,101001,120,48060,62,"""1""",48720,48840
5594,408000,34202,180,49260,62,"""1""",49260,49440
5594,34202,407701,60,49260,62,"""1""",49440,49500
5594,407701,400601,120,49260,62,"""1""",49500,49620
5594,400601,407200,60,49260,62,"""1""",49620,49680
5594,407200,101102,120,49260,62,"""1""",49680,49800
5594,101102,102001,120,49260,62,"""1""",49800,49920
5594,102001,101001,120,49260,62,"""1""",49920,50040
5594,408000,34202,180,50460,62,"""1""",50460,50640
5594,34202,407701,60,50460,62,"""1""",50640,50700
5594,407701,400601,120,50460,62,"""1""",50700,50820
5594,400601,407200,60,50460,62,"""1""",50820,50880
5594,407200,101102,120,50460,62,"""1""",50880,51000
5594,101102,102001,120,50460,62,"""1""",51000,51120
5594,102001,101001,120,50460,62,"""1""",51120,51240
5594,408000,34202,180,51660,62,"""1""",51660,51840
5594,34202,407701,60,51660,62,"""1""",51840,51900
5594,407701,400601,120,51660,62,"""1""",51900,52020
5594,400601,407200,60,51660,62,"""1""",52020,52080
5594,407200,101102,120,51660,62,"""1""",52080,52200
5594,101102,102001,120,51660,62,"""1""",52200,52320
5594,102001,101001,120,51660,62,"""1""",52320,52440
5594,408000,34202,180,52860,62,"""1""",52860,53040
5594,34202,407701,60,52860,62,"""1""",53040,53100
5594,407701,400601,120,52860,62,"""1""",53100,53220
5594,400601,407200,60,52860,62,"""1""",53220,53280
5594,407200,101102,120,52860,62,"""1""",53280,53400
5594,101102,102001,120,52860,62,"""1""",53400,53520
5594,102001,101001,120,52860,62,"""1""",53520,53640
5594,408000,34202,180,54060,62,"""1""",54060,54240
5594,34202,407701,60,54060,62,"""1""",54240,54300
5594,407701,400601,120,54060,62,"""1""",54300,54420
5594,400601,407200,60,54060,62,"""1""",54420,54480
5594,407200,101102,120,54060,62,"""1""",54480,54600
5594,101102,102001,120,54060,62,"""1""",54600,54720
5594,102001,101001,120,54060,62,"""1""",54720,54840
5594,408000,34202,180,55260,62,"""1""",55260,55440
5594,34202,407701,60,55260,62,"""1""",55440,55500
5594,407701,400601,120,55260,62,"""1""",55500,55620
5594,400601,407200,60,55260,62,"""1""",55620,55680
5594,407200,101102,120,55260,62,"""1""",55680,55800
5594,101102,102001,120,55260,62,"""1""",55800,55920
5594,102001,101001,120,55260,62,"""1""",55920,56040
5594,408000,34202,180,56460,62,"""1""",56460,56640
5594,34202,407701,60,56460,62,"""1""",56640,56700
5594,407701,400601,120,56460,62,"""1""",56700,56820
5594,400601,407200,60,56460,62,"""1""",56820,56880
5594,407200,101102,120,56460,62,"""1""",56880,57000
5594,101102,102001,120,56460,62,"""1""",57000,57120
5594,102001,101001,120,56460,62,"""1""",57120,57240
5594,408000,34202,180,57660,62,"""1""",57660,57840
5594,34202,407701,60,57660,62,"""1""",57840,57900
5594,407701,400601,120,57660,62,"""1""",57900,58020
5594,400601,407200,60,57660,62,"""1""",58020,58080
5594,407200,101102,120,57660,62,"""1""",58080,58200
5594,101102,102001,120,57660,62,"""1""",58200,58320
5594,102001,101001,120,57660,62,"""1""",58320,58440
5594,408000,34202,180,58860,62,"""1""",58860,59040
5594,34202,407701,60,58860,62,"""1""",59040,59100
5594,407701,400601,120,58860,62,"""1""",59100,59220
5594,400601,407200,60,58860,62,"""1""",59220,59280
5594,407200,101102,120,58860,62,"""1""",59280,59400
5594,101102,102001,120,58860,62,"""1""",59400,59520
5594,102001,101001,120,58860,62,"""1""",59520,59640
5594,408000,34202,180,60060,62,"""1""",60060,60240
5594,34202,407701,60,60060,62,"""1""",60240,60300
5594,407701,400601,120,60060,62,"""1""",60300,60420
5594,400601,407200,60,60060,62,"""1""",60420,60480
5594,407200,101102,120,60060,62,"""1""",60480,60600
5594,101102,102001,120,60060,62,"""1""",60600,60720
5594,102001,101001,120,60060,62,"""1""",60720,60840
5594,408000,34202,180,61260,62,"""1""",61260,61440
5594,34202,407701,60,61260,62,"""1""",61440,61500
5594,407701,400601,120,61260,62,"""1""",61500,61620
5594,400601,407200,60,61260,62,"""1""",61620,61680
5594,407200,101102,120,61260,62,"""1""",61680,61800
5594,101102,102001,120,61260,62,"""1""",61800,61920
5594,102001,101001,120,61260,62,"""1""",61920,62040
5594,408000,34202,180,62460,62,"""1""",62460,62640
5594,34202,407701,60,62460,62,"""1""",62640,62700
5594,407701,400601,120,62460,62,"""1""",62700,62820
5594,400601,407200,60,62460,62,"""1""",62820,62880
5594,407200,101102,120,62460,62,"""1""",62880,63000
5594,101102,102001,120,62460,62,"""1""",63000,63120
5594,102001,101001,120,62460,62,"""1""",63120,63240
5594,408000,34202,180,63660,62,"""1""",63660,63840
5594,34202,407701,60,63660,62,"""1""",63840,63900
5594,407701,400601,120,63660,62,"""1""",63900,64020
5594,400601,407200,60,63660,62,"""1""",64020,64080
5594,407200,101102,120,63660,62,"""1""",64080,64200
5594,101102,102001,120,63660,62,"""1""",64200,64320
5594,102001,101001,120,63660,62,"""1""",64320,64440
5594,408000,34202,180,64860,62,"""1""",64860,65040
5594,34202,407701,60,64860,62,"""1""",65040,65100
5594,407701,400601,120,64860,62,"""1""",65100,65220
5594,400601,407200,60,64860,62,"""1""",65220,65280
5594,407200,101102,120,64860,62,"""1""",65280,65400
5594,101102,102001,120,64860,62,"""1""",65400,65520
5594,102001,101001,120,64860,62,"""1""",65520,65640
5594,408000,34202,180,66060,62,"""1""",66060,66240
5594,34202,407701,60,66060,62,"""1""",66240,66300
5594,407701,400601,120,66060,62,"""1""",66300,66420
5594,400601,407200,60,66060,62,"""1""",66420,66480
5594,407200,101102,120,66060,62,"""1""",66480,66600
5594,101102,102001,120,66060,62,"""1""",66600,66720
5594,102001,101001,120,66060,62,"""1""",66720,66840
5594,408000,34202,180,67260,62,"""1""",67260,67440
5594,34202,407701,60,67260,62,"""1""",67440,67500
5594,407701,400601,120,67260,62,"""1""",67500,67620
5594,400601,407200,60,67260,62,"""1""",67620,67680
5594,407200,101102,120,67260,62,"""1""",67680,67800
5594,101102,102001,120,67260,62,"""1""",67800,67920
5594,102001,101001,120,67260,62,"""1""",67920,68040
5594,408000,34202,180,68460,62,"""1""",68460,68640
5594,34202,407701,60,68460,62,"""1""",68640,68700
5594,407701,400601,120,68460,62,"""1""",68700,68820
5594,400601,407200,60,68460,62,"""1""",68820,68880
5594,407200,101102,120,68460,62,"""1""",68880,69000
5594,101102,102001,120,68460,62,"""1""",69000,69120
5594,102001,101001,120,68460,62,"""1""",69120,69240
5594,408000,34202,180,69660,62,"""1""",69660,69840
5594,34202,407701,60,69660,62,"""1""",69840,69900
5594,407701,400601,120,69660,62,"""1""",69900,70020
5594,400601,407200,60,69660,62,"""1""",70020,70080
5594,407200,101102,120,69660,62,"""1""",70080,70200
5594,101102,102001,120,69660,62,"""1""",70200,70320
5594,102001,101001,120,69660,62,"""1""",70320,70440
5594,408000,34202,180,70860,62,"""1""",70860,71040
5594,34202,407701,60,70860,62,"""1""",71040,71100
5594,407701,400601,120,70860,62,"""1""",71100,71220
5594,400601,407200,60,70860,62,"""1""",71220,71280
5594,407200,101102,120,70860,62,"""1""",71280,71400
5594,101102,102001,120,70860,62,"""1""",71400,71520
5594,102001,101001,120,70860,62,"""1""",71520,71640
5595,101002,102002,60,27420,62,"""2""",27420,27480
5595,102002,101101,120,27420,62,"""2""",27480,27600
5595,101101,403802,120,27420,62,"""2""",27600,27720
5595,403802,408300,120,27420,62,"""2""",27720,27840
5595,408300,406502,60,27420,62,"""2""",27840,27900
5595,406502,407702,60,27420,62,"""2""",27900,27960
5595,407702,34201,60,27420,62,"""2""",27960,28020
5595,34201,408004,180,27420,62,"""2""",28020,28200
5595,101002,102002,60,28620,62,"""2""",28620,28680
5595,102002,101101,120,28620,62,"""2""",28680,28800
5595,101101,403802,120,28620,62,"""2""",28800,28920
5595,403802,408300,120,28620,62,"""2""",28920,29040
5595,408300,406502,60,28620,62,"""2""",29040,29100
5595,406502,407702,60,28620,62,"""2""",29100,29160
5595,407702,34201,60,28620,62,"""2""",29160,29220
5595,34201,408004,180,28620,62,"""2""",29220,29400
5595,101002,102002,60,29820,62,"""2""",29820,29880
5595,102002,101101,120,29820,62,"""2""",29880,30000
5595,101101,403802,120,29820,62,"""2""",30000,30120
5595,403802,408300,120,29820,62,"""2""",30120,30240
5595,408300,406502,60,29820,62,"""2""",30240,30300
5595,406502,407702,60,29820,62,"""2""",30300,30360
5595,407702,34201,60,29820,62,"""2""",30360,30420
5595,34201,408004,180,29820,62,"""2""",30420,30600
5595,101002,102002,60,31020,62,"""2""",31020,31080
5595,102002,101101,120,31020,62,"""2""",31080,31200
5595,101101,403802,120,31020,62,"""2""",31200,31320
5595,403802,408300,120,31020,62,"""2""",31320,31440
5595,408300,406502,60,31020,62,"""2""",31440,31500
5595,406502,407702,60,31020,62,"""2""",31500,31560
5595,407702,34201,60,31020,62,"""2""",31560,31620
5595,34201,408004,180,31020,62,"""2""",31620,31800
5595,101002,102002,60,32220,62,"""2""",32220,32280
5595,102002,101101,120,32220,62,"""2""",32280,32400
5595,101101,403802,120,32220,62,"""2""",32400,32520
5595,403802,408300,120,32220,62,"""2""",32520,32640
5595,408300,406502,60,32220,62,"""2""",32640,32700
5595,406502,407702,60,32220,62,"""2""",32700,32760
5595,407702,34201,60,32220,62,"""2""",32760,32820
5595,34201,408004,180,32220,62,"""2""",32820,33000
5595,101002,102002,60,33420,62,"""2""",33420,33480
5595,102002,101101,120,33420,62,"""2""",33480,33600
5595,101101,403802,120,33420,62,"""2""",33600,33720
5595,403802,408300,120,33420,62,"""2""",33720,33840
5595,408300,406502,60,33420,62,"""2""",33840,33900
5595,406502,407702,60,33420,62,"""2""",33900,33960
5595,407702,34201,60,33420,62,"""2""",33960,34020
5595,34201,408004,180,33420,62,"""2""",34020,34200
5595,101002,102002,60,34620,62,"""2""",34620,34680
5595,102002,101101,120,34620,62,"""2""",34680,34800
5595,101101,403802,120,34620,62,"""2""",34800,34920
5595,403802,408300,120,34620,62,"""2""",34920,35040
5595,408300,406502,60,34620,62,"""2""",35040,35100
5595,406502,407702,60,34620,62,"""2""",35100,35160
5595,407702,34201,60,34620,62,"""2""",35160,35220
5595,34201,408004,180,34620,62,"""2""",35220,35400
5595,101002,102002,60,35820,62,"""2""",35820,35880
5595,102002,101101,120,35820,62,"""2""",35880,36000
5595,101101,403802,120,35820,62,"""2""",36000,36120
5595,403802,408300,120,35820,62,"""2""",36120,36240
5595,408300,406502,60,35820,62,"""2""",36240,36300
5595,406502,407702,60,35820,62,"""2""",36300,36360
5595,407702,34201,60,35820,62,"""2""",36360,36420
5595,34201,408004,180,35820,62,"""2""",36420,36600
5595,101002,102002,60,37020,62,"""2""",37020,37080
5595,102002,101101,120,37020,62,"""2""",37080,37200
5595,101101,403802,120,37020,62,"""2""",37200,37320
5595,403802,408300,120,37020,62,"""2""",37320,37440
5595,408300,406502,60,37020,62,"""2""",37440,37500
5595,406502,407702,60,37020,62,"""2""",37500,37560
5595,407702,34201,60,37020,62,"""2""",37560,37620
5595,34201,408004,180,37020,62,"""2""",37620,37800
5595,101002,102002,60,38220,62,"""2""",38220,38280
5595,102002,101101,120,38220,62,"""2""",38280,38400
5595,101101,403802,120,38220,62,"""2""",38400,38520
5595,403802,408300,120,38220,62,"""2""",38520,38640
5595,408300,406502,60,38220,62,"""2""",38640,38700
5595,406502,407702,60,38220,62,"""2""",38700,38760
5595,407702,34201,60,38220,62,"""2""",38760,38820
5595,34201,408004,180,38220,62,"""2""",38820,39000
5595,101002,102002,60,39420,62,"""2""",39420,39480
5595,102002,101101,120,39420,62,"""2""",39480,39600
5595,101101,403802,120,39420,62,"""2""",39600,39720
5595,403802,408300,120,39420,62,"""2""",39720,39840
5595,408300,406502,60,39420,62,"""2""",39840,39900
5595,406502,407702,60,39420,62,"""2""",39900,39960
5595,407702,34201,60,39420,62,"""2""",39960,40020
5595,34201,408004,180,39420,62,"""2""",40020,40200
5595,101002,102002,60,40620,62,"""2""",40620,40680
5595,102002,101101,120,40620,62,"""2""",40680,40800
5595,101101,403802,120,40620,62,"""2""",40800,40920
5595,403802,408300,120,40620,62,"""2""",40920,41040
5595,408300,406502,60,40620,62,"""2""",41040,41100
5595,406502,407702,60,40620,62,"""2""",41100,41160
5595,407702,34201,60,40620,62,"""2""",41160,41220
5595,34201,408004,180,40620,62,"""2""",41220,41400
5595,101002,102002,60,41820,62,"""2""",41820,41880
5595,102002,101101,120,41820,62,"""2""",41880,42000
5595,101101,403802,120,41820,62,"""2""",42000,42120
5595,403802,408300,120,41820,62,"""2""",42120,42240
5595,408300,406502,60,41820,62,"""2""",42240,42300
5595,406502,407702,60,41820,62,"""2""",42300,42360
5595,407702,34201,60,41820,62,"""2""",42360,42420
5595,34201,408004,180,41820,62,"""2""",42420,42600
5595,101002,102002,60,43020,62,"""2""",43020,43080
5595,102002,101101,120,43020,62,"""2""",43080,43200
5595,101101,403802,120,43020,62,"""2""",43200,43320
5595,403802,408300,120,43020,62,"""2""",43320,43440
5595,408300,406502,60,43020,62,"""2""",43440,43500
5595,406502,407702,60,43020,62,"""2""",43500,43560
5595,407702,34201,60,43020,62,"""2""",43560,43620
5595,34201,408004,180,43020,62,"""2""",43620,43800
5595,101002,102002,60,44220,62,"""2""",44220,44280
5595,102002,101101,120,44220,62,"""2""",44280,44400
5595,101101,403802,120,44220,62,"""2""",44400,44520
5595,403802,408300,120,44220,62,"""2""",44520,44640
5595,408300,406502,60,44220,62,"""2""",44640,44700
5595,406502,407702,60,44220,62,"""2""",44700,44760
5595,407702,34201,60,44220,62,"""2""",44760,44820
5595,34201,408004,180,44220,62,"""2""",44820,45000
5595,101002,102002,60,45420,62,"""2""",45420,45480
5595,102002,101101,120,45420,62,"""2""",45480,45600
5595,101101,403802,120,45420,62,"""2""",45600,45720
5595,403802,408300,120,45420,62,"""2""",45720,45840
5595,408300,406502,60,45420,62,"""2""",45840,45900
5595,406502,407702,60,45420,62,"""2""",45900,45960
5595,407702,34201,60,45420,62,"""2""",45960,46020
5595,34201,408004,180,45420,62,"""2""",46020,46200
5595,101002,102002,60,46620,62,"""2""",46620,46680
5595,102002,101101,120,46620,62,"""2""",46680,46800
5595,101101,403802,120,46620,62,"""2""",46800,46920
5595,403802,408300,120,46620,62,"""2""",46920,47040
5595,408300,406502,60,46620,62,"""2""",47040,47100
5595,406502,407702,60,46620,62,"""2""",47100,47160
5595,407702,34201,60,46620,62,"""2""",47160,47220
5595,34201,408004,180,46620,62,"""2""",47220,47400
5595,101002,102002,60,47820,62,"""2""",47820,47880
5595,102002,101101,120,47820,62,"""2""",47880,48000
5595,101101,403802,120,47820,62,"""2""",48000,48120
5595,403802,408300,120,47820,62,"""2""",48120,48240
5595,408300,406502,60,47820,62,"""2""",48240,48300
5595,406502,407702,60,47820,62,"""2""",48300,48360
5595,407702,34201,60,47820,62,"""2""",48360,48420
5595,34201,408004,180,47820,62,"""2""",48420,48600
5595,101002,102002,60,49020,62,"""2""",49020,49080
5595,102002,101101,120,49020,62,"""2""",49080,49200
5595,101101,403802,120,49020,62,"""2""",49200,49320
5595,403802,408300,120,49020,62,"""2""",49320,49440
5595,408300,406502,60,49020,62,"""2""",49440,49500
5595,406502,407702,60,49020,62,"""2""",49500,49560
5595,407702,34201,60,49020,62,"""2""",49560,49620
5595,34201,408004,180,49020,62,"""2""",49620,49800
5595,101002,102002,60,50220,62,"""2""",50220,50280
5595,102002,101101,120,50220,62,"""2""",50280,50400
5595,101101,403802,120,50220,62,"""2""",50400,50520
5595,403802,408300,120,50220,62,"""2""",50520,50640
5595,408300,406502,60,50220,62,"""2""",50640,50700
5595,406502,407702,60,50220,62,"""2""",50700,50760
5595,407702,34201,60,50220,62,"""2""",50760,50820
5595,34201,408004,180,50220,62,"""2""",50820,51000
5595,101002,102002,60,51420,62,"""2""",51420,51480
5595,102002,101101,120,51420,62,"""2""",51480,51600
5595,101101,403802,120,51420,62,"""2""",51600,51720
5595,403802,408300,120,51420,62,"""2""",51720,51840
5595,408300,406502,60,51420,62,"""2""",51840,51900
5595,406502,407702,60,51420,62,"""2""",51900,51960
5595,407702,34201,60,51420,62,"""2""",51960,52020
5595,34201,408004,180,51420,62,"""2""",52020,52200
5595,101002,102002,60,52620,62,"""2""",52620,52680
5595,102002,101101,120,52620,62,"""2""",52680,52800
5595,101101,403802,120,52620,62,"""2""",52800,52920
5595,403802,408300,120,52620,62,"""2""",52920,53040
5595,408300,406502,60,52620,62,"""2""",53040,53100
5595,406502,407702,60,52620,62,"""2""",53100,53160
5595,407702,34201,60,52620,62,"""2""",53160,53220
5595,34201,408004,180,52620,62,"""2""",53220,53400
5595,101002,102002,60,53820,62,"""2""",53820,53880
5595,102002,101101,120,53820,62,"""2""",53880,54000
5595,101101,403802,120,53820,62,"""2""",54000,54120
5595,403802,408300,120,53820,62,"""2""",54120,54240
5595,408300,406502,60,53820,62,"""2""",54240,54300
5595,406502,407702,60,53820,62,"""2""",54300,54360
5595,407702,34201,60,53820,62,"""2""",54360,54420
5595,34201,408004,180,53820,62,"""2""",54420,54600
5595,101002,102002,60,55020,62,"""2""",55020,55080
5595,102002,101101,120,55020,62,"""2""",55080,55200
5595,101101,403802,120,55020,62,"""2""",55200,55320
5595,403802,408300,120,55020,62,"""2""",55320,55440
5595,408300,406502,60,55020,62,"""2""",55440,55500
5595,406502,407702,60,55020,62,"""2""",55500,55560
5595,407702,34201,60,55020,62,"""2""",55560,55620
5595,34201,408004,180,55020,62,"""2""",55620,55800
5595,101002,102002,60,56220,62,"""2""",56220,56280
5595,102002,101101,120,56220,62,"""2""",56280,56400
5595,101101,403802,120,56220,62,"""2""",56400,56520
5595,403802,408300,120,56220,62,"""2""",56520,56640
5595,408300,406502,60,56220,62,"""2""",56640,56700
5595,406502,407702,60,56220,62,"""2""",56700,56760
5595,407702,34201,60,56220,62,"""2""",56760,56820
5595,34201,408004,180,56220,62,"""2""",56820,57000
5595,101002,102002,60,57420,62,"""2""",57420,57480
5595,102002,101101,120,57420,62,"""2""",57480,57600
5595,101101,403802,120,57420,62,"""2""",57600,57720
5595,403802,408300,120,57420,62,"""2""",57720,57840
5595,408300,406502,60,57420,62,"""2""",57840,57900
5595,406502,407702,60,57420,62,"""2""",57900,57960
5595,407702,34201,60,57420,62,"""2""",57960,58020
5595,34201,408004,180,57420,62,"""2""",58020,58200
5595,101002,102002,60,58620,62,"""2""",58620,58680
5595,102002,101101,120,58620,62,"""2""",58680,58800
5595,101101,403802,120,58620,62,"""2""",58800,58920
5595,403802,408300,120,58620,62,"""2""",58920,59040
5595,408300,406502,60,58620,62,"""2""",59040,59100
5595,406502,407702,60,58620,62,"""2""",59100,59160
5595,407702,34201,60,58620,62,"""2""",59160,59220
5595,34201,408004,180,58620,62,"""2""",59220,59400
5595,101002,102002,60,59820,62,"""2""",59820,59880
5595,102002,101101,120,59820,62,"""2""",59880,60000
5595,101101,403802,120,59820,62,"""2""",60000,60120
5595,403802,408300,120,59820,62,"""2""",60120,60240
5595,408300,406502,60,59820,62,"""2""",60240,60300
5595,406502,407702,60,59820,62,"""2""",60300,60360
5595,407702,34201,60,59820,62,"""2""",60360,60420
5595,34201,408004,180,59820,62,"""2""",60420,60600
5595,101002,102002,60,61020,62,"""2""",61020,61080
5595,102002,101101,120,61020,62,"""2""",61080,61200
5595,101101,403802,120,61020,62,"""2""",61200,61320
5595,403802,408300,120,61020,62,"""2""",61320,61440
5595,408300,406502,60,61020,62,"""2""",61440,61500
5595,406502,407702,60,61020,62,"""2""",61500,61560
5595,407702,34201,60,61020,62,"""2""",61560,61620
5595,34201,408004,180,61020,62,"""2""",61620,61800
5595,101002,102002,60,62220,62,"""2""",62220,62280
5595,102002,101101,120,62220,62,"""2""",62280,62400
5595,101101,403802,120,62220,62,"""2""",62400,62520
5595,403802,408300,120,62220,62,"""2""",62520,62640
5595,408300,406502,60,62220,62,"""2""",62640,62700
5595,406502,407702,60,62220,62,"""2""",62700,62760
5595,407702,34201,60,62220,62,"""2""",62760,62820
5595,34201,408004,180,62220,62,"""2""",62820,63000
5595,101002,102002,60,63420,62,"""2""",63420,63480
5595,102002,101101,120,63420,62,"""2""",63480,63600
5595,101101,403802,120,63420,62,"""2""",63600,63720
5595,403802,408300,120,63420,62,"""2""",63720,63840
5595,408300,406502,60,63420,62,"""2""",63840,63900
5595,406502,407702,60,63420,62,"""2""",63900,63960
5595,407702,34201,60,63420,62,"""2""",63960,64020
5595,34201,408004,180,63420,62,"""2""",64020,64200
5595,101002,102002,60,64620,62,"""2""",64620,64680
5595,102002,101101,120,64620,62,"""2""",64680,64800
5595,101101,403802,120,64620,62,"""2""",64800,64920
5595,403802,408300,120,64620,62,"""2""",64920,65040
5595,408300,406502,60,64620,62,"""2""",65040,65100
5595,406502,407702,60,64620,62,"""2""",65100,65160
5595,407702,34201,60,64620,62,"""2""",65160,65220
5595,34201,408004,180,64620,62,"""2""",65220,65400
5595,101002,102002,60,65820,62,"""2""",65820,65880
5595,102002,101101,120,65820,62,"""2""",65880,66000
5595,101101,403802,120,65820,62,"""2""",66000,66120
5595,403802,408300,120,65820,62,"""2""",66120,66240
5595,408300,406502,60,65820,62,"""2""",66240,66300
5595,406502,407702,60,65820,62,"""2""",66300,66360
5595,407702,34201,60,65820,62,"""2""",66360,66420
5595,34201,408004,180,65820,62,"""2""",66420,66600
5595,101002,102002,60,67020,62,"""2""",67020,67080
5595,102002,101101,120,67020,62,"""2""",67080,67200
5595,101101,403802,120,67020,62,"""2""",67200,67320
5595,403802,408300,120,67020,62,"""2""",67320,67440
5595,408300,406502,60,67020,62,"""2""",67440,67500
5595,406502,407702,60,67020,62,"""2""",67500,67560
5595,407702,34201,60,67020,62,"""2""",67560,67620
5595,34201,408004,180,67020,62,"""2""",67620,67800
5595,101002,102002,60,68220,62,"""2""",68220,68280
5595,102002,101101,120,68220,62,"""2""",68280,68400
5595,101101,403802,120,68220,62,"""2""",68400,68520
5595,403802,408300,120,68220,62,"""2""",68520,68640
5595,408300,406502,60,68220,62,"""2""",68640,68700
5595,406502,407702,60,68220,62,"""2""",68700,68760
5595,407702,34201,60,68220,62,"""2""",68760,68820
5595,34201,408004,180,68220,62,"""2""",68820,69000
5595,101002,102002,60,69420,62,"""2""",69420,69480
5595,102002,101101,120,69420,62,"""2""",69480,69600
5595,101101,403802,120,69420,62,"""2""",69600,69720
5595,403802,408300,120,69420,62,"""2""",69720,69840
5595,408300,406502,60,69420,62,"""2""",69840,69900
5595,406502,407702,60,69420,62,"""2""",69900,69960
5595,407702,34201,60,69420,62,"""2""",69960,70020
5595,34201,408004,180,69420,62,"""2""",70020,70200
5595,101002,102002,60,70620,62,"""2""",70620,70680
5595,102002,101101,120,70620,62,"""2""",70680,70800
5595,101101,403802,120,70620,62,"""2""",70800,70920
5595,403802,408300,120,70620,62,"""2""",70920,71040
5595,408300,406502,60,70620,62,"""2""",71040,71100
5595,406502,407702,60,70620,62,"""2""",71100,71160
5595,407702,34201,60,70620,62,"""2""",71160,71220
5595,34201,408004,180,70620,62,"""2""",71220,71400
5601,405100,405902,60,26700,64,"""2""",26700,26760
5601,405902,406502,120,26700,64,"""2""",26760,26880
5601,406502,407702,60,26700,64,"""2""",26880,26940
5601,407702,34201,60,26700,64,"""2""",26940,27000
5601,34201,408004,180,26700,64,"""2""",27000,27180
5601,405100,405902,60,27900,64,"""2""",27900,27960
5601,405902,406502,120,27900,64,"""2""",27960,28080
5601,406502,407702,60,27900,64,"""2""",28080,28140
5601,407702,34201,60,27900,64,"""2""",28140,28200
5601,34201,408004,180,27900,64,"""2""",28200,28380
5601,405100,405902,60,29100,64,"""2""",29100,29160
5601,405902,406502,120,29100,64,"""2""",29160,29280
5601,406502,407702,60,29100,64,"""2""",29280,29340
5601,407702,34201,60,29100,64,"""2""",29340,29400
5601,34201,408004,180,29100,64,"""2""",29400,29580
5601,405100,405902,60,30300,64,"""2""",30300,30360
5601,405902,406502,120,30300,64,"""2""",30360,30480
5601,406502,407702,60,30300,64,"""2""",30480,30540
5601,407702,34201,60,30300,64,"""2""",30540,30600
5601,34201,408004,180,30300,64,"""2""",30600,30780
5601,405100,405902,60,31500,64,"""2""",31500,31560
5601,405902,406502,120,31500,64,"""2""",31560,31680
5601,406502,407702,60,31500,64,"""2""",31680,31740
5601,407702,34201,60,31500,64,"""2""",31740,31800
5601,34201,408004,180,31500,64,"""2""",31800,31980
5601,405100,405902,60,32700,64,"""2""",32700,32760
5601,405902,406502,120,32700,64,"""2""",32760,32880
5601,406502,407702,60,32700,64,"""2""",32880,32940
5601,407702,34201,60,32700,64,"""2""",32940,33000
5601,34201,408004,180,32700,64,"""2""",33000,33180
5601,405100,405902,60,33900,64,"""2""",33900,33960
5601,405902,406502,120,33900,64,"""2""",33960,34080
5601,406502,407702,60,33900,64,"""2""",34080,34140
5601,407702,34201,60,33900,64,"""2""",34140,34200
5601,34201,408004,180,33900,64,"""2""",34200,34380
5601,405100,405902,60,35100,64,"""2""",35100,35160
5601,405902,406502,120,35100,64,"""2""",35160,35280
5601,406502,407702,60,35100,64,"""2""",35280,35340
5601,407702,34201,60,35100,64,"""2""",35340,35400
5601,34201,408004,180,35100,64,"""2""",35400,35580
5601,405100,405902,60,36300,64,"""2""",36300,36360
5601,405902,406502,120,36300,64,"""2""",36360,36480
5601,406502,407702,60,36300,64,"""2""",36480,36540
5601,407702,34201,60,36300,64,"""2""",36540,36600
5601,34201,408004,180,36300,64,"""2""",36600,36780
5612,501500,500500,60,25620,53,"""1""",25620,25680
5612,500500,500300,60,25620,53,"""1""",25680,25740
5612,500300,500200,60,25620,53,"""1""",25740,25800
5612,500200,502300,180,25620,53,"""1""",25800,25980
5612,502300,502600,0,25620,53,"""1""",25980,25980
5612,502600,502501,60,25620,53,"""1""",25980,26040
5612,502501,501702,120,25620,53,"""1""",26040,26160
5612,501702,500903,300,25620,53,"""1""",26160,26460
5612,500903,502801,60,25620,53,"""1""",26460,26520
5612,502801,101103,240,25620,53,"""1""",26520,26760
5612,101103,112105,240,25620,53,"""1""",26760,27000
5612,501500,500500,60,26220,53,"""1""",26220,26280
5612,500500,500300,60,26220,53,"""1""",26280,26340
5612,500300,500200,60,26220,53,"""1""",26340,26400
5612,500200,502300,180,26220,53,"""1""",26400,26580
5612,502300,502600,0,26220,53,"""1""",26580,26580
5612,502600,502501,60,26220,53,"""1""",26580,26640
5612,502501,501702,120,26220,53,"""1""",26640,26760
5612,501702,500903,300,26220,53,"""1""",26760,27060
5612,500903,502801,60,26220,53,"""1""",27060,27120
5612,502801,101103,240,26220,53,"""1""",27120,27360
5612,101103,112105,240,26220,53,"""1""",27360,27600
5612,501500,500500,60,26820,53,"""1""",26820,26880
5612,500500,500300,60,26820,53,"""1""",26880,26940
5612,500300,500200,60,26820,53,"""1""",26940,27000
5612,500200,502300,180,26820,53,"""1""",27000,27180
5612,502300,502600,0,26820,53,"""1""",27180,27180
5612,502600,502501,60,26820,53,"""1""",27180,27240
5612,502501,501702,120,26820,53,"""1""",27240,27360
5612,501702,500903,300,26820,53,"""1""",27360,27660
5612,500903,502801,60,26820,53,"""1""",27660,27720
5612,502801,101103,240,26820,53,"""1""",27720,27960
5612,101103,112105,240,26820,53,"""1""",27960,28200
5613,500903,502801,60,47100,53,"""7""",47100,47160
5613,502801,101103,240,47100,53,"""7""",47160,47400
5613,101103,109006,240,47100,53,"""7""",47400,47640
5614,112105,101104,240,27120,53,"""4""",27120,27360
5614,101104,502802,180,27120,53,"""4""",27360,27540
5614,502802,500904,120,27120,53,"""4""",27540,27660
5614,500904,501704,300,27120,53,"""4""",27660,27960
5614,112105,101104,240,27720,53,"""4""",27720,27960
5614,101104,502802,180,27720,53,"""4""",27960,28140
5614,502802,500904,120,27720,53,"""4""",28140,28260
5614,500904,501704,300,27720,53,"""4""",28260,28560
5632,407500,407503,60,70320,2,"""12""",70320,70380
5632,407503,408900,60,70320,2,"""12""",70380,70440
5632,408900,400802,60,70320,2,"""12""",70440,70500
5632,400802,400704,120,70320,2,"""12""",70500,70620
5632,400704,408503,60,70320,2,"""12""",70620,70680
5632,408503,405602,60,70320,2,"""12""",70680,70740
5632,405602,407102,60,70320,2,"""12""",70740,70800
5632,407102,404202,60,70320,2,"""12""",70800,70860
5632,404202,117000,60,70320,2,"""12""",70860,70920
5632,117000,112106,120,70320,2,"""12""",70920,71040
5632,112106,103003,120,70320,2,"""12""",71040,71160
5632,103003,118002,180,70320,2,"""12""",71160,71340
5632,118002,106002,60,70320,2,"""12""",71340,71400
5632,106002,118102,60,70320,2,"""12""",71400,71460
5632,118102,101002,120,70320,2,"""12""",71460,71580
5632,101002,102002,60,70320,2,"""12""",71580,71640
5632,102002,101101,120,70320,2,"""12""",71640,71760
5632,101101,403802,120,70320,2,"""12""",71760,71880
5632,403802,408300,120,70320,2,"""12""",71880,72000
5632,408300,406502,60,70320,2,"""12""",72000,72060
5632,406502,407702,60,70320,2,"""12""",72060,72120
5632,407702,408403,60,70320,2,"""12""",72120,72180
5632,408403,403502,60,70320,2,"""12""",72180,72240
5632,403502,403701,60,70320,2,"""12""",72240,72300
5632,403701,404600,60,70320,2,"""12""",72300,72360
5632,404600,402602,60,70320,2,"""12""",72360,72420
5632,402602,403602,120,70320,2,"""12""",72420,72540
5632,403602,404701,120,70320,2,"""12""",72540,72660
5632,404701,404700,0,70320,2,"""12""",72660,72660
5632,404700,32100,0,70320,2,"""12""",72660,72660
5632,32100,406001,60,70320,2,"""12""",72660,72720
5632,406001,302602,60,70320,2,"""12""",72720,72780
5632,302602,406701,60,70320,2,"""12""",72780,72840
5632,406701,406902,60,70320,2,"""12""",72840,72900
5633,407500,407503,60,84600,2,"""12""",84600,84660
5633,407503,408900,60,84600,2,"""12""",84660,84720
5633,408900,400802,60,84600,2,"""12""",84720,84780
5633,400802,400704,120,84600,2,"""12""",84780,84900
5633,400704,408503,60,84600,2,"""12""",84900,84960
5633,408503,405602,60,84600,2,"""12""",84960,85020
5633,405602,407102,60,84600,2,"""12""",85020,85080
5633,407102,404202,60,84600,2,"""12""",85080,85140
5633,404202,117000,60,84600,2,"""12""",85140,85200
5633,117000,112106,120,84600,2,"""12""",85200,85320
5633,112106,103003,120,84600,2,"""12""",85320,85440
5633,103003,118002,120,84600,2,"""12""",85440,85560
5633,118002,106002,60,84600,2,"""12""",85560,85620
5633,106002,118102,60,84600,2,"""12""",85620,85680
5633,118102,101002,120,84600,2,"""12""",85680,85800
5633,101002,102002,60,84600,2,"""12""",85800,85860
5633,102002,101101,120,84600,2,"""12""",85860,85980
5633,101101,403802,120,84600,2,"""12""",85980,86100
5633,403802,408300,60,84600,2,"""12""",86100,86160
5633,408300,406502,60,84600,2,"""12""",86160,86220
5633,406502,407702,60,84600,2,"""12""",86220,86280
5633,407702,408403,60,84600,2,"""12""",86280,86340
5633,408403,403502,60,84600,2,"""12""",86340,86400
5633,403502,403701,60,84600,2,"""12""",86400,86460
5633,403701,404600,60,84600,2,"""12""",86460,86520
5633,404600,402602,60,84600,2,"""12""",86520,86580
5633,402602,403602,120,84600,2,"""12""",86580,86700
5633,403602,404701,60,84600,2,"""12""",86700,86760
5633,404701,404700,0,84600,2,"""12""",86760,86760
5633,404700,32100,0,84600,2,"""12""",86760,86760
5633,32100,406001,60,84600,2,"""12""",86760,86820
5633,406001,302602,60,84600,2,"""12""",86820,86880
5633,302602,406701,60,84600,2,"""12""",86880,86940
5633,406701,406902,60,84600,2,"""12""",86940,87000
5654,112105,103001,120,50400,5,"""1""",50400,50520
5654,103001,106501,120,50400,5,"""1""",50520,50640
5654,106501,119006,120,50400,5,"""1""",50640,50760
5654,119006,208101,120,50400,5,"""1""",50760,50880
5654,208101,201504,120,50400,5,"""1""",50880,51000
5654,201504,208501,60,50400,5,"""1""",51000,51060
5654,208501,208003,60,50400,5,"""1""",51060,51120
5654,208003,201601,60,50400,5,"""1""",51120,51180
5654,201601,203001,60,50400,5,"""1""",51180,51240
5654,203001,207101,60,50400,5,"""1""",51240,51300
5654,207101,207301,60,50400,5,"""1""",51300,51360
5654,207301,207001,60,50400,5,"""1""",51360,51420
5654,207001,207202,60,50400,5,"""1""",51420,51480
5654,207202,107802,60,50400,5,"""1""",51480,51540
5654,107802,803102,60,50400,5,"""1""",51540,51600
5654,803102,803002,60,50400,5,"""1""",51600,51660
5654,803002,800802,120,50400,5,"""1""",51660,51780
5654,800802,801003,60,50400,5,"""1""",51780,51840
5654,801003,801203,60,50400,5,"""1""",51840,51900
5654,801203,802602,120,50400,5,"""1""",51900,52020
5654,802602,802802,60,50400,5,"""1""",52020,52080
5654,802802,802501,60,50400,5,"""1""",52080,52140
5654,112105,103001,120,52800,5,"""1""",52800,52920
5654,103001,106501,120,52800,5,"""1""",52920,53040
5654,106501,119006,120,52800,5,"""1""",53040,53160
5654,119006,208101,120,52800,5,"""1""",53160,53280
5654,208101,201504,120,52800,5,"""1""",53280,53400
5654,201504,208501,60,52800,5,"""1""",53400,53460
5654,208501,208003,60,52800,5,"""1""",53460,53520
5654,208003,201601,60,52800,5,"""1""",53520,53580
5654,201601,203001,60,52800,5,"""1""",53580,53640
5654,203001,207101,60,52800,5,"""1""",53640,53700
5654,207101,207301,60,52800,5,"""1""",53700,53760
5654,207301,207001,60,52800,5,"""1""",53760,53820
5654,207001,207202,60,52800,5,"""1""",53820,53880
5654,207202,107802,60,52800,5,"""1""",53880,53940
5654,107802,803102,60,52800,5,"""1""",53940,54000
5654,803102,803002,60,52800,5,"""1""",54000,54060
5654,803002,800802,120,52800,5,"""1""",54060,54180
5654,800802,801003,60,52800,5,"""1""",54180,54240
5654,801003,801203,60,52800,5,"""1""",54240,54300
5654,801203,802602,120,52800,5,"""1""",54300,54420
5654,802602,802802,60,52800,5,"""1""",54420,54480
5654,802802,802501,60,52800,5,"""1""",54480,54540
5655,112105,103001,120,45600,5,"""13""",45600,45720
5655,103001,106501,120,45600,5,"""13""",45720,45840
5655,106501,119006,120,45600,5,"""13""",45840,45960
5655,119006,208101,120,45600,5,"""13""",45960,46080
5655,208101,201504,120,45600,5,"""13""",46080,46200
5655,201504,208501,60,45600,5,"""13""",46200,46260
5655,208501,208003,60,45600,5,"""13""",46260,46320
5655,208003,201601,60,45600,5,"""13""",46320,46380
5655,201601,203001,60,45600,5,"""13""",46380,46440
5655,203001,207101,60,45600,5,"""13""",46440,46500
5655,207101,207301,60,45600,5,"""13""",46500,46560
5655,207301,207001,60,45600,5,"""13""",46560,46620
5655,207001,207202,60,45600,5,"""13""",46620,46680
5655,207202,107802,60,45600,5,"""13""",46680,46740
5655,107802,803102,60,45600,5,"""13""",46740,46800
5655,803102,803002,60,45600,5,"""13""",46800,46860
5655,803002,800802,120,45600,5,"""13""",46860,46980
5655,800802,801003,60,45600,5,"""13""",46980,47040
5655,801003,801401,180,45600,5,"""13""",47040,47220
5655,801401,11101,120,45600,5,"""13""",47220,47340
5655,11101,800901,180,45600,5,"""13""",47340,47520
5656,112105,103001,120,58200,5,"""11""",58200,58320
5656,103001,106501,120,58200,5,"""11""",58320,58440
5656,106501,119006,120,58200,5,"""11""",58440,58560
5656,119006,208101,120,58200,5,"""11""",58560,58680
5656,208101,201504,120,58200,5,"""11""",58680,58800
5656,201504,208501,60,58200,5,"""11""",58800,58860
5656,208501,208003,60,58200,5,"""11""",58860,58920
5656,208003,201601,60,58200,5,"""11""",58920,58980
5656,201601,203001,60,58200,5,"""11""",58980,59040
5656,203001,207101,60,58200,5,"""11""",59040,59100
5656,207101,207301,60,58200,5,"""11""",59100,59160
5656,207301,207001,60,58200,5,"""11""",59160,59220
5656,207001,207202,60,58200,5,"""11""",59220,59280
5656,207202,107802,60,58200,5,"""11""",59280,59340
5656,107802,803102,60,58200,5,"""11""",59340,59400
5656,803102,803002,60,58200,5,"""11""",59400,59460
5656,803002,800802,120,58200,5,"""11""",59460,59580
5656,800802,801003,60,58200,5,"""11""",59580,59640
5656,801003,86800,120,58200,5,"""11""",59640,59760
5657,800901,11101,180,47520,5,"""10""",47520,47700
5657,11101,801402,120,47520,5,"""10""",47700,47820
5657,801402,86800,120,47520,5,"""10""",47820,47940
5657,86800,801002,120,47520,5,"""10""",47940,48060
5657,801002,800801,60,47520,5,"""10""",48060,48120
5657,800801,803001,120,47520,5,"""10""",48120,48240
5657,803001,803101,60,47520,5,"""10""",48240,48300
5657,803101,107801,60,47520,5,"""10""",48300,48360
5657,107801,207201,60,47520,5,"""10""",48360,48420
5657,207201,207002,60,47520,5,"""10""",48420,48480
5657,207002,207302,60,47520,5,"""10""",48480,48540
5657,207302,207102,60,47520,5,"""10""",48540,48600
5657,207102,203002,60,47520,5,"""10""",48600,48660
5657,203002,201602,60,47520,5,"""10""",48660,48720
5657,201602,208005,60,47520,5,"""10""",48720,48780
5657,208005,208500,60,47520,5,"""10""",48780,48840
5657,208500,201503,60,47520,5,"""10""",48840,48900
5657,201503,208103,120,47520,5,"""10""",48900,49020
5657,208103,119005,120,47520,5,"""10""",49020,49140
5657,119005,106503,120,47520,5,"""10""",49140,49260
5657,106503,103006,120,47520,5,"""10""",49260,49380
5657,103006,112105,120,47520,5,"""10""",49380,49500
5658,802501,802801,60,24960,5,"""2""",24960,25020
5658,802801,801202,120,24960,5,"""2""",25020,25140
5658,801202,801002,120,24960,5,"""2""",25140,25260
5658,801002,800801,120,24960,5,"""2""",25260,25380
5658,800801,803001,180,24960,5,"""2""",25380,25560
5658,803001,803101,120,24960,5,"""2""",25560,25680
5658,803101,107801,60,24960,5,"""2""",25680,25740
5658,107801,207201,60,24960,5,"""2""",25740,25800
5658,207201,207002,180,24960,5,"""2""",25800,25980
5658,207002,207302,120,24960,5,"""2""",25980,26100
5658,207302,207102,120,24960,5,"""2""",26100,26220
5658,207102,203002,60,24960,5,"""2""",26220,26280
5658,203002,201602,60,24960,5,"""2""",26280,26340
5658,201602,208005,60,24960,5,"""2""",26340,26400
5658,208005,208500,60,24960,5,"""2""",26400,26460
5658,208500,201503,180,24960,5,"""2""",26460,26640
5658,201503,208103,60,24960,5,"""2""",26640,26700
5658,208103,119005,180,24960,5,"""2""",26700,26880
5658,119005,106503,120,24960,5,"""2""",26880,27000
5658,106503,103006,120,24960,5,"""2""",27000,27120
5658,103006,112105,120,24960,5,"""2""",27120,27240
5658,802501,802801,60,25620,5,"""2""",25620,25680
5658,802801,801202,120,25620,5,"""2""",25680,25800
5658,801202,801002,120,25620,5,"""2""",25800,25920
5658,801002,800801,120,25620,5,"""2""",25920,26040
5658,800801,803001,180,25620,5,"""2""",26040,26220
5658,803001,803101,120,25620,5,"""2""",26220,26340
5658,803101,107801,60,25620,5,"""2""",26340,26400
5658,107801,207201,60,25620,5,"""2""",26400,26460
5658,207201,207002,180,25620,5,"""2""",26460,26640
5658,207002,207302,120,25620,5,"""2""",26640,26760
5658,207302,207102,120,25620,5,"""2""",26760,26880
5658,207102,203002,60,25620,5,"""2""",26880,26940
5658,203002,201602,60,25620,5,"""2""",26940,27000
5658,201602,208005,60,25620,5,"""2""",27000,27060
5658,208005,208500,60,25620,5,"""2""",27060,27120
5658,208500,201503,180,25620,5,"""2""",27120,27300
5658,201503,208103,60,25620,5,"""2""",27300,27360
5658,208103,119005,180,25620,5,"""2""",27360,27540
5658,119005,106503,120,25620,5,"""2""",27540,27660
5658,106503,103006,120,25620,5,"""2""",27660,27780
5658,103006,112105,120,25620,5,"""2""",27780,27900
5659,802501,802801,60,53820,5,"""2""",53820,53880
5659,802801,801202,120,53820,5,"""2""",53880,54000
5659,801202,801002,60,53820,5,"""2""",54000,54060
5659,801002,800801,60,53820,5,"""2""",54060,54120
5659,800801,803001,120,53820,5,"""2""",54120,54240
5659,803001,803101,60,53820,5,"""2""",54240,54300
5659,803101,107801,60,53820,5,"""2""",54300,54360
5659,107801,207201,60,53820,5,"""2""",54360,54420
5659,207201,207002,60,53820,5,"""2""",54420,54480
5659,207002,207302,60,53820,5,"""2""",54480,54540
5659,207302,207102,60,53820,5,"""2""",54540,54600
5659,207102,203002,60,53820,5,"""2""",54600,54660
5659,203002,201602,60,53820,5,"""2""",54660,54720
5659,201602,208005,60,53820,5,"""2""",54720,54780
5659,208005,208500,60,53820,5,"""2""",54780,54840
5659,208500,201503,60,53820,5,"""2""",54840,54900
5659,201503,208103,120,53820,5,"""2""",54900,55020
5659,208103,119005,120,53820,5,"""2""",55020,55140
5659,119005,106503,120,53820,5,"""2""",55140,55260
5659,106503,103006,120,53820,5,"""2""",55260,55380
5659,103006,112105,120,53820,5,"""2""",55380,55500
5659,802501,802801,60,55020,5,"""2""",55020,55080
5659,802801,801202,120,55020,5,"""2""",55080,55200
5659,801202,801002,60,55020,5,"""2""",55200,55260
5659,801002,800801,60,55020,5,"""2""",55260,55320
5659,800801,803001,120,55020,5,"""2""",55320,55440
5659,803001,803101,60,55020,5,"""2""",55440,55500
5659,803101,107801,60,55020,5,"""2""",55500,55560
5659,107801,207201,60,55020,5,"""2""",55560,55620
5659,207201,207002,60,55020,5,"""2""",55620,55680
5659,207002,207302,60,55020,5,"""2""",55680,55740
5659,207302,207102,60,55020,5,"""2""",55740,55800
5659,207102,203002,60,55020,5,"""2""",55800,55860
5659,203002,201602,60,55020,5,"""2""",55860,55920
5659,201602,208005,60,55020,5,"""2""",55920,55980
5659,208005,208500,60,55020,5,"""2""",55980,56040
5659,208500,201503,60,55020,5,"""2""",56040,56100
5659,201503,208103,120,55020,5,"""2""",56100,56220
5659,208103,119005,120,55020,5,"""2""",56220,56340
5659,119005,106503,120,55020,5,"""2""",56340,56460
5659,106503,103006,120,55020,5,"""2""",56460,56580
5659,103006,112105,120,55020,5,"""2""",56580,56700
5660,86800,801002,120,20340,5,"""14""",20340,20460
5660,801002,800801,60,20340,5,"""14""",20460,20520
5660,800801,803001,120,20340,5,"""14""",20520,20640
5660,803001,803101,60,20340,5,"""14""",20640,20700
5660,803101,107801,60,20340,5,"""14""",20700,20760
5660,107801,207201,60,20340,5,"""14""",20760,20820
5660,207201,207002,60,20340,5,"""14""",20820,20880
5660,207002,207302,60,20340,5,"""14""",20880,20940
5660,207302,207102,60,20340,5,"""14""",20940,21000
5660,207102,203002,60,20340,5,"""14""",21000,21060
5660,203002,201602,60,20340,5,"""14""",21060,21120
5660,201602,208005,60,20340,5,"""14""",21120,21180
5660,208005,208500,60,20340,5,"""14""",21180,21240
5660,208500,201503,60,20340,5,"""14""",21240,21300
5660,201503,208103,120,20340,5,"""14""",21300,21420
5660,208103,119005,120,20340,5,"""14""",21420,21540
5660,119005,106503,120,20340,5,"""14""",21540,21660
5660,106503,103006,120,20340,5,"""14""",21660,21780
5660,103006,112105,120,20340,5,"""14""",21780,21900
5660,86800,801002,120,61140,5,"""14""",61140,61260
5660,801002,800801,60,61140,5,"""14""",61260,61320
5660,800801,803001,120,61140,5,"""14""",61320,61440
5660,803001,803101,60,61140,5,"""14""",61440,61500
5660,803101,107801,60,61140,5,"""14""",61500,61560
5660,107801,207201,60,61140,5,"""14""",61560,61620
5660,207201,207002,60,61140,5,"""14""",61620,61680
5660,207002,207302,60,61140,5,"""14""",61680,61740
5660,207302,207102,60,61140,5,"""14""",61740,61800
5660,207102,203002,60,61140,5,"""14""",61800,61860
5660,203002,201602,60,61140,5,"""14""",61860,61920
5660,201602,208005,60,61140,5,"""14""",61920,61980
5660,208005,208500,60,61140,5,"""14""",61980,62040
5660,208500,201503,60,61140,5,"""14""",62040,62100
5660,201503,208103,120,61140,5,"""14""",62100,62220
5660,208103,119005,120,61140,5,"""14""",62220,62340
5660,119005,106503,120,61140,5,"""14""",62340,62460
5660,106503,103006,120,61140,5,"""14""",62460,62580
5660,103006,112105,120,61140,5,"""14""",62580,62700
5660,86800,801002,120,64740,5,"""14""",64740,64860
5660,801002,800801,60,64740,5,"""14""",64860,64920
5660,800801,803001,120,64740,5,"""14""",64920,65040
5660,803001,803101,60,64740,5,"""14""",65040,65100
5660,803101,107801,60,64740,5,"""14""",65100,65160
5660,107801,207201,60,64740,5,"""14""",65160,65220
5660,207201,207002,60,64740,5,"""14""",65220,65280
5660,207002,207302,60,64740,5,"""14""",65280,65340
5660,207302,207102,60,64740,5,"""14""",65340,65400
5660,207102,203002,60,64740,5,"""14""",65400,65460
5660,203002,201602,60,64740,5,"""14""",65460,65520
5660,201602,208005,60,64740,5,"""14""",65520,65580
5660,208005,208500,60,64740,5,"""14""",65580,65640
5660,208500,201503,60,64740,5,"""14""",65640,65700
5660,201503,208103,120,64740,5,"""14""",65700,65820
5660,208103,119005,120,64740,5,"""14""",65820,65940
5660,119005,106503,120,64740,5,"""14""",65940,66060
5660,106503,103006,120,64740,5,"""14""",66060,66180
5660,103006,112105,120,64740,5,"""14""",66180,66300
6016,400200,400402,60,79680,10,"""1""",79680,79740
6016,400402,402002,60,79680,10,"""1""",79740,79800
6016,402002,500702,60,79680,10,"""1""",79800,79860
6016,500702,402204,60,79680,10,"""1""",79860,79920
6016,402204,402900,60,79680,10,"""1""",79920,79980
6016,402900,405300,60,79680,10,"""1""",79980,80040
6016,405300,402800,60,79680,10,"""1""",80040,80100
6016,402800,405100,60,79680,10,"""1""",80100,80160
6016,405100,405902,60,79680,10,"""1""",80160,80220
6016,405902,406500,60,79680,10,"""1""",80220,80280
6016,406500,400601,60,79680,10,"""1""",80280,80340
6016,400601,404300,60,79680,10,"""1""",80340,80400
6016,404300,407401,60,79680,10,"""1""",80400,80460
6016,407401,404103,120,79680,10,"""1""",80460,80580
6016,404103,403104,60,79680,10,"""1""",80580,80640
6016,403104,112112,180,79680,10,"""1""",80640,80820
6016,112112,103001,180,79680,10,"""1""",80820,81000
6016,103001,106501,60,79680,10,"""1""",81000,81060
6016,106501,119006,120,79680,10,"""1""",81060,81180
6016,119006,302501,120,79680,10,"""1""",81180,81300
6016,302501,303001,60,79680,10,"""1""",81300,81360
6016,303001,302201,120,79680,10,"""1""",81360,81480
6016,302201,302001,60,79680,10,"""1""",81480,81540
6016,302001,302100,60,79680,10,"""1""",81540,81600
6016,302100,300302,180,79680,10,"""1""",81600,81780
6016,300302,302402,60,79680,10,"""1""",81780,81840
6016,302402,302702,60,79680,10,"""1""",81840,81900
6016,302702,302300,60,79680,10,"""1""",81900,81960
6017,400200,400402,60,72480,10,"""931""",72480,72540
6017,400402,402002,60,72480,10,"""931""",72540,72600
6017,402002,500702,60,72480,10,"""931""",72600,72660
6017,500702,402204,60,72480,10,"""931""",72660,72720
6017,402204,402900,60,72480,10,"""931""",72720,72780
6017,402900,405300,60,72480,10,"""931""",72780,72840
6017,405300,402800,60,72480,10,"""931""",72840,72900
6017,402800,405100,60,72480,10,"""931""",72900,72960
6017,405100,405902,60,72480,10,"""931""",72960,73020
6017,405902,406500,60,72480,10,"""931""",73020,73080
6017,406500,400601,60,72480,10,"""931""",73080,73140
6017,400601,404300,60,72480,10,"""931""",73140,73200
6017,404300,407401,60,72480,10,"""931""",73200,73260
6017,407401,404103,120,72480,10,"""931""",73260,73380
6017,404103,403104,60,72480,10,"""931""",73380,73440
6017,403104,112112,180,72480,10,"""931""",73440,73620
6017,112112,103001,180,72480,10,"""931""",73620,73800
6017,103001,106501,60,72480,10,"""931""",73800,73860
6017,106501,119006,120,72480,10,"""931""",73860,73980
6017,119006,302501,120,72480,10,"""931""",73980,74100
6017,302501,303001,60,72480,10,"""931""",74100,74160
6017,303001,302201,120,72480,10,"""931""",74160,74280
6017,302201,302001,60,72480,10,"""931""",74280,74340
6017,302001,302100,60,72480,10,"""931""",74340,74400
6017,400200,400402,60,76080,10,"""931""",76080,76140
6017,400402,402002,60,76080,10,"""931""",76140,76200
6017,402002,500702,60,76080,10,"""931""",76200,76260
6017,500702,402204,60,76080,10,"""931""",76260,76320
6017,402204,402900,60,76080,10,"""931""",76320,76380
6017,402900,405300,60,76080,10,"""931""",76380,76440
6017,405300,402800,60,76080,10,"""931""",76440,76500
6017,402800,405100,60,76080,10,"""931""",76500,76560
6017,405100,405902,60,76080,10,"""931""",76560,76620
6017,405902,406500,60,76080,10,"""931""",76620,76680
6017,406500,400601,60,76080,10,"""931""",76680,76740
6017,400601,404300,60,76080,10,"""931""",76740,76800
6017,404300,407401,60,76080,10,"""931""",76800,76860
6017,407401,404103,120,76080,10,"""931""",76860,76980
6017,404103,403104,60,76080,10,"""931""",76980,77040
6017,403104,112112,180,76080,10,"""931""",77040,77220
6017,112112,103001,180,76080,10,"""931""",77220,77400
6017,103001,106501,60,76080,10,"""931""",77400,77460
6017,106501,119006,120,76080,10,"""931""",77460,77580
6017,119006,302501,120,76080,10,"""931""",77580,77700
6017,302501,303001,60,76080,10,"""931""",77700,77760
6017,303001,302201,120,76080,10,"""931""",77760,77880
6017,302201,302001,60,76080,10,"""931""",77880,77940
6017,302001,302100,60,76080,10,"""931""",77940,78000
6017,400200,400402,60,83280,10,"""931""",83280,83340
6017,400402,402002,60,83280,10,"""931""",83340,83400
6017,402002,500702,60,83280,10,"""931""",83400,83460
6017,500702,402204,60,83280,10,"""931""",83460,83520
6017,402204,402900,60,83280,10,"""931""",83520,83580
6017,402900,405300,60,83280,10,"""931""",83580,83640
6017,405300,402800,60,83280,10,"""931""",83640,83700
6017,402800,405100,60,83280,10,"""931""",83700,83760
6017,405100,405902,60,83280,10,"""931""",83760,83820
6017,405902,406500,60,83280,10,"""931""",83820,83880
6017,406500,400601,60,83280,10,"""931""",83880,83940
6017,400601,404300,60,83280,10,"""931""",83940,84000
6017,404300,407401,60,83280,10,"""931""",84000,84060
6017,407401,404103,120,83280,10,"""931""",84060,84180
6017,404103,403104,60,83280,10,"""931""",84180,84240
6017,403104,112112,180,83280,10,"""931""",84240,84420
6017,112112,103001,180,83280,10,"""931""",84420,84600
6017,103001,106501,60,83280,10,"""931""",84600,84660
6017,106501,119006,120,83280,10,"""931""",84660,84780
6017,119006,302501,120,83280,10,"""931""",84780,84900
6017,302501,303001,60,83280,10,"""931""",84900,84960
6017,303001,302201,120,83280,10,"""931""",84960,85080
6017,302201,302001,60,83280,10,"""931""",85080,85140
6017,302001,302100,60,83280,10,"""931""",85140,85200
6018,405300,402800,60,71040,10,"""7""",71040,71100
6018,402800,405100,60,71040,10,"""7""",71100,71160
6018,405100,405902,60,71040,10,"""7""",71160,71220
6018,405902,406500,60,71040,10,"""7""",71220,71280
6018,406500,400601,60,71040,10,"""7""",71280,71340
6018,400601,404300,60,71040,10,"""7""",71340,71400
6018,404300,407401,60,71040,10,"""7""",71400,71460
6018,407401,404103,120,71040,10,"""7""",71460,71580
6018,404103,403104,60,71040,10,"""7""",71580,71640
6018,403104,112112,180,71040,10,"""7""",71640,71820
6018,112112,103001,180,71040,10,"""7""",71820,72000
6018,103001,106501,60,71040,10,"""7""",72000,72060
6018,106501,119006,120,71040,10,"""7""",72060,72180
6018,119006,302501,120,71040,10,"""7""",72180,72300
6018,302501,303001,60,71040,10,"""7""",72300,72360
6018,303001,302201,120,71040,10,"""7""",72360,72480
6018,302201,302001,60,71040,10,"""7""",72480,72540
6018,302001,302100,60,71040,10,"""7""",72540,72600
6018,405300,402800,60,74640,10,"""7""",74640,74700
6018,402800,405100,60,74640,10,"""7""",74700,74760
6018,405100,405902,60,74640,10,"""7""",74760,74820
6018,405902,406500,60,74640,10,"""7""",74820,74880
6018,406500,400601,60,74640,10,"""7""",74880,74940
6018,400601,404300,60,74640,10,"""7""",74940,75000
6018,404300,407401,60,74640,10,"""7""",75000,75060
6018,407401,404103,120,74640,10,"""7""",75060,75180
6018,404103,403104,60,74640,10,"""7""",75180,75240
6018,403104,112112,180,74640,10,"""7""",75240,75420
6018,112112,103001,180,74640,10,"""7""",75420,75600
6018,103001,106501,60,74640,10,"""7""",75600,75660
6018,106501,119006,120,74640,10,"""7""",75660,75780
6018,119006,302501,120,74640,10,"""7""",75780,75900
6018,302501,303001,60,74640,10,"""7""",75900,75960
6018,303001,302201,120,74640,10,"""7""",75960,76080
6018,302201,302001,60,74640,10,"""7""",76080,76140
6018,302001,302100,60,74640,10,"""7""",76140,76200
6018,405300,402800,60,78240,10,"""7""",78240,78300
6018,402800,405100,60,78240,10,"""7""",78300,78360
6018,405100,405902,60,78240,10,"""7""",78360,78420
6018,405902,406500,60,78240,10,"""7""",78420,78480
6018,406500,400601,60,78240,10,"""7""",78480,78540
6018,400601,404300,60,78240,10,"""7""",78540,78600
6018,404300,407401,60,78240,10,"""7""",78600,78660
6018,407401,404103,120,78240,10,"""7""",78660,78780
6018,404103,403104,60,78240,10,"""7""",78780,78840
6018,403104,112112,180,78240,10,"""7""",78840,79020
6018,112112,103001,180,78240,10,"""7""",79020,79200
6018,103001,106501,60,78240,10,"""7""",79200,79260
6018,106501,119006,120,78240,10,"""7""",79260,79380
6018,119006,302501,120,78240,10,"""7""",79380,79500
6018,302501,303001,60,78240,10,"""7""",79500,79560
6018,303001,302201,120,78240,10,"""7""",79560,79680
6018,302201,302001,60,78240,10,"""7""",79680,79740
6018,302001,302100,60,78240,10,"""7""",79740,79800
6018,405300,402800,60,81840,10,"""7""",81840,81900
6018,402800,405100,60,81840,10,"""7""",81900,81960
6018,405100,405902,60,81840,10,"""7""",81960,82020
6018,405902,406500,60,81840,10,"""7""",82020,82080
6018,406500,400601,60,81840,10,"""7""",82080,82140
6018,400601,404300,60,81840,10,"""7""",82140,82200
6018,404300,407401,60,81840,10,"""7""",82200,82260
6018,407401,404103,120,81840,10,"""7""",82260,82380
6018,404103,403104,60,81840,10,"""7""",82380,82440
6018,403104,112112,180,81840,10,"""7""",82440,82620
6018,112112,103001,180,81840,10,"""7""",82620,82800
6018,103001,106501,60,81840,10,"""7""",82800,82860
6018,106501,119006,120,81840,10,"""7""",82860,82980
6018,119006,302501,120,81840,10,"""7""",82980,83100
6018,302501,303001,60,81840,10,"""7""",83100,83160
6018,303001,302201,120,81840,10,"""7""",83160,83280
6018,302201,302001,60,81840,10,"""7""",83280,83340
6018,302001,302100,60,81840,10,"""7""",83340,83400
6018,405300,402800,60,85440,10,"""7""",85440,85500
6018,402800,405100,60,85440,10,"""7""",85500,85560
6018,405100,405902,60,85440,10,"""7""",85560,85620
6018,405902,406500,60,85440,10,"""7""",85620,85680
6018,406500,400601,60,85440,10,"""7""",85680,85740
6018,400601,404300,60,85440,10,"""7""",85740,85800
6018,404300,407401,60,85440,10,"""7""",85800,85860
6018,407401,404103,120,85440,10,"""7""",85860,85980
6018,404103,403104,60,85440,10,"""7""",85980,86040
6018,403104,112112,180,85440,10,"""7""",86040,86220
6018,112112,103001,180,85440,10,"""7""",86220,86400
6018,103001,106501,60,85440,10,"""7""",86400,86460
6018,106501,119006,120,85440,10,"""7""",86460,86580
6018,119006,302501,120,85440,10,"""7""",86580,86700
6018,302501,303001,60,85440,10,"""7""",86700,86760
6018,303001,302201,120,85440,10,"""7""",86760,86880
6018,302201,302001,60,85440,10,"""7""",86880,86940
6018,302001,302100,60,85440,10,"""7""",86940,87000
6108,503300,503302,60,46740,73,"""11""",46740,46800
6108,503302,503901,60,46740,73,"""11""",46800,46860
6108,503901,500404,60,46740,73,"""11""",46860,46920
6108,500404,29502,60,46740,73,"""11""",46920,46980
6108,29502,503304,60,46740,73,"""11""",46980,47040
6108,503304,501900,120,46740,73,"""11""",47040,47160
6108,501900,501704,120,46740,73,"""11""",47160,47280
6108,501704,502502,60,46740,73,"""11""",47280,47340
6108,502502,501500,60,46740,73,"""11""",47340,47400
6108,501500,500500,60,46740,73,"""11""",47400,47460
6108,500500,503800,60,46740,73,"""11""",47460,47520
6108,503800,504001,0,46740,73,"""11""",47520,47520
6108,504001,501101,60,46740,73,"""11""",47520,47580
6108,501101,503305,60,46740,73,"""11""",47580,47640
6110,503300,503902,180,27420,73,"""14""",27420,27600
6110,503902,503303,60,27420,73,"""14""",27600,27660
6110,503303,501900,120,27420,73,"""14""",27660,27780
6110,501900,501704,120,27420,73,"""14""",27780,27900
6110,501704,502502,60,27420,73,"""14""",27900,27960
6110,502502,501500,60,27420,73,"""14""",27960,28020
6110,501500,500500,60,27420,73,"""14""",28020,28080
6110,500500,503800,60,27420,73,"""14""",28080,28140
6110,503800,504001,0,27420,73,"""14""",28140,28140
6110,504001,501101,60,27420,73,"""14""",28140,28200
6110,501101,503305,60,27420,73,"""14""",28200,28260
6111,503300,501102,60,26400,73,"""2""",26400,26460
6111,501102,504002,60,26400,73,"""2""",26460,26520
6111,504002,503803,60,26400,73,"""2""",26520,26580
6111,503803,500300,60,26400,73,"""2""",26580,26640
6111,500300,500200,60,26400,73,"""2""",26640,26700
6111,500200,502300,180,26400,73,"""2""",26700,26880
6111,502300,502600,0,26400,73,"""2""",26880,26880
6111,502600,502501,60,26400,73,"""2""",26880,26940
6111,502501,501703,120,26400,73,"""2""",26940,27060
6111,501703,503305,180,26400,73,"""2""",27060,27240
6112,503300,501900,120,41040,73,"""1""",41040,41160
6112,501900,501704,120,41040,73,"""1""",41160,41280
6112,501704,502502,60,41040,73,"""1""",41280,41340
6112,502502,501500,60,41040,73,"""1""",41340,41400
6112,501500,500500,60,41040,73,"""1""",41400,41460
6112,500500,503800,60,41040,73,"""1""",41460,41520
6112,503800,504001,0,41040,73,"""1""",41520,41520
6112,504001,501101,60,41040,73,"""1""",41520,41580
6112,501101,503305,60,41040,73,"""1""",41580,41640
6112,503300,501900,120,44640,73,"""1""",44640,44760
6112,501900,501704,120,44640,73,"""1""",44760,44880
6112,501704,502502,60,44640,73,"""1""",44880,44940
6112,502502,501500,60,44640,73,"""1""",44940,45000
6112,501500,500500,60,44640,73,"""1""",45000,45060
6112,500500,503800,60,44640,73,"""1""",45060,45120
6112,503800,504001,0,44640,73,"""1""",45120,45120
6112,504001,501101,60,44640,73,"""1""",45120,45180
6112,501101,503305,60,44640,73,"""1""",45180,45240
6112,503300,501900,120,57840,73,"""1""",57840,57960
6112,501900,501704,120,57840,73,"""1""",57960,58080
6112,501704,502502,60,57840,73,"""1""",58080,58140
6112,502502,501500,60,57840,73,"""1""",58140,58200
6112,501500,500500,60,57840,73,"""1""",58200,58260
6112,500500,503800,60,57840,73,"""1""",58260,58320
6112,503800,504001,0,57840,73,"""1""",58320,58320
6112,504001,501101,60,57840,73,"""1""",58320,58380
6112,501101,503305,60,57840,73,"""1""",58380,58440
6139,503302,503402,60,23880,11,"""3""",23880,23940
6139,503402,503501,60,23880,11,"""3""",23940,24000
6139,503501,503202,60,23880,11,"""3""",24000,24060
6139,503202,500405,60,23880,11,"""3""",24060,24120
6139,500405,501301,120,23880,11,"""3""",24120,24240
6139,501301,502101,120,23880,11,"""3""",24240,24360
6139,502101,501001,60,23880,11,"""3""",24360,24420
6139,501001,502201,120,23880,11,"""3""",24420,24540
6139,502201,101001,240,23880,11,"""3""",24540,24780
6139,101001,118101,60,23880,11,"""3""",24780,24840
6139,118101,106001,60,23880,11,"""3""",24840,24900
6139,106001,118001,120,23880,11,"""3""",24900,25020
6139,118001,103004,180,23880,11,"""3""",25020,25200
6139,103004,112107,180,23880,11,"""3""",25200,25380
6139,112107,403102,60,23880,11,"""3""",25380,25440
6139,403102,402301,60,23880,11,"""3""",25440,25500
6139,402301,406602,120,23880,11,"""3""",25500,25620
6139,406602,402501,60,23880,11,"""3""",25620,25680
6139,402501,408004,120,23880,11,"""3""",25680,25800
6139,408004,406801,120,23880,11,"""3""",25800,25920
6139,406801,402401,120,23880,11,"""3""",25920,26040
6139,402401,403901,60,23880,11,"""3""",26040,26100
6139,403901,33606,60,23880,11,"""3""",26100,26160
6139,33606,407503,60,23880,11,"""3""",26160,26220
6139,407503,408900,60,23880,11,"""3""",26220,26280
6139,408900,400802,60,23880,11,"""3""",26280,26340
6139,400802,401303,120,23880,11,"""3""",26340,26460
6139,401303,26503,60,23880,11,"""3""",26460,26520
6139,26503,401502,120,23880,11,"""3""",26520,26640
6139,401502,401901,60,23880,11,"""3""",26640,26700
6139,401901,401401,60,23880,11,"""3""",26700,26760
6139,401401,403301,60,23880,11,"""3""",26760,26820
6139,403301,410202,120,23880,11,"""3""",26820,26940
6139,503302,503402,60,25080,11,"""3""",25080,25140
6139,503402,503501,60,25080,11,"""3""",25140,25200
6139,503501,503202,60,25080,11,"""3""",25200,25260
6139,503202,500405,60,25080,11,"""3""",25260,25320
6139,500405,501301,120,25080,11,"""3""",25320,25440
6139,501301,502101,120,25080,11,"""3""",25440,25560
6139,502101,501001,60,25080,11,"""3""",25560,25620
6139,501001,502201,120,25080,11,"""3""",25620,25740
6139,502201,101001,240,25080,11,"""3""",25740,25980
6139,101001,118101,60,25080,11,"""3""",25980,26040
6139,118101,106001,60,25080,11,"""3""",26040,26100
6139,106001,118001,120,25080,11,"""3""",26100,26220
6139,118001,103004,180,25080,11,"""3""",26220,26400
6139,103004,112107,180,25080,11,"""3""",26400,26580
6139,112107,403102,60,25080,11,"""3""",26580,26640
6139,403102,402301,60,25080,11,"""3""",26640,26700
6139,402301,406602,120,25080,11,"""3""",26700,26820
6139,406602,402501,60,25080,11,"""3""",26820,26880
6139,402501,408004,120,25080,11,"""3""",26880,27000
6139,408004,406801,120,25080,11,"""3""",27000,27120
6139,406801,402401,120,25080,11,"""3""",27120,27240
6139,402401,403901,60,25080,11,"""3""",27240,27300
6139,403901,33606,60,25080,11,"""3""",27300,27360
6139,33606,407503,60,25080,11,"""3""",27360,27420
6139,407503,408900,60,25080,11,"""3""",27420,27480
6139,408900,400802,60,25080,11,"""3""",27480,27540
6139,400802,401303,120,25080,11,"""3""",27540,27660
6139,401303,26503,60,25080,11,"""3""",27660,27720
6139,26503,401502,120,25080,11,"""3""",27720,27840
6139,401502,401901,60,25080,11,"""3""",27840,27900
6139,401901,401401,60,25080,11,"""3""",27900,27960
6139,401401,403301,60,25080,11,"""3""",27960,28020
6139,403301,410202,120,25080,11,"""3""",28020,28140
6139,503302,503402,60,26280,11,"""3""",26280,26340
6139,503402,503501,60,26280,11,"""3""",26340,26400
6139,503501,503202,60,26280,11,"""3""",26400,26460
6139,503202,500405,60,26280,11,"""3""",26460,26520
6139,500405,501301,120,26280,11,"""3""",26520,26640
6139,501301,502101,120,26280,11,"""3""",26640,26760
6139,502101,501001,60,26280,11,"""3""",26760,26820
6139,501001,502201,120,26280,11,"""3""",26820,26940
6139,502201,101001,240,26280,11,"""3""",26940,27180
6139,101001,118101,60,26280,11,"""3""",27180,27240
6139,118101,106001,60,26280,11,"""3""",27240,27300
6139,106001,118001,120,26280,11,"""3""",27300,27420
6139,118001,103004,180,26280,11,"""3""",27420,27600
6139,103004,112107,180,26280,11,"""3""",27600,27780
6139,112107,403102,60,26280,11,"""3""",27780,27840
6139,403102,402301,60,26280,11,"""3""",27840,27900
6139,402301,406602,120,26280,11,"""3""",27900,28020
6139,406602,402501,60,26280,11,"""3""",28020,28080
6139,402501,408004,120,26280,11,"""3""",28080,28200
6139,408004,406801,120,26280,11,"""3""",28200,28320
6139,406801,402401,120,26280,11,"""3""",28320,28440
6139,402401,403901,60,26280,11,"""3""",28440,28500
6139,403901,33606,60,26280,11,"""3""",28500,28560
6139,33606,407503,60,26280,11,"""3""",28560,28620
6139,407503,408900,60,26280,11,"""3""",28620,28680
6139,408900,400802,60,26280,11,"""3""",28680,28740
6139,400802,401303,120,26280,11,"""3""",28740,28860
6139,401303,26503,60,26280,11,"""3""",28860,28920
6139,26503,401502,120,26280,11,"""3""",28920,29040
6139,401502,401901,60,26280,11,"""3""",29040,29100
6139,401901,401401,60,26280,11,"""3""",29100,29160
6139,401401,403301,60,26280,11,"""3""",29160,29220
6139,403301,410202,120,26280,11,"""3""",29220,29340
6139,503302,503402,60,27480,11,"""3""",27480,27540
6139,503402,503501,60,27480,11,"""3""",27540,27600
6139,503501,503202,60,27480,11,"""3""",27600,27660
6139,503202,500405,60,27480,11,"""3""",27660,27720
6139,500405,501301,120,27480,11,"""3""",27720,27840
6139,501301,502101,120,27480,11,"""3""",27840,27960
6139,502101,501001,60,27480,11,"""3""",27960,28020
6139,501001,502201,120,27480,11,"""3""",28020,28140
6139,502201,101001,240,27480,11,"""3""",28140,28380
6139,101001,118101,60,27480,11,"""3""",28380,28440
6139,118101,106001,60,27480,11,"""3""",28440,28500
6139,106001,118001,120,27480,11,"""3""",28500,28620
6139,118001,103004,180,27480,11,"""3""",28620,28800
6139,103004,112107,180,27480,11,"""3""",28800,28980
6139,112107,403102,60,27480,11,"""3""",28980,29040
6139,403102,402301,60,27480,11,"""3""",29040,29100
6139,402301,406602,120,27480,11,"""3""",29100,29220
6139,406602,402501,60,27480,11,"""3""",29220,29280
6139,402501,408004,120,27480,11,"""3""",29280,29400
6139,408004,406801,120,27480,11,"""3""",29400,29520
6139,406801,402401,120,27480,11,"""3""",29520,29640
6139,402401,403901,60,27480,11,"""3""",29640,29700
6139,403901,33606,60,27480,11,"""3""",29700,29760
6139,33606,407503,60,27480,11,"""3""",29760,29820
6139,407503,408900,60,27480,11,"""3""",29820,29880
6139,408900,400802,60,27480,11,"""3""",29880,29940
6139,400802,401303,120,27480,11,"""3""",29940,30060
6139,401303,26503,60,27480,11,"""3""",30060,30120
6139,26503,401502,120,27480,11,"""3""",30120,30240
6139,401502,401901,60,27480,11,"""3""",30240,30300
6139,401901,401401,60,27480,11,"""3""",30300,30360
6139,401401,403301,60,27480,11,"""3""",30360,30420
6139,403301,410202,120,27480,11,"""3""",30420,30540
6139,503302,503402,60,28680,11,"""3""",28680,28740
6139,503402,503501,60,28680,11,"""3""",28740,28800
6139,503501,503202,60,28680,11,"""3""",28800,28860
6139,503202,500405,60,28680,11,"""3""",28860,28920
6139,500405,501301,120,28680,11,"""3""",28920,29040
6139,501301,502101,120,28680,11,"""3""",29040,29160
6139,502101,501001,60,28680,11,"""3""",29160,29220
6139,501001,502201,120,28680,11,"""3""",29220,29340
6139,502201,101001,240,28680,11,"""3""",29340,29580
6139,101001,118101,60,28680,11,"""3""",29580,29640
6139,118101,106001,60,28680,11,"""3""",29640,29700
6139,106001,118001,120,28680,11,"""3""",29700,29820
6139,118001,103004,180,28680,11,"""3""",29820,30000
6139,103004,112107,180,28680,11,"""3""",30000,30180
6139,112107,403102,60,28680,11,"""3""",30180,30240
6139,403102,402301,60,28680,11,"""3""",30240,30300
6139,402301,406602,120,28680,11,"""3""",30300,30420
6139,406602,402501,60,28680,11,"""3""",30420,30480
6139,402501,408004,120,28680,11,"""3""",30480,30600
6139,408004,406801,120,28680,11,"""3""",30600,30720
6139,406801,402401,120,28680,11,"""3""",30720,30840
6139,402401,403901,60,28680,11,"""3""",30840,30900
6139,403901,33606,60,28680,11,"""3""",30900,30960
6139,33606,407503,60,28680,11,"""3""",30960,31020
6139,407503,408900,60,28680,11,"""3""",31020,31080
6139,408900,400802,60,28680,11,"""3""",31080,31140
6139,400802,401303,120,28680,11,"""3""",31140,31260
6139,401303,26503,60,28680,11,"""3""",31260,31320
6139,26503,401502,120,28680,11,"""3""",31320,31440
6139,401502,401901,60,28680,11,"""3""",31440,31500
6139,401901,401401,60,28680,11,"""3""",31500,31560
6139,401401,403301,60,28680,11,"""3""",31560,31620
6139,403301,410202,120,28680,11,"""3""",31620,31740
6139,503302,503402,60,29880,11,"""3""",29880,29940
6139,503402,503501,60,29880,11,"""3""",29940,30000
6139,503501,503202,60,29880,11,"""3""",30000,30060
6139,503202,500405,60,29880,11,"""3""",30060,30120
6139,500405,501301,120,29880,11,"""3""",30120,30240
6139,501301,502101,120,29880,11,"""3""",30240,30360
6139,502101,501001,60,29880,11,"""3""",30360,30420
6139,501001,502201,120,29880,11,"""3""",30420,30540
6139,502201,101001,240,29880,11,"""3""",30540,30780
6139,101001,118101,60,29880,11,"""3""",30780,30840
6139,118101,106001,60,29880,11,"""3""",30840,30900
6139,106001,118001,120,29880,11,"""3""",30900,31020
6139,118001,103004,180,29880,11,"""3""",31020,31200
6139,103004,112107,180,29880,11,"""3""",31200,31380
6139,112107,403102,60,29880,11,"""3""",31380,31440
6139,403102,402301,60,29880,11,"""3""",31440,31500
6139,402301,406602,120,29880,11,"""3""",31500,31620
6139,406602,402501,60,29880,11,"""3""",31620,31680
6139,402501,408004,120,29880,11,"""3""",31680,31800
6139,408004,406801,120,29880,11,"""3""",31800,31920
6139,406801,402401,120,29880,11,"""3""",31920,32040
6139,402401,403901,60,29880,11,"""3""",32040,32100
6139,403901,33606,60,29880,11,"""3""",32100,32160
6139,33606,407503,60,29880,11,"""3""",32160,32220
6139,407503,408900,60,29880,11,"""3""",32220,32280
6139,408900,400802,60,29880,11,"""3""",32280,32340
6139,400802,401303,120,29880,11,"""3""",32340,32460
6139,401303,26503,60,29880,11,"""3""",32460,32520
6139,26503,401502,120,29880,11,"""3""",32520,32640
6139,401502,401901,60,29880,11,"""3""",32640,32700
6139,401901,401401,60,29880,11,"""3""",32700,32760
6139,401401,403301,60,29880,11,"""3""",32760,32820
6139,403301,410202,120,29880,11,"""3""",32820,32940
6139,503302,503402,60,31080,11,"""3""",31080,31140
6139,503402,503501,60,31080,11,"""3""",31140,31200
6139,503501,503202,60,31080,11,"""3""",31200,31260
6139,503202,500405,60,31080,11,"""3""",31260,31320
6139,500405,501301,120,31080,11,"""3""",31320,31440
6139,501301,502101,120,31080,11,"""3""",31440,31560
6139,502101,501001,60,31080,11,"""3""",31560,31620
6139,501001,502201,120,31080,11,"""3""",31620,31740
6139,502201,101001,240,31080,11,"""3""",31740,31980
6139,101001,118101,60,31080,11,"""3""",31980,32040
6139,118101,106001,60,31080,11,"""3""",32040,32100
6139,106001,118001,120,31080,11,"""3""",32100,32220
6139,118001,103004,180,31080,11,"""3""",32220,32400
6139,103004,112107,180,31080,11,"""3""",32400,32580
6139,112107,403102,60,31080,11,"""3""",32580,32640
6139,403102,402301,60,31080,11,"""3""",32640,32700
6139,402301,406602,120,31080,11,"""3""",32700,32820
6139,406602,402501,60,31080,11,"""3""",32820,32880
6139,402501,408004,120,31080,11,"""3""",32880,33000
6139,408004,406801,120,31080,11,"""3""",33000,33120
6139,406801,402401,120,31080,11,"""3""",33120,33240
6139,402401,403901,60,31080,11,"""3""",33240,33300
6139,403901,33606,60,31080,11,"""3""",33300,33360
6139,33606,407503,60,31080,11,"""3""",33360,33420
6139,407503,408900,60,31080,11,"""3""",33420,33480
6139,408900,400802,60,31080,11,"""3""",33480,33540
6139,400802,401303,120,31080,11,"""3""",33540,33660
6139,401303,26503,60,31080,11,"""3""",33660,33720
6139,26503,401502,120,31080,11,"""3""",33720,33840
6139,401502,401901,60,31080,11,"""3""",33840,33900
6139,401901,401401,60,31080,11,"""3""",33900,33960
6139,401401,403301,60,31080,11,"""3""",33960,34020
6139,403301,410202,120,31080,11,"""3""",34020,34140
6139,503302,503402,60,32280,11,"""3""",32280,32340
6139,503402,503501,60,32280,11,"""3""",32340,32400
6139,503501,503202,60,32280,11,"""3""",32400,32460
6139,503202,500405,60,32280,11,"""3""",32460,32520
6139,500405,501301,120,32280,11,"""3""",32520,32640
6139,501301,502101,120,32280,11,"""3""",32640,32760
6139,502101,501001,60,32280,11,"""3""",32760,32820
6139,501001,502201,120,32280,11,"""3""",32820,32940
6139,502201,101001,240,32280,11,"""3""",32940,33180
6139,101001,118101,60,32280,11,"""3""",33180,33240
6139,118101,106001,60,32280,11,"""3""",33240,33300
6139,106001,118001,120,32280,11,"""3""",33300,33420
6139,118001,103004,180,32280,11,"""3""",33420,33600
6139,103004,112107,180,32280,11,"""3""",33600,33780
6139,112107,403102,60,32280,11,"""3""",33780,33840
6139,403102,402301,60,32280,11,"""3""",33840,33900
6139,402301,406602,120,32280,11,"""3""",33900,34020
6139,406602,402501,60,32280,11,"""3""",34020,34080
6139,402501,408004,120,32280,11,"""3""",34080,34200
6139,408004,406801,120,32280,11,"""3""",34200,34320
6139,406801,402401,120,32280,11,"""3""",34320,34440
6139,402401,403901,60,32280,11,"""3""",34440,34500
6139,403901,33606,60,32280,11,"""3""",34500,34560
6139,33606,407503,60,32280,11,"""3""",34560,34620
6139,407503,408900,60,32280,11,"""3""",34620,34680
6139,408900,400802,60,32280,11,"""3""",34680,34740
6139,400802,401303,120,32280,11,"""3""",34740,34860
6139,401303,26503,60,32280,11,"""3""",34860,34920
6139,26503,401502,120,32280,11,"""3""",34920,35040
6139,401502,401901,60,32280,11,"""3""",35040,35100
6139,401901,401401,60,32280,11,"""3""",35100,35160
6139,401401,403301,60,32280,11,"""3""",35160,35220
6139,403301,410202,120,32280,11,"""3""",35220,35340
6139,503302,503402,60,33480,11,"""3""",33480,33540
6139,503402,503501,60,33480,11,"""3""",33540,33600
6139,503501,503202,60,33480,11,"""3""",33600,33660
6139,503202,500405,60,33480,11,"""3""",33660,33720
6139,500405,501301,120,33480,11,"""3""",33720,33840
6139,501301,502101,120,33480,11,"""3""",33840,33960
6139,502101,501001,60,33480,11,"""3""",33960,34020
6139,501001,502201,120,33480,11,"""3""",34020,34140
6139,502201,101001,240,33480,11,"""3""",34140,34380
6139,101001,118101,60,33480,11,"""3""",34380,34440
6139,118101,106001,60,33480,11,"""3""",34440,34500
6139,106001,118001,120,33480,11,"""3""",34500,34620
6139,118001,103004,180,33480,11,"""3""",34620,34800
6139,103004,112107,180,33480,11,"""3""",34800,34980
6139,112107,403102,60,33480,11,"""3""",34980,35040
6139,403102,402301,60,33480,11,"""3""",35040,35100
6139,402301,406602,120,33480,11,"""3""",35100,35220
6139,406602,402501,60,33480,11,"""3""",35220,35280
6139,402501,408004,120,33480,11,"""3""",35280,35400
6139,408004,406801,120,33480,11,"""3""",35400,35520
6139,406801,402401,120,33480,11,"""3""",35520,35640
6139,402401,403901,60,33480,11,"""3""",35640,35700
6139,403901,33606,60,33480,11,"""3""",35700,35760
6139,33606,407503,60,33480,11,"""3""",35760,35820
6139,407503,408900,60,33480,11,"""3""",35820,35880
6139,408900,400802,60,33480,11,"""3""",35880,35940
6139,400802,401303,120,33480,11,"""3""",35940,36060
6139,401303,26503,60,33480,11,"""3""",36060,36120
6139,26503,401502,120,33480,11,"""3""",36120,36240
6139,401502,401901,60,33480,11,"""3""",36240,36300
6139,401901,401401,60,33480,11,"""3""",36300,36360
6139,401401,403301,60,33480,11,"""3""",36360,36420
6139,403301,410202,120,33480,11,"""3""",36420,36540
6139,503302,503402,60,34680,11,"""3""",34680,34740
6139,503402,503501,60,34680,11,"""3""",34740,34800
6139,503501,503202,60,34680,11,"""3""",34800,34860
6139,503202,500405,60,34680,11,"""3""",34860,34920
6139,500405,501301,120,34680,11,"""3""",34920,35040
6139,501301,502101,120,34680,11,"""3""",35040,35160
6139,502101,501001,60,34680,11,"""3""",35160,35220
6139,501001,502201,120,34680,11,"""3""",35220,35340
6139,502201,101001,240,34680,11,"""3""",35340,35580
6139,101001,118101,60,34680,11,"""3""",35580,35640
6139,118101,106001,60,34680,11,"""3""",35640,35700
6139,106001,118001,120,34680,11,"""3""",35700,35820
6139,118001,103004,180,34680,11,"""3""",35820,36000
6139,103004,112107,180,34680,11,"""3""",36000,36180
6139,112107,403102,60,34680,11,"""3""",36180,36240
6139,403102,402301,60,34680,11,"""3""",36240,36300
6139,402301,406602,120,34680,11,"""3""",36300,36420
6139,406602,402501,60,34680,11,"""3""",36420,36480
6139,402501,408004,120,34680,11,"""3""",36480,36600
6139,408004,406801,120,34680,11,"""3""",36600,36720
6139,406801,402401,120,34680,11,"""3""",36720,36840
6139,402401,403901,60,34680,11,"""3""",36840,36900
6139,403901,33606,60,34680,11,"""3""",36900,36960
6139,33606,407503,60,34680,11,"""3""",36960,37020
6139,407503,408900,60,34680,11,"""3""",37020,37080
6139,408900,400802,60,34680,11,"""3""",37080,37140
6139,400802,401303,120,34680,11,"""3""",37140,37260
6139,401303,26503,60,34680,11,"""3""",37260,37320
6139,26503,401502,120,34680,11,"""3""",37320,37440
6139,401502,401901,60,34680,11,"""3""",37440,37500
6139,401901,401401,60,34680,11,"""3""",37500,37560
6139,401401,403301,60,34680,11,"""3""",37560,37620
6139,403301,410202,120,34680,11,"""3""",37620,37740
6139,503302,503402,60,35880,11,"""3""",35880,35940
6139,503402,503501,60,35880,11,"""3""",35940,36000
6139,503501,503202,60,35880,11,"""3""",36000,36060
6139,503202,500405,60,35880,11,"""3""",36060,36120
6139,500405,501301,120,35880,11,"""3""",36120,36240
6139,501301,502101,120,35880,11,"""3""",36240,36360
6139,502101,501001,60,35880,11,"""3""",36360,36420
6139,501001,502201,120,35880,11,"""3""",36420,36540
6139,502201,101001,240,35880,11,"""3""",36540,36780
6139,101001,118101,60,35880,11,"""3""",36780,36840
6139,118101,106001,60,35880,11,"""3""",36840,36900
6139,106001,118001,120,35880,11,"""3""",36900,37020
6139,118001,103004,180,35880,11,"""3""",37020,37200
6139,103004,112107,180,35880,11,"""3""",37200,37380
6139,112107,403102,60,35880,11,"""3""",37380,37440
6139,403102,402301,60,35880,11,"""3""",37440,37500
6139,402301,406602,120,35880,11,"""3""",37500,37620
6139,406602,402501,60,35880,11,"""3""",37620,37680
6139,402501,408004,120,35880,11,"""3""",37680,37800
6139,408004,406801,120,35880,11,"""3""",37800,37920
6139,406801,402401,120,35880,11,"""3""",37920,38040
6139,402401,403901,60,35880,11,"""3""",38040,38100
6139,403901,33606,60,35880,11,"""3""",38100,38160
6139,33606,407503,60,35880,11,"""3""",38160,38220
6139,407503,408900,60,35880,11,"""3""",38220,38280
6139,408900,400802,60,35880,11,"""3""",38280,38340
6139,400802,401303,120,35880,11,"""3""",38340,38460
6139,401303,26503,60,35880,11,"""3""",38460,38520
6139,26503,401502,120,35880,11,"""3""",38520,38640
6139,401502,401901,60,35880,11,"""3""",38640,38700
6139,401901,401401,60,35880,11,"""3""",38700,38760
6139,401401,403301,60,35880,11,"""3""",38760,38820
6139,403301,410202,120,35880,11,"""3""",38820,38940
6139,503302,503402,60,37080,11,"""3""",37080,37140
6139,503402,503501,60,37080,11,"""3""",37140,37200
6139,503501,503202,60,37080,11,"""3""",37200,37260
6139,503202,500405,60,37080,11,"""3""",37260,37320
6139,500405,501301,120,37080,11,"""3""",37320,37440
6139,501301,502101,120,37080,11,"""3""",37440,37560
6139,502101,501001,60,37080,11,"""3""",37560,37620
6139,501001,502201,120,37080,11,"""3""",37620,37740
6139,502201,101001,240,37080,11,"""3""",37740,37980
6139,101001,118101,60,37080,11,"""3""",37980,38040
6139,118101,106001,60,37080,11,"""3""",38040,38100
6139,106001,118001,120,37080,11,"""3""",38100,38220
6139,118001,103004,180,37080,11,"""3""",38220,38400
6139,103004,112107,180,37080,11,"""3""",38400,38580
6139,112107,403102,60,37080,11,"""3""",38580,38640
6139,403102,402301,60,37080,11,"""3""",38640,38700
6139,402301,406602,120,37080,11,"""3""",38700,38820
6139,406602,402501,60,37080,11,"""3""",38820,38880
6139,402501,408004,120,37080,11,"""3""",38880,39000
6139,408004,406801,120,37080,11,"""3""",39000,39120
6139,406801,402401,120,37080,11,"""3""",39120,39240
6139,402401,403901,60,37080,11,"""3""",39240,39300
6139,403901,33606,60,37080,11,"""3""",39300,39360
6139,33606,407503,60,37080,11,"""3""",39360,39420
6139,407503,408900,60,37080,11,"""3""",39420,39480
6139,408900,400802,60,37080,11,"""3""",39480,39540
6139,400802,401303,120,37080,11,"""3""",39540,39660
6139,401303,26503,60,37080,11,"""3""",39660,39720
6139,26503,401502,120,37080,11,"""3""",39720,39840
6139,401502,401901,60,37080,11,"""3""",39840,39900
6139,401901,401401,60,37080,11,"""3""",39900,39960
6139,401401,403301,60,37080,11,"""3""",39960,40020
6139,403301,410202,120,37080,11,"""3""",40020,40140
6139,503302,503402,60,38280,11,"""3""",38280,38340
6139,503402,503501,60,38280,11,"""3""",38340,38400
6139,503501,503202,60,38280,11,"""3""",38400,38460
6139,503202,500405,60,38280,11,"""3""",38460,38520
6139,500405,501301,120,38280,11,"""3""",38520,38640
6139,501301,502101,120,38280,11,"""3""",38640,38760
6139,502101,501001,60,38280,11,"""3""",38760,38820
6139,501001,502201,120,38280,11,"""3""",38820,38940
6139,502201,101001,240,38280,11,"""3""",38940,39180
6139,101001,118101,60,38280,11,"""3""",39180,39240
6139,118101,106001,60,38280,11,"""3""",39240,39300
6139,106001,118001,120,38280,11,"""3""",39300,39420
6139,118001,103004,180,38280,11,"""3""",39420,39600
6139,103004,112107,180,38280,11,"""3""",39600,39780
6139,112107,403102,60,38280,11,"""3""",39780,39840
6139,403102,402301,60,38280,11,"""3""",39840,39900
6139,402301,406602,120,38280,11,"""3""",39900,40020
6139,406602,402501,60,38280,11,"""3""",40020,40080
6139,402501,408004,120,38280,11,"""3""",40080,40200
6139,408004,406801,120,38280,11,"""3""",40200,40320
6139,406801,402401,120,38280,11,"""3""",40320,40440
6139,402401,403901,60,38280,11,"""3""",40440,40500
6139,403901,33606,60,38280,11,"""3""",40500,40560
6139,33606,407503,60,38280,11,"""3""",40560,40620
6139,407503,408900,60,38280,11,"""3""",40620,40680
6139,408900,400802,60,38280,11,"""3""",40680,40740
6139,400802,401303,120,38280,11,"""3""",40740,40860
6139,401303,26503,60,38280,11,"""3""",40860,40920
6139,26503,401502,120,38280,11,"""3""",40920,41040
6139,401502,401901,60,38280,11,"""3""",41040,41100
6139,401901,401401,60,38280,11,"""3""",41100,41160
6139,401401,403301,60,38280,11,"""3""",41160,41220
6139,403301,410202,120,38280,11,"""3""",41220,41340
6139,503302,503402,60,39480,11,"""3""",39480,39540
6139,503402,503501,60,39480,11,"""3""",39540,39600
6139,503501,503202,60,39480,11,"""3""",39600,39660
6139,503202,500405,60,39480,11,"""3""",39660,39720
6139,500405,501301,120,39480,11,"""3""",39720,39840
6139,501301,502101,120,39480,11,"""3""",39840,39960
6139,502101,501001,60,39480,11,"""3""",39960,40020
6139,501001,502201,120,39480,11,"""3""",40020,40140
6139,502201,101001,240,39480,11,"""3""",40140,40380
6139,101001,118101,60,39480,11,"""3""",40380,40440
6139,118101,106001,60,39480,11,"""3""",40440,40500
6139,106001,118001,120,39480,11,"""3""",40500,40620
6139,118001,103004,180,39480,11,"""3""",40620,40800
6139,103004,112107,180,39480,11,"""3""",40800,40980
6139,112107,403102,60,39480,11,"""3""",40980,41040
6139,403102,402301,60,39480,11,"""3""",41040,41100
6139,402301,406602,120,39480,11,"""3""",41100,41220
6139,406602,402501,60,39480,11,"""3""",41220,41280
6139,402501,408004,120,39480,11,"""3""",41280,41400
6139,408004,406801,120,39480,11,"""3""",41400,41520
6139,406801,402401,120,39480,11,"""3""",41520,41640
6139,402401,403901,60,39480,11,"""3""",41640,41700
6139,403901,33606,60,39480,11,"""3""",41700,41760
6139,33606,407503,60,39480,11,"""3""",41760,41820
6139,407503,408900,60,39480,11,"""3""",41820,41880
6139,408900,400802,60,39480,11,"""3""",41880,41940
6139,400802,401303,120,39480,11,"""3""",41940,42060
6139,401303,26503,60,39480,11,"""3""",42060,42120
6139,26503,401502,120,39480,11,"""3""",42120,42240
6139,401502,401901,60,39480,11,"""3""",42240,42300
6139,401901,401401,60,39480,11,"""3""",42300,42360
6139,401401,403301,60,39480,11,"""3""",42360,42420
6139,403301,410202,120,39480,11,"""3""",42420,42540
6139,503302,503402,60,40680,11,"""3""",40680,40740
6139,503402,503501,60,40680,11,"""3""",40740,40800
6139,503501,503202,60,40680,11,"""3""",40800,40860
6139,503202,500405,60,40680,11,"""3""",40860,40920
6139,500405,501301,120,40680,11,"""3""",40920,41040
6139,501301,502101,120,40680,11,"""3""",41040,41160
6139,502101,501001,60,40680,11,"""3""",41160,41220
6139,501001,502201,120,40680,11,"""3""",41220,41340
6139,502201,101001,240,40680,11,"""3""",41340,41580
6139,101001,118101,60,40680,11,"""3""",41580,41640
6139,118101,106001,60,40680,11,"""3""",41640,41700
6139,106001,118001,120,40680,11,"""3""",41700,41820
6139,118001,103004,180,40680,11,"""3""",41820,42000
6139,103004,112107,180,40680,11,"""3""",42000,42180
6139,112107,403102,60,40680,11,"""3""",42180,42240
6139,403102,402301,60,40680,11,"""3""",42240,42300
6139,402301,406602,120,40680,11,"""3""",42300,42420
6139,406602,402501,60,40680,11,"""3""",42420,42480
6139,402501,408004,120,40680,11,"""3""",42480,42600
6139,408004,406801,120,40680,11,"""3""",42600,42720
6139,406801,402401,120,40680,11,"""3""",42720,42840
6139,402401,403901,60,40680,11,"""3""",42840,42900
6139,403901,33606,60,40680,11,"""3""",42900,42960
6139,33606,407503,60,40680,11,"""3""",42960,43020
6139,407503,408900,60,40680,11,"""3""",43020,43080
6139,408900,400802,60,40680,11,"""3""",43080,43140
6139,400802,401303,120,40680,11,"""3""",43140,43260
6139,401303,26503,60,40680,11,"""3""",43260,43320
6139,26503,401502,120,40680,11,"""3""",43320,43440
6139,401502,401901,60,40680,11,"""3""",43440,43500
6139,401901,401401,60,40680,11,"""3""",43500,43560
6139,401401,403301,60,40680,11,"""3""",43560,43620
6139,403301,410202,120,40680,11,"""3""",43620,43740
6139,503302,503402,60,41880,11,"""3""",41880,41940
6139,503402,503501,60,41880,11,"""3""",41940,42000
6139,503501,503202,60,41880,11,"""3""",42000,42060
6139,503202,500405,60,41880,11,"""3""",42060,42120
6139,500405,501301,120,41880,11,"""3""",42120,42240
6139,501301,502101,120,41880,11,"""3""",42240,42360
6139,502101,501001,60,41880,11,"""3""",42360,42420
6139,501001,502201,120,41880,11,"""3""",42420,42540
6139,502201,101001,240,41880,11,"""3""",42540,42780
6139,101001,118101,60,41880,11,"""3""",42780,42840
6139,118101,106001,60,41880,11,"""3""",42840,42900
6139,106001,118001,120,41880,11,"""3""",42900,43020
6139,118001,103004,180,41880,11,"""3""",43020,43200
6139,103004,112107,180,41880,11,"""3""",43200,43380
6139,112107,403102,60,41880,11,"""3""",43380,43440
6139,403102,402301,60,41880,11,"""3""",43440,43500
6139,402301,406602,120,41880,11,"""3""",43500,43620
6139,406602,402501,60,41880,11,"""3""",43620,43680
6139,402501,408004,120,41880,11,"""3""",43680,43800
6139,408004,406801,120,41880,11,"""3""",43800,43920
6139,406801,402401,120,41880,11,"""3""",43920,44040
6139,402401,403901,60,41880,11,"""3""",44040,44100
6139,403901,33606,60,41880,11,"""3""",44100,44160
6139,33606,407503,60,41880,11,"""3""",44160,44220
6139,407503,408900,60,41880,11,"""3""",44220,44280
6139,408900,400802,60,41880,11,"""3""",44280,44340
6139,400802,401303,120,41880,11,"""3""",44340,44460
6139,401303,26503,60,41880,11,"""3""",44460,44520
6139,26503,401502,120,41880,11,"""3""",44520,44640
6139,401502,401901,60,41880,11,"""3""",44640,44700
6139,401901,401401,60,41880,11,"""3""",44700,44760
6139,401401,403301,60,41880,11,"""3""",44760,44820
6139,403301,410202,120,41880,11,"""3""",44820,44940
6139,503302,503402,60,43080,11,"""3""",43080,43140
6139,503402,503501,60,43080,11,"""3""",43140,43200
6139,503501,503202,60,43080,11,"""3""",43200,43260
6139,503202,500405,60,43080,11,"""3""",43260,43320
6139,500405,501301,120,43080,11,"""3""",43320,43440
6139,501301,502101,120,43080,11,"""3""",43440,43560
6139,502101,501001,60,43080,11,"""3""",43560,43620
6139,501001,502201,120,43080,11,"""3""",43620,43740
6139,502201,101001,240,43080,11,"""3""",43740,43980
6139,101001,118101,60,43080,11,"""3""",43980,44040
6139,118101,106001,60,43080,11,"""3""",44040,44100
6139,106001,118001,120,43080,11,"""3""",44100,44220
6139,118001,103004,180,43080,11,"""3""",44220,44400
6139,103004,112107,180,43080,11,"""3""",44400,44580
6139,112107,403102,60,43080,11,"""3""",44580,44640
6139,403102,402301,60,43080,11,"""3""",44640,44700
6139,402301,406602,120,43080,11,"""3""",44700,44820
6139,406602,402501,60,43080,11,"""3""",44820,44880
6139,402501,408004,120,43080,11,"""3""",44880,45000
6139,408004,406801,120,43080,11,"""3""",45000,45120
6139,406801,402401,120,43080,11,"""3""",45120,45240
6139,402401,403901,60,43080,11,"""3""",45240,45300
6139,403901,33606,60,43080,11,"""3""",45300,45360
6139,33606,407503,60,43080,11,"""3""",45360,45420
6139,407503,408900,60,43080,11,"""3""",45420,45480
6139,408900,400802,60,43080,11,"""3""",45480,45540
6139,400802,401303,120,43080,11,"""3""",45540,45660
6139,401303,26503,60,43080,11,"""3""",45660,45720
6139,26503,401502,120,43080,11,"""3""",45720,45840
6139,401502,401901,60,43080,11,"""3""",45840,45900
6139,401901,401401,60,43080,11,"""3""",45900,45960
6139,401401,403301,60,43080,11,"""3""",45960,46020
6139,403301,410202,120,43080,11,"""3""",46020,46140
6139,503302,503402,60,44280,11,"""3""",44280,44340
6139,503402,503501,60,44280,11,"""3""",44340,44400
6139,503501,503202,60,44280,11,"""3""",44400,44460
6139,503202,500405,60,44280,11,"""3""",44460,44520
6139,500405,501301,120,44280,11,"""3""",44520,44640
6139,501301,502101,120,44280,11,"""3""",44640,44760
6139,502101,501001,60,44280,11,"""3""",44760,44820
6139,501001,502201,120,44280,11,"""3""",44820,44940
6139,502201,101001,240,44280,11,"""3""",44940,45180
6139,101001,118101,60,44280,11,"""3""",45180,45240
6139,118101,106001,60,44280,11,"""3""",45240,45300
6139,106001,118001,120,44280,11,"""3""",45300,45420
6139,118001,103004,180,44280,11,"""3""",45420,45600
6139,103004,112107,180,44280,11,"""3""",45600,45780
6139,112107,403102,60,44280,11,"""3""",45780,45840
6139,403102,402301,60,44280,11,"""3""",45840,45900
6139,402301,406602,120,44280,11,"""3""",45900,46020
6139,406602,402501,60,44280,11,"""3""",46020,46080
6139,402501,408004,120,44280,11,"""3""",46080,46200
6139,408004,406801,120,44280,11,"""3""",46200,46320
6139,406801,402401,120,44280,11,"""3""",46320,46440
6139,402401,403901,60,44280,11,"""3""",46440,46500
6139,403901,33606,60,44280,11,"""3""",46500,46560
6139,33606,407503,60,44280,11,"""3""",46560,46620
6139,407503,408900,60,44280,11,"""3""",46620,46680
6139,408900,400802,60,44280,11,"""3""",46680,46740
6139,400802,401303,120,44280,11,"""3""",46740,46860
6139,401303,26503,60,44280,11,"""3""",46860,46920
6139,26503,401502,120,44280,11,"""3""",46920,47040
6139,401502,401901,60,44280,11,"""3""",47040,47100
6139,401901,401401,60,44280,11,"""3""",47100,47160
6139,401401,403301,60,44280,11,"""3""",47160,47220
6139,403301,410202,120,44280,11,"""3""",47220,47340
6139,503302,503402,60,45480,11,"""3""",45480,45540
6139,503402,503501,60,45480,11,"""3""",45540,45600
6139,503501,503202,60,45480,11,"""3""",45600,45660
6139,503202,500405,60,45480,11,"""3""",45660,45720
6139,500405,501301,120,45480,11,"""3""",45720,45840
6139,501301,502101,120,45480,11,"""3""",45840,45960
6139,502101,501001,60,45480,11,"""3""",45960,46020
6139,501001,502201,120,45480,11,"""3""",46020,46140
6139,502201,101001,240,45480,11,"""3""",46140,46380
6139,101001,118101,60,45480,11,"""3""",46380,46440
6139,118101,106001,60,45480,11,"""3""",46440,46500
6139,106001,118001,120,45480,11,"""3""",46500,46620
6139,118001,103004,180,45480,11,"""3""",46620,46800
6139,103004,112107,180,45480,11,"""3""",46800,46980
6139,112107,403102,60,45480,11,"""3""",46980,47040
6139,403102,402301,60,45480,11,"""3""",47040,47100
6139,402301,406602,120,45480,11,"""3""",47100,47220
6139,406602,402501,60,45480,11,"""3""",47220,47280
6139,402501,408004,120,45480,11,"""3""",47280,47400
6139,408004,406801,120,45480,11,"""3""",47400,47520
6139,406801,402401,120,45480,11,"""3""",47520,47640
6139,402401,403901,60,45480,11,"""3""",47640,47700
6139,403901,33606,60,45480,11,"""3""",47700,47760
6139,33606,407503,60,45480,11,"""3""",47760,47820
6139,407503,408900,60,45480,11,"""3""",47820,47880
6139,408900,400802,60,45480,11,"""3""",47880,47940
6139,400802,401303,120,45480,11,"""3""",47940,48060
6139,401303,26503,60,45480,11,"""3""",48060,48120
6139,26503,401502,120,45480,11,"""3""",48120,48240
6139,401502,401901,60,45480,11,"""3""",48240,48300
6139,401901,401401,60,45480,11,"""3""",48300,48360
6139,401401,403301,60,45480,11,"""3""",48360,48420
6139,403301,410202,120,45480,11,"""3""",48420,48540
6139,503302,503402,60,46680,11,"""3""",46680,46740
6139,503402,503501,60,46680,11,"""3""",46740,46800
6139,503501,503202,60,46680,11,"""3""",46800,46860
6139,503202,500405,60,46680,11,"""3""",46860,46920
6139,500405,501301,120,46680,11,"""3""",46920,47040
6139,501301,502101,120,46680,11,"""3""",47040,47160
6139,502101,501001,60,46680,11,"""3""",47160,47220
6139,501001,502201,120,46680,11,"""3""",47220,47340
6139,502201,101001,240,46680,11,"""3""",47340,47580
6139,101001,118101,60,46680,11,"""3""",47580,47640
6139,118101,106001,60,46680,11,"""3""",47640,47700
6139,106001,118001,120,46680,11,"""3""",47700,47820
6139,118001,103004,180,46680,11,"""3""",47820,48000
6139,103004,112107,180,46680,11,"""3""",48000,48180
6139,112107,403102,60,46680,11,"""3""",48180,48240
6139,403102,402301,60,46680,11,"""3""",48240,48300
6139,402301,406602,120,46680,11,"""3""",48300,48420
6139,406602,402501,60,46680,11,"""3""",48420,48480
6139,402501,408004,120,46680,11,"""3""",48480,48600
6139,408004,406801,120,46680,11,"""3""",48600,48720
6139,406801,402401,120,46680,11,"""3""",48720,48840
6139,402401,403901,60,46680,11,"""3""",48840,48900
6139,403901,33606,60,46680,11,"""3""",48900,48960
6139,33606,407503,60,46680,11,"""3""",48960,49020
6139,407503,408900,60,46680,11,"""3""",49020,49080
6139,408900,400802,60,46680,11,"""3""",49080,49140
6139,400802,401303,120,46680,11,"""3""",49140,49260
6139,401303,26503,60,46680,11,"""3""",49260,49320
6139,26503,401502,120,46680,11,"""3""",49320,49440
6139,401502,401901,60,46680,11,"""3""",49440,49500
6139,401901,401401,60,46680,11,"""3""",49500,49560
6139,401401,403301,60,46680,11,"""3""",49560,49620
6139,403301,410202,120,46680,11,"""3""",49620,49740
6139,503302,503402,60,47880,11,"""3""",47880,47940
6139,503402,503501,60,47880,11,"""3""",47940,48000
6139,503501,503202,60,47880,11,"""3""",48000,48060
6139,503202,500405,60,47880,11,"""3""",48060,48120
6139,500405,501301,120,47880,11,"""3""",48120,48240
6139,501301,502101,120,47880,11,"""3""",48240,48360
6139,502101,501001,60,47880,11,"""3""",48360,48420
6139,501001,502201,120,47880,11,"""3""",48420,48540
6139,502201,101001,240,47880,11,"""3""",48540,48780
6139,101001,118101,60,47880,11,"""3""",48780,48840
6139,118101,106001,60,47880,11,"""3""",48840,48900
6139,106001,118001,120,47880,11,"""3""",48900,49020
6139,118001,103004,180,47880,11,"""3""",49020,49200
6139,103004,112107,180,47880,11,"""3""",49200,49380
6139,112107,403102,60,47880,11,"""3""",49380,49440
6139,403102,402301,60,47880,11,"""3""",49440,49500
6139,402301,406602,120,47880,11,"""3""",49500,49620
6139,406602,402501,60,47880,11,"""3""",49620,49680
6139,402501,408004,120,47880,11,"""3""",49680,49800
6139,408004,406801,120,47880,11,"""3""",49800,49920
6139,406801,402401,120,47880,11,"""3""",49920,50040
6139,402401,403901,60,47880,11,"""3""",50040,50100
6139,403901,33606,60,47880,11,"""3""",50100,50160
6139,33606,407503,60,47880,11,"""3""",50160,50220
6139,407503,408900,60,47880,11,"""3""",50220,50280
6139,408900,400802,60,47880,11,"""3""",50280,50340
6139,400802,401303,120,47880,11,"""3""",50340,50460
6139,401303,26503,60,47880,11,"""3""",50460,50520
6139,26503,401502,120,47880,11,"""3""",50520,50640
6139,401502,401901,60,47880,11,"""3""",50640,50700
6139,401901,401401,60,47880,11,"""3""",50700,50760
6139,401401,403301,60,47880,11,"""3""",50760,50820
6139,403301,410202,120,47880,11,"""3""",50820,50940
6139,503302,503402,60,49080,11,"""3""",49080,49140
6139,503402,503501,60,49080,11,"""3""",49140,49200
6139,503501,503202,60,49080,11,"""3""",49200,49260
6139,503202,500405,60,49080,11,"""3""",49260,49320
6139,500405,501301,120,49080,11,"""3""",49320,49440
6139,501301,502101,120,49080,11,"""3""",49440,49560
6139,502101,501001,60,49080,11,"""3""",49560,49620
6139,501001,502201,120,49080,11,"""3""",49620,49740
6139,502201,101001,240,49080,11,"""3""",49740,49980
6139,101001,118101,60,49080,11,"""3""",49980,50040
6139,118101,106001,60,49080,11,"""3""",50040,50100
6139,106001,118001,120,49080,11,"""3""",50100,50220
6139,118001,103004,180,49080,11,"""3""",50220,50400
6139,103004,112107,180,49080,11,"""3""",50400,50580
6139,112107,403102,60,49080,11,"""3""",50580,50640
6139,403102,402301,60,49080,11,"""3""",50640,50700
6139,402301,406602,120,49080,11,"""3""",50700,50820
6139,406602,402501,60,49080,11,"""3""",50820,50880
6139,402501,408004,120,49080,11,"""3""",50880,51000
6139,408004,406801,120,49080,11,"""3""",51000,51120
6139,406801,402401,120,49080,11,"""3""",51120,51240
6139,402401,403901,60,49080,11,"""3""",51240,51300
6139,403901,33606,60,49080,11,"""3""",51300,51360
6139,33606,407503,60,49080,11,"""3""",51360,51420
6139,407503,408900,60,49080,11,"""3""",51420,51480
6139,408900,400802,60,49080,11,"""3""",51480,51540
6139,400802,401303,120,49080,11,"""3""",51540,51660
6139,401303,26503,60,49080,11,"""3""",51660,51720
6139,26503,401502,120,49080,11,"""3""",51720,51840
6139,401502,401901,60,49080,11,"""3""",51840,51900
6139,401901,401401,60,49080,11,"""3""",51900,51960
6139,401401,403301,60,49080,11,"""3""",51960,52020
6139,403301,410202,120,49080,11,"""3""",52020,52140
6139,503302,503402,60,50280,11,"""3""",50280,50340
6139,503402,503501,60,50280,11,"""3""",50340,50400
6139,503501,503202,60,50280,11,"""3""",50400,50460
6139,503202,500405,60,50280,11,"""3""",50460,50520
6139,500405,501301,120,50280,11,"""3""",50520,50640
6139,501301,502101,120,50280,11,"""3""",50640,50760
6139,502101,501001,60,50280,11,"""3""",50760,50820
6139,501001,502201,120,50280,11,"""3""",50820,50940
6139,502201,101001,240,50280,11,"""3""",50940,51180
6139,101001,118101,60,50280,11,"""3""",51180,51240
6139,118101,106001,60,50280,11,"""3""",51240,51300
6139,106001,118001,120,50280,11,"""3""",51300,51420
6139,118001,103004,180,50280,11,"""3""",51420,51600
6139,103004,112107,180,50280,11,"""3""",51600,51780
6139,112107,403102,60,50280,11,"""3""",51780,51840
6139,403102,402301,60,50280,11,"""3""",51840,51900
6139,402301,406602,120,50280,11,"""3""",51900,52020
6139,406602,402501,60,50280,11,"""3""",52020,52080
6139,402501,408004,120,50280,11,"""3""",52080,52200
6139,408004,406801,120,50280,11,"""3""",52200,52320
6139,406801,402401,120,50280,11,"""3""",52320,52440
6139,402401,403901,60,50280,11,"""3""",52440,52500
6139,403901,33606,60,50280,11,"""3""",52500,52560
6139,33606,407503,60,50280,11,"""3""",52560,52620
6139,407503,408900,60,50280,11,"""3""",52620,52680
6139,408900,400802,60,50280,11,"""3""",52680,52740
6139,400802,401303,120,50280,11,"""3""",52740,52860
6139,401303,26503,60,50280,11,"""3""",52860,52920
6139,26503,401502,120,50280,11,"""3""",52920,53040
6139,401502,401901,60,50280,11,"""3""",53040,53100
6139,401901,401401,60,50280,11,"""3""",53100,53160
6139,401401,403301,60,50280,11,"""3""",53160,53220
6139,403301,410202,120,50280,11,"""3""",53220,53340
6139,503302,503402,60,51480,11,"""3""",51480,51540
6139,503402,503501,60,51480,11,"""3""",51540,51600
6139,503501,503202,60,51480,11,"""3""",51600,51660
6139,503202,500405,60,51480,11,"""3""",51660,51720
6139,500405,501301,120,51480,11,"""3""",51720,51840
6139,501301,502101,120,51480,11,"""3""",51840,51960
6139,502101,501001,60,51480,11,"""3""",51960,52020
6139,501001,502201,120,51480,11,"""3""",52020,52140
6139,502201,101001,240,51480,11,"""3""",52140,52380
6139,101001,118101,60,51480,11,"""3""",52380,52440
6139,118101,106001,60,51480,11,"""3""",52440,52500
6139,106001,118001,120,51480,11,"""3""",52500,52620
6139,118001,103004,180,51480,11,"""3""",52620,52800
6139,103004,112107,180,51480,11,"""3""",52800,52980
6139,112107,403102,60,51480,11,"""3""",52980,53040
6139,403102,402301,60,51480,11,"""3""",53040,53100
6139,402301,406602,120,51480,11,"""3""",53100,53220
6139,406602,402501,60,51480,11,"""3""",53220,53280
6139,402501,408004,120,51480,11,"""3""",53280,53400
6139,408004,406801,120,51480,11,"""3""",53400,53520
6139,406801,402401,120,51480,11,"""3""",53520,53640
6139,402401,403901,60,51480,11,"""3""",53640,53700
6139,403901,33606,60,51480,11,"""3""",53700,53760
6139,33606,407503,60,51480,11,"""3""",53760,53820
6139,407503,408900,60,51480,11,"""3""",53820,53880
6139,408900,400802,60,51480,11,"""3""",53880,53940
6139,400802,401303,120,51480,11,"""3""",53940,54060
6139,401303,26503,60,51480,11,"""3""",54060,54120
6139,26503,401502,120,51480,11,"""3""",54120,54240
6139,401502,401901,60,51480,11,"""3""",54240,54300
6139,401901,401401,60,51480,11,"""3""",54300,54360
6139,401401,403301,60,51480,11,"""3""",54360,54420
6139,403301,410202,120,51480,11,"""3""",54420,54540
6139,503302,503402,60,52680,11,"""3""",52680,52740
6139,503402,503501,60,52680,11,"""3""",52740,52800
6139,503501,503202,60,52680,11,"""3""",52800,52860
6139,503202,500405,60,52680,11,"""3""",52860,52920
6139,500405,501301,120,52680,11,"""3""",52920,53040
6139,501301,502101,120,52680,11,"""3""",53040,53160
6139,502101,501001,60,52680,11,"""3""",53160,53220
6139,501001,502201,120,52680,11,"""3""",53220,53340
6139,502201,101001,240,52680,11,"""3""",53340,53580
6139,101001,118101,60,52680,11,"""3""",53580,53640
6139,118101,106001,60,52680,11,"""3""",53640,53700
6139,106001,118001,120,52680,11,"""3""",53700,53820
6139,118001,103004,180,52680,11,"""3""",53820,54000
6139,103004,112107,180,52680,11,"""3""",54000,54180
6139,112107,403102,60,52680,11,"""3""",54180,54240
6139,403102,402301,60,52680,11,"""3""",54240,54300
6139,402301,406602,120,52680,11,"""3""",54300,54420
6139,406602,402501,60,52680,11,"""3""",54420,54480
6139,402501,408004,120,52680,11,"""3""",54480,54600
6139,408004,406801,120,52680,11,"""3""",54600,54720
6139,406801,402401,120,52680,11,"""3""",54720,54840
6139,402401,403901,60,52680,11,"""3""",54840,54900
6139,403901,33606,60,52680,11,"""3""",54900,54960
6139,33606,407503,60,52680,11,"""3""",54960,55020
6139,407503,408900,60,52680,11,"""3""",55020,55080
6139,408900,400802,60,52680,11,"""3""",55080,55140
6139,400802,401303,120,52680,11,"""3""",55140,55260
6139,401303,26503,60,52680,11,"""3""",55260,55320
6139,26503,401502,120,52680,11,"""3""",55320,55440
6139,401502,401901,60,52680,11,"""3""",55440,55500
6139,401901,401401,60,52680,11,"""3""",55500,55560
6139,401401,403301,60,52680,11,"""3""",55560,55620
6139,403301,410202,120,52680,11,"""3""",55620,55740
6139,503302,503402,60,53880,11,"""3""",53880,53940
6139,503402,503501,60,53880,11,"""3""",53940,54000
6139,503501,503202,60,53880,11,"""3""",54000,54060
6139,503202,500405,60,53880,11,"""3""",54060,54120
6139,500405,501301,120,53880,11,"""3""",54120,54240
6139,501301,502101,120,53880,11,"""3""",54240,54360
6139,502101,501001,60,53880,11,"""3""",54360,54420
6139,501001,502201,120,53880,11,"""3""",54420,54540
6139,502201,101001,240,53880,11,"""3""",54540,54780
6139,101001,118101,60,53880,11,"""3""",54780,54840
6139,118101,106001,60,53880,11,"""3""",54840,54900
6139,106001,118001,120,53880,11,"""3""",54900,55020
6139,118001,103004,180,53880,11,"""3""",55020,55200
6139,103004,112107,180,53880,11,"""3""",55200,55380
6139,112107,403102,60,53880,11,"""3""",55380,55440
6139,403102,402301,60,53880,11,"""3""",55440,55500
6139,402301,406602,120,53880,11,"""3""",55500,55620
6139,406602,402501,60,53880,11,"""3""",55620,55680
6139,402501,408004,120,53880,11,"""3""",55680,55800
6139,408004,406801,120,53880,11,"""3""",55800,55920
6139,406801,402401,120,53880,11,"""3""",55920,56040
6139,402401,403901,60,53880,11,"""3""",56040,56100
6139,403901,33606,60,53880,11,"""3""",56100,56160
6139,33606,407503,60,53880,11,"""3""",56160,56220
6139,407503,408900,60,53880,11,"""3""",56220,56280
6139,408900,400802,60,53880,11,"""3""",56280,56340
6139,400802,401303,120,53880,11,"""3""",56340,56460
6139,401303,26503,60,53880,11,"""3""",56460,56520
6139,26503,401502,120,53880,11,"""3""",56520,56640
6139,401502,401901,60,53880,11,"""3""",56640,56700
6139,401901,401401,60,53880,11,"""3""",56700,56760
6139,401401,403301,60,53880,11,"""3""",56760,56820
6139,403301,410202,120,53880,11,"""3""",56820,56940
6139,503302,503402,60,55080,11,"""3""",55080,55140
6139,503402,503501,60,55080,11,"""3""",55140,55200
6139,503501,503202,60,55080,11,"""3""",55200,55260
6139,503202,500405,60,55080,11,"""3""",55260,55320
6139,500405,501301,120,55080,11,"""3""",55320,55440
6139,501301,502101,120,55080,11,"""3""",55440,55560
6139,502101,501001,60,55080,11,"""3""",55560,55620
6139,501001,502201,120,55080,11,"""3""",55620,55740
6139,502201,101001,240,55080,11,"""3""",55740,55980
6139,101001,118101,60,55080,11,"""3""",55980,56040
6139,118101,106001,60,55080,11,"""3""",56040,56100
6139,106001,118001,120,55080,11,"""3""",56100,56220
6139,118001,103004,180,55080,11,"""3""",56220,56400
6139,103004,112107,180,55080,11,"""3""",56400,56580
6139,112107,403102,60,55080,11,"""3""",56580,56640
6139,403102,402301,60,55080,11,"""3""",56640,56700
6139,402301,406602,120,55080,11,"""3""",56700,56820
6139,406602,402501,60,55080,11,"""3""",56820,56880
6139,402501,408004,120,55080,11,"""3""",56880,57000
6139,408004,406801,120,55080,11,"""3""",57000,57120
6139,406801,402401,120,55080,11,"""3""",57120,57240
6139,402401,403901,60,55080,11,"""3""",57240,57300
6139,403901,33606,60,55080,11,"""3""",57300,57360
6139,33606,407503,60,55080,11,"""3""",57360,57420
6139,407503,408900,60,55080,11,"""3""",57420,57480
6139,408900,400802,60,55080,11,"""3""",57480,57540
6139,400802,401303,120,55080,11,"""3""",57540,57660
6139,401303,26503,60,55080,11,"""3""",57660,57720
6139,26503,401502,120,55080,11,"""3""",57720,57840
6139,401502,401901,60,55080,11,"""3""",57840,57900
6139,401901,401401,60,55080,11,"""3""",57900,57960
6139,401401,403301,60,55080,11,"""3""",57960,58020
6139,403301,410202,120,55080,11,"""3""",58020,58140
6139,503302,503402,60,56280,11,"""3""",56280,56340
6139,503402,503501,60,56280,11,"""3""",56340,56400
6139,503501,503202,60,56280,11,"""3""",56400,56460
6139,503202,500405,60,56280,11,"""3""",56460,56520
6139,500405,501301,120,56280,11,"""3""",56520,56640
6139,501301,502101,120,56280,11,"""3""",56640,56760
6139,502101,501001,60,56280,11,"""3""",56760,56820
6139,501001,502201,120,56280,11,"""3""",56820,56940
6139,502201,101001,240,56280,11,"""3""",56940,57180
6139,101001,118101,60,56280,11,"""3""",57180,57240
6139,118101,106001,60,56280,11,"""3""",57240,57300
6139,106001,118001,120,56280,11,"""3""",57300,57420
6139,118001,103004,180,56280,11,"""3""",57420,57600
6139,103004,112107,180,56280,11,"""3""",57600,57780
6139,112107,403102,60,56280,11,"""3""",57780,57840
6139,403102,402301,60,56280,11,"""3""",57840,57900
6139,402301,406602,120,56280,11,"""3""",57900,58020
6139,406602,402501,60,56280,11,"""3""",58020,58080
6139,402501,408004,120,56280,11,"""3""",58080,58200
6139,408004,406801,120,56280,11,"""3""",58200,58320
6139,406801,402401,120,56280,11,"""3""",58320,58440
6139,402401,403901,60,56280,11,"""3""",58440,58500
6139,403901,33606,60,56280,11,"""3""",58500,58560
6139,33606,407503,60,56280,11,"""3""",58560,58620
6139,407503,408900,60,56280,11,"""3""",58620,58680
6139,408900,400802,60,56280,11,"""3""",58680,58740
6139,400802,401303,120,56280,11,"""3""",58740,58860
6139,401303,26503,60,56280,11,"""3""",58860,58920
6139,26503,401502,120,56280,11,"""3""",58920,59040
6139,401502,401901,60,56280,11,"""3""",59040,59100
6139,401901,401401,60,56280,11,"""3""",59100,59160
6139,401401,403301,60,56280,11,"""3""",59160,59220
6139,403301,410202,120,56280,11,"""3""",59220,59340
6139,503302,503402,60,57480,11,"""3""",57480,57540
6139,503402,503501,60,57480,11,"""3""",57540,57600
6139,503501,503202,60,57480,11,"""3""",57600,57660
6139,503202,500405,60,57480,11,"""3""",57660,57720
6139,500405,501301,120,57480,11,"""3""",57720,57840
6139,501301,502101,120,57480,11,"""3""",57840,57960
6139,502101,501001,60,57480,11,"""3""",57960,58020
6139,501001,502201,120,57480,11,"""3""",58020,58140
6139,502201,101001,240,57480,11,"""3""",58140,58380
6139,101001,118101,60,57480,11,"""3""",58380,58440
6139,118101,106001,60,57480,11,"""3""",58440,58500
6139,106001,118001,120,57480,11,"""3""",58500,58620
6139,118001,103004,180,57480,11,"""3""",58620,58800
6139,103004,112107,180,57480,11,"""3""",58800,58980
6139,112107,403102,60,57480,11,"""3""",58980,59040
6139,403102,402301,60,57480,11,"""3""",59040,59100
6139,402301,406602,120,57480,11,"""3""",59100,59220
6139,406602,402501,60,57480,11,"""3""",59220,59280
6139,402501,408004,120,57480,11,"""3""",59280,59400
6139,408004,406801,120,57480,11,"""3""",59400,59520
6139,406801,402401,120,57480,11,"""3""",59520,59640
6139,402401,403901,60,57480,11,"""3""",59640,59700
6139,403901,33606,60,57480,11,"""3""",59700,59760
6139,33606,407503,60,57480,11,"""3""",59760,59820
6139,407503,408900,60,57480,11,"""3""",59820,59880
6139,408900,400802,60,57480,11,"""3""",59880,59940
6139,400802,401303,120,57480,11,"""3""",59940,60060
6139,401303,26503,60,57480,11,"""3""",60060,60120
6139,26503,401502,120,57480,11,"""3""",60120,60240
6139,401502,401901,60,57480,11,"""3""",60240,60300
6139,401901,401401,60,57480,11,"""3""",60300,60360
6139,401401,403301,60,57480,11,"""3""",60360,60420
6139,403301,410202,120,57480,11,"""3""",60420,60540
6139,503302,503402,60,58680,11,"""3""",58680,58740
6139,503402,503501,60,58680,11,"""3""",58740,58800
6139,503501,503202,60,58680,11,"""3""",58800,58860
6139,503202,500405,60,58680,11,"""3""",58860,58920
6139,500405,501301,120,58680,11,"""3""",58920,59040
6139,501301,502101,120,58680,11,"""3""",59040,59160
6139,502101,501001,60,58680,11,"""3""",59160,59220
6139,501001,502201,120,58680,11,"""3""",59220,59340
6139,502201,101001,240,58680,11,"""3""",59340,59580
6139,101001,118101,60,58680,11,"""3""",59580,59640
6139,118101,106001,60,58680,11,"""3""",59640,59700
6139,106001,118001,120,58680,11,"""3""",59700,59820
6139,118001,103004,180,58680,11,"""3""",59820,60000
6139,103004,112107,180,58680,11,"""3""",60000,60180
6139,112107,403102,60,58680,11,"""3""",60180,60240
6139,403102,402301,60,58680,11,"""3""",60240,60300
6139,402301,406602,120,58680,11,"""3""",60300,60420
6139,406602,402501,60,58680,11,"""3""",60420,60480
6139,402501,408004,120,58680,11,"""3""",60480,60600
6139,408004,406801,120,58680,11,"""3""",60600,60720
6139,406801,402401,120,58680,11,"""3""",60720,60840
6139,402401,403901,60,58680,11,"""3""",60840,60900
6139,403901,33606,60,58680,11,"""3""",60900,60960
6139,33606,407503,60,58680,11,"""3""",60960,61020
6139,407503,408900,60,58680,11,"""3""",61020,61080
6139,408900,400802,60,58680,11,"""3""",61080,61140
6139,400802,401303,120,58680,11,"""3""",61140,61260
6139,401303,26503,60,58680,11,"""3""",61260,61320
6139,26503,401502,120,58680,11,"""3""",61320,61440
6139,401502,401901,60,58680,11,"""3""",61440,61500
6139,401901,401401,60,58680,11,"""3""",61500,61560
6139,401401,403301,60,58680,11,"""3""",61560,61620
6139,403301,410202,120,58680,11,"""3""",61620,61740
6139,503302,503402,60,59880,11,"""3""",59880,59940
6139,503402,503501,60,59880,11,"""3""",59940,60000
6139,503501,503202,60,59880,11,"""3""",60000,60060
6139,503202,500405,60,59880,11,"""3""",60060,60120
6139,500405,501301,120,59880,11,"""3""",60120,60240
6139,501301,502101,120,59880,11,"""3""",60240,60360
6139,502101,501001,60,59880,11,"""3""",60360,60420
6139,501001,502201,120,59880,11,"""3""",60420,60540
6139,502201,101001,240,59880,11,"""3""",60540,60780
6139,101001,118101,60,59880,11,"""3""",60780,60840
6139,118101,106001,60,59880,11,"""3""",60840,60900
6139,106001,118001,120,59880,11,"""3""",60900,61020
6139,118001,103004,180,59880,11,"""3""",61020,61200
6139,103004,112107,180,59880,11,"""3""",61200,61380
6139,112107,403102,60,59880,11,"""3""",61380,61440
6139,403102,402301,60,59880,11,"""3""",61440,61500
6139,402301,406602,120,59880,11,"""3""",61500,61620
6139,406602,402501,60,59880,11,"""3""",61620,61680
6139,402501,408004,120,59880,11,"""3""",61680,61800
6139,408004,406801,120,59880,11,"""3""",61800,61920
6139,406801,402401,120,59880,11,"""3""",61920,62040
6139,402401,403901,60,59880,11,"""3""",62040,62100
6139,403901,33606,60,59880,11,"""3""",62100,62160
6139,33606,407503,60,59880,11,"""3""",62160,62220
6139,407503,408900,60,59880,11,"""3""",62220,62280
6139,408900,400802,60,59880,11,"""3""",62280,62340
6139,400802,401303,120,59880,11,"""3""",62340,62460
6139,401303,26503,60,59880,11,"""3""",62460,62520
6139,26503,401502,120,59880,11,"""3""",62520,62640
6139,401502,401901,60,59880,11,"""3""",62640,62700
6139,401901,401401,60,59880,11,"""3""",62700,62760
6139,401401,403301,60,59880,11,"""3""",62760,62820
6139,403301,410202,120,59880,11,"""3""",62820,62940
6139,503302,503402,60,61080,11,"""3""",61080,61140
6139,503402,503501,60,61080,11,"""3""",61140,61200
6139,503501,503202,60,61080,11,"""3""",61200,61260
6139,503202,500405,60,61080,11,"""3""",61260,61320
6139,500405,501301,120,61080,11,"""3""",61320,61440
6139,501301,502101,120,61080,11,"""3""",61440,61560
6139,502101,501001,60,61080,11,"""3""",61560,61620
6139,501001,502201,120,61080,11,"""3""",61620,61740
6139,502201,101001,240,61080,11,"""3""",61740,61980
6139,101001,118101,60,61080,11,"""3""",61980,62040
6139,118101,106001,60,61080,11,"""3""",62040,62100
6139,106001,118001,120,61080,11,"""3""",62100,62220
6139,118001,103004,180,61080,11,"""3""",62220,62400
6139,103004,112107,180,61080,11,"""3""",62400,62580
6139,112107,403102,60,61080,11,"""3""",62580,62640
6139,403102,402301,60,61080,11,"""3""",62640,62700
6139,402301,406602,120,61080,11,"""3""",62700,62820
6139,406602,402501,60,61080,11,"""3""",62820,62880
6139,402501,408004,120,61080,11,"""3""",62880,63000
6139,408004,406801,120,61080,11,"""3""",63000,63120
6139,406801,402401,120,61080,11,"""3""",63120,63240
6139,402401,403901,60,61080,11,"""3""",63240,63300
6139,403901,33606,60,61080,11,"""3""",63300,63360
6139,33606,407503,60,61080,11,"""3""",63360,63420
6139,407503,408900,60,61080,11,"""3""",63420,63480
6139,408900,400802,60,61080,11,"""3""",63480,63540
6139,400802,401303,120,61080,11,"""3""",63540,63660
6139,401303,26503,60,61080,11,"""3""",63660,63720
6139,26503,401502,120,61080,11,"""3""",63720,63840
6139,401502,401901,60,61080,11,"""3""",63840,63900
6139,401901,401401,60,61080,11,"""3""",63900,63960
6139,401401,403301,60,61080,11,"""3""",63960,64020
6139,403301,410202,120,61080,11,"""3""",64020,64140
6139,503302,503402,60,62280,11,"""3""",62280,62340
6139,503402,503501,60,62280,11,"""3""",62340,62400
6139,503501,503202,60,62280,11,"""3""",62400,62460
6139,503202,500405,60,62280,11,"""3""",62460,62520
6139,500405,501301,120,62280,11,"""3""",62520,62640
6139,501301,502101,120,62280,11,"""3""",62640,62760
6139,502101,501001,60,62280,11,"""3""",62760,62820
6139,501001,502201,120,62280,11,"""3""",62820,62940
6139,502201,101001,240,62280,11,"""3""",62940,63180
6139,101001,118101,60,62280,11,"""3""",63180,63240
6139,118101,106001,60,62280,11,"""3""",63240,63300
6139,106001,118001,120,62280,11,"""3""",63300,63420
6139,118001,103004,180,62280,11,"""3""",63420,63600
6139,103004,112107,180,62280,11,"""3""",63600,63780
6139,112107,403102,60,62280,11,"""3""",63780,63840
6139,403102,402301,60,62280,11,"""3""",63840,63900
6139,402301,406602,120,62280,11,"""3""",63900,64020
6139,406602,402501,60,62280,11,"""3""",64020,64080
6139,402501,408004,120,62280,11,"""3""",64080,64200
6139,408004,406801,120,62280,11,"""3""",64200,64320
6139,406801,402401,120,62280,11,"""3""",64320,64440
6139,402401,403901,60,62280,11,"""3""",64440,64500
6139,403901,33606,60,62280,11,"""3""",64500,64560
6139,33606,407503,60,62280,11,"""3""",64560,64620
6139,407503,408900,60,62280,11,"""3""",64620,64680
6139,408900,400802,60,62280,11,"""3""",64680,64740
6139,400802,401303,120,62280,11,"""3""",64740,64860
6139,401303,26503,60,62280,11,"""3""",64860,64920
6139,26503,401502,120,62280,11,"""3""",64920,65040
6139,401502,401901,60,62280,11,"""3""",65040,65100
6139,401901,401401,60,62280,11,"""3""",65100,65160
6139,401401,403301,60,62280,11,"""3""",65160,65220
6139,403301,410202,120,62280,11,"""3""",65220,65340
6139,503302,503402,60,63480,11,"""3""",63480,63540
6139,503402,503501,60,63480,11,"""3""",63540,63600
6139,503501,503202,60,63480,11,"""3""",63600,63660
6139,503202,500405,60,63480,11,"""3""",63660,63720
6139,500405,501301,120,63480,11,"""3""",63720,63840
6139,501301,502101,120,63480,11,"""3""",63840,63960
6139,502101,501001,60,63480,11,"""3""",63960,64020
6139,501001,502201,120,63480,11,"""3""",64020,64140
6139,502201,101001,240,63480,11,"""3""",64140,64380
6139,101001,118101,60,63480,11,"""3""",64380,64440
6139,118101,106001,60,63480,11,"""3""",64440,64500
6139,106001,118001,120,63480,11,"""3""",64500,64620
6139,118001,103004,180,63480,11,"""3""",64620,64800
6139,103004,112107,180,63480,11,"""3""",64800,64980
6139,112107,403102,60,63480,11,"""3""",64980,65040
6139,403102,402301,60,63480,11,"""3""",65040,65100
6139,402301,406602,120,63480,11,"""3""",65100,65220
6139,406602,402501,60,63480,11,"""3""",65220,65280
6139,402501,408004,120,63480,11,"""3""",65280,65400
6139,408004,406801,120,63480,11,"""3""",65400,65520
6139,406801,402401,120,63480,11,"""3""",65520,65640
6139,402401,403901,60,63480,11,"""3""",65640,65700
6139,403901,33606,60,63480,11,"""3""",65700,65760
6139,33606,407503,60,63480,11,"""3""",65760,65820
6139,407503,408900,60,63480,11,"""3""",65820,65880
6139,408900,400802,60,63480,11,"""3""",65880,65940
6139,400802,401303,120,63480,11,"""3""",65940,66060
6139,401303,26503,60,63480,11,"""3""",66060,66120
6139,26503,401502,120,63480,11,"""3""",66120,66240
6139,401502,401901,60,63480,11,"""3""",66240,66300
6139,401901,401401,60,63480,11,"""3""",66300,66360
6139,401401,403301,60,63480,11,"""3""",66360,66420
6139,403301,410202,120,63480,11,"""3""",66420,66540
6139,503302,503402,60,64680,11,"""3""",64680,64740
6139,503402,503501,60,64680,11,"""3""",64740,64800
6139,503501,503202,60,64680,11,"""3""",64800,64860
6139,503202,500405,60,64680,11,"""3""",64860,64920
6139,500405,501301,120,64680,11,"""3""",64920,65040
6139,501301,502101,120,64680,11,"""3""",65040,65160
6139,502101,501001,60,64680,11,"""3""",65160,65220
6139,501001,502201,120,64680,11,"""3""",65220,65340
6139,502201,101001,240,64680,11,"""3""",65340,65580
6139,101001,118101,60,64680,11,"""3""",65580,65640
6139,118101,106001,60,64680,11,"""3""",65640,65700
6139,106001,118001,120,64680,11,"""3""",65700,65820
6139,118001,103004,180,64680,11,"""3""",65820,66000
6139,103004,112107,180,64680,11,"""3""",66000,66180
6139,112107,403102,60,64680,11,"""3""",66180,66240
6139,403102,402301,60,64680,11,"""3""",66240,66300
6139,402301,406602,120,64680,11,"""3""",66300,66420
6139,406602,402501,60,64680,11,"""3""",66420,66480
6139,402501,408004,120,64680,11,"""3""",66480,66600
6139,408004,406801,120,64680,11,"""3""",66600,66720
6139,406801,402401,120,64680,11,"""3""",66720,66840
6139,402401,403901,60,64680,11,"""3""",66840,66900
6139,403901,33606,60,64680,11,"""3""",66900,66960
6139,33606,407503,60,64680,11,"""3""",66960,67020
6139,407503,408900,60,64680,11,"""3""",67020,67080
6139,408900,400802,60,64680,11,"""3""",67080,67140
6139,400802,401303,120,64680,11,"""3""",67140,67260
6139,401303,26503,60,64680,11,"""3""",67260,67320
6139,26503,401502,120,64680,11,"""3""",67320,67440
6139,401502,401901,60,64680,11,"""3""",67440,67500
6139,401901,401401,60,64680,11,"""3""",67500,67560
6139,401401,403301,60,64680,11,"""3""",67560,67620
6139,403301,410202,120,64680,11,"""3""",67620,67740
6139,503302,503402,60,65880,11,"""3""",65880,65940
6139,503402,503501,60,65880,11,"""3""",65940,66000
6139,503501,503202,60,65880,11,"""3""",66000,66060
6139,503202,500405,60,65880,11,"""3""",66060,66120
6139,500405,501301,120,65880,11,"""3""",66120,66240
6139,501301,502101,120,65880,11,"""3""",66240,66360
6139,502101,501001,60,65880,11,"""3""",66360,66420
6139,501001,502201,120,65880,11,"""3""",66420,66540
6139,502201,101001,240,65880,11,"""3""",66540,66780
6139,101001,118101,60,65880,11,"""3""",66780,66840
6139,118101,106001,60,65880,11,"""3""",66840,66900
6139,106001,118001,120,65880,11,"""3""",66900,67020
6139,118001,103004,180,65880,11,"""3""",67020,67200
6139,103004,112107,180,65880,11,"""3""",67200,67380
6139,112107,403102,60,65880,11,"""3""",67380,67440
6139,403102,402301,60,65880,11,"""3""",67440,67500
6139,402301,406602,120,65880,11,"""3""",67500,67620
6139,406602,402501,60,65880,11,"""3""",67620,67680
6139,402501,408004,120,65880,11,"""3""",67680,67800
6139,408004,406801,120,65880,11,"""3""",67800,67920
6139,406801,402401,120,65880,11,"""3""",67920,68040
6139,402401,403901,60,65880,11,"""3""",68040,68100
6139,403901,33606,60,65880,11,"""3""",68100,68160
6139,33606,407503,60,65880,11,"""3""",68160,68220
6139,407503,408900,60,65880,11,"""3""",68220,68280
6139,408900,400802,60,65880,11,"""3""",68280,68340
6139,400802,401303,120,65880,11,"""3""",68340,68460
6139,401303,26503,60,65880,11,"""3""",68460,68520
6139,26503,401502,120,65880,11,"""3""",68520,68640
6139,401502,401901,60,65880,11,"""3""",68640,68700
6139,401901,401401,60,65880,11,"""3""",68700,68760
6139,401401,403301,60,65880,11,"""3""",68760,68820
6139,403301,410202,120,65880,11,"""3""",68820,68940
6139,503302,503402,60,67740,11,"""3""",67740,67800
6139,503402,503501,60,67740,11,"""3""",67800,67860
6139,503501,503202,60,67740,11,"""3""",67860,67920
6139,503202,500405,60,67740,11,"""3""",67920,67980
6139,500405,501301,120,67740,11,"""3""",67980,68100
6139,501301,502101,120,67740,11,"""3""",68100,68220
6139,502101,501001,60,67740,11,"""3""",68220,68280
6139,501001,502201,120,67740,11,"""3""",68280,68400
6139,502201,101001,240,67740,11,"""3""",68400,68640
6139,101001,118101,60,67740,11,"""3""",68640,68700
6139,118101,106001,60,67740,11,"""3""",68700,68760
6139,106001,118001,120,67740,11,"""3""",68760,68880
6139,118001,103004,180,67740,11,"""3""",68880,69060
6139,103004,112107,180,67740,11,"""3""",69060,69240
6139,112107,403102,60,67740,11,"""3""",69240,69300
6139,403102,402301,60,67740,11,"""3""",69300,69360
6139,402301,406602,120,67740,11,"""3""",69360,69480
6139,406602,402501,60,67740,11,"""3""",69480,69540
6139,402501,408004,120,67740,11,"""3""",69540,69660
6139,408004,406801,120,67740,11,"""3""",69660,69780
6139,406801,402401,120,67740,11,"""3""",69780,69900
6139,402401,403901,60,67740,11,"""3""",69900,69960
6139,403901,33606,60,67740,11,"""3""",69960,70020
6139,33606,407503,60,67740,11,"""3""",70020,70080
6139,407503,408900,60,67740,11,"""3""",70080,70140
6139,408900,400802,60,67740,11,"""3""",70140,70200
6139,400802,401303,120,67740,11,"""3""",70200,70320
6139,401303,26503,60,67740,11,"""3""",70320,70380
6139,26503,401502,120,67740,11,"""3""",70380,70500
6139,401502,401901,60,67740,11,"""3""",70500,70560
6139,401901,401401,60,67740,11,"""3""",70560,70620
6139,401401,403301,60,67740,11,"""3""",70620,70680
6139,403301,410202,120,67740,11,"""3""",70680,70800
6139,503302,503402,60,69540,11,"""3""",69540,69600
6139,503402,503501,60,69540,11,"""3""",69600,69660
6139,503501,503202,60,69540,11,"""3""",69660,69720
6139,503202,500405,60,69540,11,"""3""",69720,69780
6139,500405,501301,120,69540,11,"""3""",69780,69900
6139,501301,502101,120,69540,11,"""3""",69900,70020
6139,502101,501001,60,69540,11,"""3""",70020,70080
6139,501001,502201,120,69540,11,"""3""",70080,70200
6139,502201,101001,240,69540,11,"""3""",70200,70440
6139,101001,118101,60,69540,11,"""3""",70440,70500
6139,118101,106001,60,69540,11,"""3""",70500,70560
6139,106001,118001,120,69540,11,"""3""",70560,70680
6139,118001,103004,180,69540,11,"""3""",70680,70860
6139,103004,112107,180,69540,11,"""3""",70860,71040
6139,112107,403102,60,69540,11,"""3""",71040,71100
6139,403102,402301,60,69540,11,"""3""",71100,71160
6139,402301,406602,120,69540,11,"""3""",71160,71280
6139,406602,402501,60,69540,11,"""3""",71280,71340
6139,402501,408004,120,69540,11,"""3""",71340,71460
6139,408004,406801,120,69540,11,"""3""",71460,71580
6139,406801,402401,120,69540,11,"""3""",71580,71700
6139,402401,403901,60,69540,11,"""3""",71700,71760
6139,403901,33606,60,69540,11,"""3""",71760,71820
6139,33606,407503,60,69540,11,"""3""",71820,71880
6139,407503,408900,60,69540,11,"""3""",71880,71940
6139,408900,400802,60,69540,11,"""3""",71940,72000
6139,400802,401303,120,69540,11,"""3""",72000,72120
6139,401303,26503,60,69540,11,"""3""",72120,72180
6139,26503,401502,120,69540,11,"""3""",72180,72300
6139,401502,401901,60,69540,11,"""3""",72300,72360
6139,401901,401401,60,69540,11,"""3""",72360,72420
6139,401401,403301,60,69540,11,"""3""",72420,72480
6139,403301,410202,120,69540,11,"""3""",72480,72600
6140,503302,503402,60,21540,11,"""3""",21540,21600
6140,503402,503501,60,21540,11,"""3""",21600,21660
6140,503501,503202,60,21540,11,"""3""",21660,21720
6140,503202,500405,60,21540,11,"""3""",21720,21780
6140,500405,501301,120,21540,11,"""3""",21780,21900
6140,501301,502101,120,21540,11,"""3""",21900,22020
6140,502101,501001,60,21540,11,"""3""",22020,22080
6140,501001,502201,60,21540,11,"""3""",22080,22140
6140,502201,101001,240,21540,11,"""3""",22140,22380
6140,101001,118101,60,21540,11,"""3""",22380,22440
6140,118101,106001,60,21540,11,"""3""",22440,22500
6140,106001,118001,120,21540,11,"""3""",22500,22620
6140,118001,103004,180,21540,11,"""3""",22620,22800
6140,103004,112107,180,21540,11,"""3""",22800,22980
6140,112107,403102,60,21540,11,"""3""",22980,23040
6140,403102,402301,60,21540,11,"""3""",23040,23100
6140,402301,406602,120,21540,11,"""3""",23100,23220
6140,406602,402501,60,21540,11,"""3""",23220,23280
6140,402501,408004,120,21540,11,"""3""",23280,23400
6140,408004,406801,120,21540,11,"""3""",23400,23520
6140,406801,402401,120,21540,11,"""3""",23520,23640
6140,402401,403901,60,21540,11,"""3""",23640,23700
6140,403901,33606,60,21540,11,"""3""",23700,23760
6140,33606,407503,60,21540,11,"""3""",23760,23820
6140,407503,408900,60,21540,11,"""3""",23820,23880
6140,408900,400802,60,21540,11,"""3""",23880,23940
6140,400802,401303,120,21540,11,"""3""",23940,24060
6140,401303,26503,60,21540,11,"""3""",24060,24120
6140,26503,401502,120,21540,11,"""3""",24120,24240
6140,401502,401901,60,21540,11,"""3""",24240,24300
6140,401901,401401,60,21540,11,"""3""",24300,24360
6140,401401,403301,60,21540,11,"""3""",24360,24420
6140,403301,410202,120,21540,11,"""3""",24420,24540
6140,503302,503402,60,22740,11,"""3""",22740,22800
6140,503402,503501,60,22740,11,"""3""",22800,22860
6140,503501,503202,60,22740,11,"""3""",22860,22920
6140,503202,500405,60,22740,11,"""3""",22920,22980
6140,500405,501301,120,22740,11,"""3""",22980,23100
6140,501301,502101,120,22740,11,"""3""",23100,23220
6140,502101,501001,60,22740,11,"""3""",23220,23280
6140,501001,502201,60,22740,11,"""3""",23280,23340
6140,502201,101001,240,22740,11,"""3""",23340,23580
6140,101001,118101,60,22740,11,"""3""",23580,23640
6140,118101,106001,60,22740,11,"""3""",23640,23700
6140,106001,118001,120,22740,11,"""3""",23700,23820
6140,118001,103004,180,22740,11,"""3""",23820,24000
6140,103004,112107,180,22740,11,"""3""",24000,24180
6140,112107,403102,60,22740,11,"""3""",24180,24240
6140,403102,402301,60,22740,11,"""3""",24240,24300
6140,402301,406602,120,22740,11,"""3""",24300,24420
6140,406602,402501,60,22740,11,"""3""",24420,24480
6140,402501,408004,120,22740,11,"""3""",24480,24600
6140,408004,406801,120,22740,11,"""3""",24600,24720
6140,406801,402401,120,22740,11,"""3""",24720,24840
6140,402401,403901,60,22740,11,"""3""",24840,24900
6140,403901,33606,60,22740,11,"""3""",24900,24960
6140,33606,407503,60,22740,11,"""3""",24960,25020
6140,407503,408900,60,22740,11,"""3""",25020,25080
6140,408900,400802,60,22740,11,"""3""",25080,25140
6140,400802,401303,120,22740,11,"""3""",25140,25260
6140,401303,26503,60,22740,11,"""3""",25260,25320
6140,26503,401502,120,22740,11,"""3""",25320,25440
6140,401502,401901,60,22740,11,"""3""",25440,25500
6140,401901,401401,60,22740,11,"""3""",25500,25560
6140,401401,403301,60,22740,11,"""3""",25560,25620
6140,403301,410202,120,22740,11,"""3""",25620,25740
6141,503302,503402,60,71400,11,"""3""",71400,71460
6141,503402,503501,60,71400,11,"""3""",71460,71520
6141,503501,503202,60,71400,11,"""3""",71520,71580
6141,503202,500405,60,71400,11,"""3""",71580,71640
6141,500405,501301,120,71400,11,"""3""",71640,71760
6141,501301,502101,120,71400,11,"""3""",71760,71880
6141,502101,501001,60,71400,11,"""3""",71880,71940
6141,501001,502201,60,71400,11,"""3""",71940,72000
6141,502201,101001,180,71400,11,"""3""",72000,72180
6141,101001,118101,60,71400,11,"""3""",72180,72240
6141,118101,106001,60,71400,11,"""3""",72240,72300
6141,106001,118001,120,71400,11,"""3""",72300,72420
6141,118001,103004,180,71400,11,"""3""",72420,72600
6141,103004,112107,120,71400,11,"""3""",72600,72720
6141,112107,403102,60,71400,11,"""3""",72720,72780
6141,403102,402301,60,71400,11,"""3""",72780,72840
6141,402301,406602,60,71400,11,"""3""",72840,72900
6141,406602,402501,60,71400,11,"""3""",72900,72960
6141,402501,408004,120,71400,11,"""3""",72960,73080
6141,408004,406801,120,71400,11,"""3""",73080,73200
6141,406801,402401,60,71400,11,"""3""",73200,73260
6141,402401,403901,60,71400,11,"""3""",73260,73320
6141,403901,33606,60,71400,11,"""3""",73320,73380
6141,33606,407503,60,71400,11,"""3""",73380,73440
6141,407503,408900,60,71400,11,"""3""",73440,73500
6141,408900,400802,60,71400,11,"""3""",73500,73560
6141,400802,401303,120,71400,11,"""3""",73560,73680
6141,401303,26503,60,71400,11,"""3""",73680,73740
6141,26503,401502,60,71400,11,"""3""",73740,73800
6141,401502,401901,60,71400,11,"""3""",73800,73860
6141,401901,401401,60,71400,11,"""3""",73860,73920
6141,401401,403301,60,71400,11,"""3""",73920,73980
6141,403301,410202,120,71400,11,"""3""",73980,74100
6141,503302,503402,60,73200,11,"""3""",73200,73260
6141,503402,503501,60,73200,11,"""3""",73260,73320
6141,503501,503202,60,73200,11,"""3""",73320,73380
6141,503202,500405,60,73200,11,"""3""",73380,73440
6141,500405,501301,120,73200,11,"""3""",73440,73560
6141,501301,502101,120,73200,11,"""3""",73560,73680
6141,502101,501001,60,73200,11,"""3""",73680,73740
6141,501001,502201,60,73200,11,"""3""",73740,73800
6141,502201,101001,180,73200,11,"""3""",73800,73980
6141,101001,118101,60,73200,11,"""3""",73980,74040
6141,118101,106001,60,73200,11,"""3""",74040,74100
6141,106001,118001,120,73200,11,"""3""",74100,74220
6141,118001,103004,180,73200,11,"""3""",74220,74400
6141,103004,112107,120,73200,11,"""3""",74400,74520
6141,112107,403102,60,73200,11,"""3""",74520,74580
6141,403102,402301,60,73200,11,"""3""",74580,74640
6141,402301,406602,60,73200,11,"""3""",74640,74700
6141,406602,402501,60,73200,11,"""3""",74700,74760
6141,402501,408004,120,73200,11,"""3""",74760,74880
6141,408004,406801,120,73200,11,"""3""",74880,75000
6141,406801,402401,60,73200,11,"""3""",75000,75060
6141,402401,403901,60,73200,11,"""3""",75060,75120
6141,403901,33606,60,73200,11,"""3""",75120,75180
6141,33606,407503,60,73200,11,"""3""",75180,75240
6141,407503,408900,60,73200,11,"""3""",75240,75300
6141,408900,400802,60,73200,11,"""3""",75300,75360
6141,400802,401303,120,73200,11,"""3""",75360,75480
6141,401303,26503,60,73200,11,"""3""",75480,75540
6141,26503,401502,60,73200,11,"""3""",75540,75600
6141,401502,401901,60,73200,11,"""3""",75600,75660
6141,401901,401401,60,73200,11,"""3""",75660,75720
6141,401401,403301,60,73200,11,"""3""",75720,75780
6141,403301,410202,120,73200,11,"""3""",75780,75900
6141,503302,503402,60,75000,11,"""3""",75000,75060
6141,503402,503501,60,75000,11,"""3""",75060,75120
6141,503501,503202,60,75000,11,"""3""",75120,75180
6141,503202,500405,60,75000,11,"""3""",75180,75240
6141,500405,501301,120,75000,11,"""3""",75240,75360
6141,501301,502101,120,75000,11,"""3""",75360,75480
6141,502101,501001,60,75000,11,"""3""",75480,75540
6141,501001,502201,60,75000,11,"""3""",75540,75600
6141,502201,101001,180,75000,11,"""3""",75600,75780
6141,101001,118101,60,75000,11,"""3""",75780,75840
6141,118101,106001,60,75000,11,"""3""",75840,75900
6141,106001,118001,120,75000,11,"""3""",75900,76020
6141,118001,103004,180,75000,11,"""3""",76020,76200
6141,103004,112107,120,75000,11,"""3""",76200,76320
6141,112107,403102,60,75000,11,"""3""",76320,76380
6141,403102,402301,60,75000,11,"""3""",76380,76440
6141,402301,406602,60,75000,11,"""3""",76440,76500
6141,406602,402501,60,75000,11,"""3""",76500,76560
6141,402501,408004,120,75000,11,"""3""",76560,76680
6141,408004,406801,120,75000,11,"""3""",76680,76800
6141,406801,402401,60,75000,11,"""3""",76800,76860
6141,402401,403901,60,75000,11,"""3""",76860,76920
6141,403901,33606,60,75000,11,"""3""",76920,76980
6141,33606,407503,60,75000,11,"""3""",76980,77040
6141,407503,408900,60,75000,11,"""3""",77040,77100
6141,408900,400802,60,75000,11,"""3""",77100,77160
6141,400802,401303,120,75000,11,"""3""",77160,77280
6141,401303,26503,60,75000,11,"""3""",77280,77340
6141,26503,401502,60,75000,11,"""3""",77340,77400
6141,401502,401901,60,75000,11,"""3""",77400,77460
6141,401901,401401,60,75000,11,"""3""",77460,77520
6141,401401,403301,60,75000,11,"""3""",77520,77580
6141,403301,410202,120,75000,11,"""3""",77580,77700
6141,503302,503402,60,76800,11,"""3""",76800,76860
6141,503402,503501,60,76800,11,"""3""",76860,76920
6141,503501,503202,60,76800,11,"""3""",76920,76980
6141,503202,500405,60,76800,11,"""3""",76980,77040
6141,500405,501301,120,76800,11,"""3""",77040,77160
6141,501301,502101,120,76800,11,"""3""",77160,77280
6141,502101,501001,60,76800,11,"""3""",77280,77340
6141,501001,502201,60,76800,11,"""3""",77340,77400
6141,502201,101001,180,76800,11,"""3""",77400,77580
6141,101001,118101,60,76800,11,"""3""",77580,77640
6141,118101,106001,60,76800,11,"""3""",77640,77700
6141,106001,118001,120,76800,11,"""3""",77700,77820
6141,118001,103004,180,76800,11,"""3""",77820,78000
6141,103004,112107,120,76800,11,"""3""",78000,78120
6141,112107,403102,60,76800,11,"""3""",78120,78180
6141,403102,402301,60,76800,11,"""3""",78180,78240
6141,402301,406602,60,76800,11,"""3""",78240,78300
6141,406602,402501,60,76800,11,"""3""",78300,78360
6141,402501,408004,120,76800,11,"""3""",78360,78480
6141,408004,406801,120,76800,11,"""3""",78480,78600
6141,406801,402401,60,76800,11,"""3""",78600,78660
6141,402401,403901,60,76800,11,"""3""",78660,78720
6141,403901,33606,60,76800,11,"""3""",78720,78780
6141,33606,407503,60,76800,11,"""3""",78780,78840
6141,407503,408900,60,76800,11,"""3""",78840,78900
6141,408900,400802,60,76800,11,"""3""",78900,78960
6141,400802,401303,120,76800,11,"""3""",78960,79080
6141,401303,26503,60,76800,11,"""3""",79080,79140
6141,26503,401502,60,76800,11,"""3""",79140,79200
6141,401502,401901,60,76800,11,"""3""",79200,79260
6141,401901,401401,60,76800,11,"""3""",79260,79320
6141,401401,403301,60,76800,11,"""3""",79320,79380
6141,403301,410202,120,76800,11,"""3""",79380,79500
6141,503302,503402,60,78600,11,"""3""",78600,78660
6141,503402,503501,60,78600,11,"""3""",78660,78720
6141,503501,503202,60,78600,11,"""3""",78720,78780
6141,503202,500405,60,78600,11,"""3""",78780,78840
6141,500405,501301,120,78600,11,"""3""",78840,78960
6141,501301,502101,120,78600,11,"""3""",78960,79080
6141,502101,501001,60,78600,11,"""3""",79080,79140
6141,501001,502201,60,78600,11,"""3""",79140,79200
6141,502201,101001,180,78600,11,"""3""",79200,79380
6141,101001,118101,60,78600,11,"""3""",79380,79440
6141,118101,106001,60,78600,11,"""3""",79440,79500
6141,106001,118001,120,78600,11,"""3""",79500,79620
6141,118001,103004,180,78600,11,"""3""",79620,79800
6141,103004,112107,120,78600,11,"""3""",79800,79920
6141,112107,403102,60,78600,11,"""3""",79920,79980
6141,403102,402301,60,78600,11,"""3""",79980,80040
6141,402301,406602,60,78600,11,"""3""",80040,80100
6141,406602,402501,60,78600,11,"""3""",80100,80160
6141,402501,408004,120,78600,11,"""3""",80160,80280
6141,408004,406801,120,78600,11,"""3""",80280,80400
6141,406801,402401,60,78600,11,"""3""",80400,80460
6141,402401,403901,60,78600,11,"""3""",80460,80520
6141,403901,33606,60,78600,11,"""3""",80520,80580
6141,33606,407503,60,78600,11,"""3""",80580,80640
6141,407503,408900,60,78600,11,"""3""",80640,80700
6141,408900,400802,60,78600,11,"""3""",80700,80760
6141,400802,401303,120,78600,11,"""3""",80760,80880
6141,401303,26503,60,78600,11,"""3""",80880,80940
6141,26503,401502,60,78600,11,"""3""",80940,81000
6141,401502,401901,60,78600,11,"""3""",81000,81060
6141,401901,401401,60,78600,11,"""3""",81060,81120
6141,401401,403301,60,78600,11,"""3""",81120,81180
6141,403301,410202,120,78600,11,"""3""",81180,81300
6141,503302,503402,60,80400,11,"""3""",80400,80460
6141,503402,503501,60,80400,11,"""3""",80460,80520
6141,503501,503202,60,80400,11,"""3""",80520,80580
6141,503202,500405,60,80400,11,"""3""",80580,80640
6141,500405,501301,120,80400,11,"""3""",80640,80760
6141,501301,502101,120,80400,11,"""3""",80760,80880
6141,502101,501001,60,80400,11,"""3""",80880,80940
6141,501001,502201,60,80400,11,"""3""",80940,81000
6141,502201,101001,180,80400,11,"""3""",81000,81180
6141,101001,118101,60,80400,11,"""3""",81180,81240
6141,118101,106001,60,80400,11,"""3""",81240,81300
6141,106001,118001,120,80400,11,"""3""",81300,81420
6141,118001,103004,180,80400,11,"""3""",81420,81600
6141,103004,112107,120,80400,11,"""3""",81600,81720
6141,112107,403102,60,80400,11,"""3""",81720,81780
6141,403102,402301,60,80400,11,"""3""",81780,81840
6141,402301,406602,60,80400,11,"""3""",81840,81900
6141,406602,402501,60,80400,11,"""3""",81900,81960
6141,402501,408004,120,80400,11,"""3""",81960,82080
6141,408004,406801,120,80400,11,"""3""",82080,82200
6141,406801,402401,60,80400,11,"""3""",82200,82260
6141,402401,403901,60,80400,11,"""3""",82260,82320
6141,403901,33606,60,80400,11,"""3""",82320,82380
6141,33606,407503,60,80400,11,"""3""",82380,82440
6141,407503,408900,60,80400,11,"""3""",82440,82500
6141,408900,400802,60,80400,11,"""3""",82500,82560
6141,400802,401303,120,80400,11,"""3""",82560,82680
6141,401303,26503,60,80400,11,"""3""",82680,82740
6141,26503,401502,60,80400,11,"""3""",82740,82800
6141,401502,401901,60,80400,11,"""3""",82800,82860
6141,401901,401401,60,80400,11,"""3""",82860,82920
6141,401401,403301,60,80400,11,"""3""",82920,82980
6141,403301,410202,120,80400,11,"""3""",82980,83100
6141,503302,503402,60,82200,11,"""3""",82200,82260
6141,503402,503501,60,82200,11,"""3""",82260,82320
6141,503501,503202,60,82200,11,"""3""",82320,82380
6141,503202,500405,60,82200,11,"""3""",82380,82440
6141,500405,501301,120,82200,11,"""3""",82440,82560
6141,501301,502101,120,82200,11,"""3""",82560,82680
6141,502101,501001,60,82200,11,"""3""",82680,82740
6141,501001,502201,60,82200,11,"""3""",82740,82800
6141,502201,101001,180,82200,11,"""3""",82800,82980
6141,101001,118101,60,82200,11,"""3""",82980,83040
6141,118101,106001,60,82200,11,"""3""",83040,83100
6141,106001,118001,120,82200,11,"""3""",83100,83220
6141,118001,103004,180,82200,11,"""3""",83220,83400
6141,103004,112107,120,82200,11,"""3""",83400,83520
6141,112107,403102,60,82200,11,"""3""",83520,83580
6141,403102,402301,60,82200,11,"""3""",83580,83640
6141,402301,406602,60,82200,11,"""3""",83640,83700
6141,406602,402501,60,82200,11,"""3""",83700,83760
6141,402501,408004,120,82200,11,"""3""",83760,83880
6141,408004,406801,120,82200,11,"""3""",83880,84000
6141,406801,402401,60,82200,11,"""3""",84000,84060
6141,402401,403901,60,82200,11,"""3""",84060,84120
6141,403901,33606,60,82200,11,"""3""",84120,84180
6141,33606,407503,60,82200,11,"""3""",84180,84240
6141,407503,408900,60,82200,11,"""3""",84240,84300
6141,408900,400802,60,82200,11,"""3""",84300,84360
6141,400802,401303,120,82200,11,"""3""",84360,84480
6141,401303,26503,60,82200,11,"""3""",84480,84540
6141,26503,401502,60,82200,11,"""3""",84540,84600
6141,401502,401901,60,82200,11,"""3""",84600,84660
6141,401901,401401,60,82200,11,"""3""",84660,84720
6141,401401,403301,60,82200,11,"""3""",84720,84780
6141,403301,410202,120,82200,11,"""3""",84780,84900
6141,503302,503402,60,84000,11,"""3""",84000,84060
6141,503402,503501,60,84000,11,"""3""",84060,84120
6141,503501,503202,60,84000,11,"""3""",84120,84180
6141,503202,500405,60,84000,11,"""3""",84180,84240
6141,500405,501301,120,84000,11,"""3""",84240,84360
6141,501301,502101,120,84000,11,"""3""",84360,84480
6141,502101,501001,60,84000,11,"""3""",84480,84540
6141,501001,502201,60,84000,11,"""3""",84540,84600
6141,502201,101001,180,84000,11,"""3""",84600,84780
6141,101001,118101,60,84000,11,"""3""",84780,84840
6141,118101,106001,60,84000,11,"""3""",84840,84900
6141,106001,118001,120,84000,11,"""3""",84900,85020
6141,118001,103004,180,84000,11,"""3""",85020,85200
6141,103004,112107,120,84000,11,"""3""",85200,85320
6141,112107,403102,60,84000,11,"""3""",85320,85380
6141,403102,402301,60,84000,11,"""3""",85380,85440
6141,402301,406602,60,84000,11,"""3""",85440,85500
6141,406602,402501,60,84000,11,"""3""",85500,85560
6141,402501,408004,120,84000,11,"""3""",85560,85680
6141,408004,406801,120,84000,11,"""3""",85680,85800
6141,406801,402401,60,84000,11,"""3""",85800,85860
6141,402401,403901,60,84000,11,"""3""",85860,85920
6141,403901,33606,60,84000,11,"""3""",85920,85980
6141,33606,407503,60,84000,11,"""3""",85980,86040
6141,407503,408900,60,84000,11,"""3""",86040,86100
6141,408900,400802,60,84000,11,"""3""",86100,86160
6141,400802,401303,120,84000,11,"""3""",86160,86280
6141,401303,26503,60,84000,11,"""3""",86280,86340
6141,26503,401502,60,84000,11,"""3""",86340,86400
6141,401502,401901,60,84000,11,"""3""",86400,86460
6141,401901,401401,60,84000,11,"""3""",86460,86520
6141,401401,403301,60,84000,11,"""3""",86520,86580
6141,403301,410202,120,84000,11,"""3""",86580,86700
6142,503302,503402,60,18960,11,"""3""",18960,19020
6142,503402,503501,60,18960,11,"""3""",19020,19080
6142,503501,503202,60,18960,11,"""3""",19080,19140
6142,503202,500405,60,18960,11,"""3""",19140,19200
6142,500405,501301,120,18960,11,"""3""",19200,19320
6142,501301,502101,60,18960,11,"""3""",19320,19380
6142,502101,501001,60,18960,11,"""3""",19380,19440
6142,501001,502201,60,18960,11,"""3""",19440,19500
6142,502201,101001,180,18960,11,"""3""",19500,19680
6142,101001,118101,60,18960,11,"""3""",19680,19740
6142,118101,106001,60,18960,11,"""3""",19740,19800
6142,106001,118001,60,18960,11,"""3""",19800,19860
6142,118001,103004,180,18960,11,"""3""",19860,20040
6142,103004,112107,180,18960,11,"""3""",20040,20220
6142,112107,403102,60,18960,11,"""3""",20220,20280
6142,403102,402301,60,18960,11,"""3""",20280,20340
6142,402301,406602,120,18960,11,"""3""",20340,20460
6142,406602,402501,60,18960,11,"""3""",20460,20520
6142,402501,408004,120,18960,11,"""3""",20520,20640
6142,408004,406801,120,18960,11,"""3""",20640,20760
6142,406801,402401,60,18960,11,"""3""",20760,20820
6142,402401,403901,60,18960,11,"""3""",20820,20880
6142,403901,33606,60,18960,11,"""3""",20880,20940
6142,33606,407503,60,18960,11,"""3""",20940,21000
6142,407503,408900,60,18960,11,"""3""",21000,21060
6142,408900,400802,60,18960,11,"""3""",21060,21120
6142,400802,401303,120,18960,11,"""3""",21120,21240
6142,401303,26503,60,18960,11,"""3""",21240,21300
6142,26503,401502,60,18960,11,"""3""",21300,21360
6142,401502,401901,60,18960,11,"""3""",21360,21420
6142,401901,401401,60,18960,11,"""3""",21420,21480
6142,401401,403301,60,18960,11,"""3""",21480,21540
6142,403301,410202,120,18960,11,"""3""",21540,21660
6142,503302,503402,60,20160,11,"""3""",20160,20220
6142,503402,503501,60,20160,11,"""3""",20220,20280
6142,503501,503202,60,20160,11,"""3""",20280,20340
6142,503202,500405,60,20160,11,"""3""",20340,20400
6142,500405,501301,120,20160,11,"""3""",20400,20520
6142,501301,502101,60,20160,11,"""3""",20520,20580
6142,502101,501001,60,20160,11,"""3""",20580,20640
6142,501001,502201,60,20160,11,"""3""",20640,20700
6142,502201,101001,180,20160,11,"""3""",20700,20880
6142,101001,118101,60,20160,11,"""3""",20880,20940
6142,118101,106001,60,20160,11,"""3""",20940,21000
6142,106001,118001,60,20160,11,"""3""",21000,21060
6142,118001,103004,180,20160,11,"""3""",21060,21240
6142,103004,112107,180,20160,11,"""3""",21240,21420
6142,112107,403102,60,20160,11,"""3""",21420,21480
6142,403102,402301,60,20160,11,"""3""",21480,21540
6142,402301,406602,120,20160,11,"""3""",21540,21660
6142,406602,402501,60,20160,11,"""3""",21660,21720
6142,402501,408004,120,20160,11,"""3""",21720,21840
6142,408004,406801,120,20160,11,"""3""",21840,21960
6142,406801,402401,60,20160,11,"""3""",21960,22020
6142,402401,403901,60,20160,11,"""3""",22020,22080
6142,403901,33606,60,20160,11,"""3""",22080,22140
6142,33606,407503,60,20160,11,"""3""",22140,22200
6142,407503,408900,60,20160,11,"""3""",22200,22260
6142,408900,400802,60,20160,11,"""3""",22260,22320
6142,400802,401303,120,20160,11,"""3""",22320,22440
6142,401303,26503,60,20160,11,"""3""",22440,22500
6142,26503,401502,60,20160,11,"""3""",22500,22560
6142,401502,401901,60,20160,11,"""3""",22560,22620
6142,401901,401401,60,20160,11,"""3""",22620,22680
6142,401401,403301,60,20160,11,"""3""",22680,22740
6142,403301,410202,120,20160,11,"""3""",22740,22860
6143,410202,403300,60,24060,11,"""4""",24060,24120
6143,403300,401402,60,24060,11,"""4""",24120,24180
6143,401402,401902,60,24060,11,"""4""",24180,24240
6143,401902,401503,60,24060,11,"""4""",24240,24300
6143,401503,26502,120,24060,11,"""4""",24300,24420
6143,26502,401302,60,24060,11,"""4""",24420,24480
6143,401302,400800,120,24060,11,"""4""",24480,24600
6143,400800,408901,60,24060,11,"""4""",24600,24660
6143,408901,407501,120,24060,11,"""4""",24660,24780
6143,407501,33604,120,24060,11,"""4""",24780,24900
6143,33604,403902,60,24060,11,"""4""",24900,24960
6143,403902,402402,60,24060,11,"""4""",24960,25020
6143,402402,406803,120,24060,11,"""4""",25020,25140
6143,406803,408002,180,24060,11,"""4""",25140,25320
6143,408002,402502,60,24060,11,"""4""",25320,25380
6143,402502,406603,120,24060,11,"""4""",25380,25500
6143,406603,402302,60,24060,11,"""4""",25500,25560
6143,402302,403104,180,24060,11,"""4""",25560,25740
6143,403104,112103,120,24060,11,"""4""",25740,25860
6143,112103,103003,180,24060,11,"""4""",25860,26040
6143,103003,118002,180,24060,11,"""4""",26040,26220
6143,118002,106002,60,24060,11,"""4""",26220,26280
6143,106002,118102,60,24060,11,"""4""",26280,26340
6143,118102,101003,120,24060,11,"""4""",26340,26460
6143,101003,502202,120,24060,11,"""4""",26460,26580
6143,502202,501002,60,24060,11,"""4""",26580,26640
6143,501002,502102,120,24060,11,"""4""",26640,26760
6143,502102,501302,60,24060,11,"""4""",26760,26820
6143,501302,500406,120,24060,11,"""4""",26820,26940
6143,500406,503203,60,24060,11,"""4""",26940,27000
6143,503203,503502,60,24060,11,"""4""",27000,27060
6143,503502,503403,120,24060,11,"""4""",27060,27180
6143,503403,503300,120,24060,11,"""4""",27180,27300
6143,410202,403300,60,25260,11,"""4""",25260,25320
6143,403300,401402,60,25260,11,"""4""",25320,25380
6143,401402,401902,60,25260,11,"""4""",25380,25440
6143,401902,401503,60,25260,11,"""4""",25440,25500
6143,401503,26502,120,25260,11,"""4""",25500,25620
6143,26502,401302,60,25260,11,"""4""",25620,25680
6143,401302,400800,120,25260,11,"""4""",25680,25800
6143,400800,408901,60,25260,11,"""4""",25800,25860
6143,408901,407501,120,25260,11,"""4""",25860,25980
6143,407501,33604,120,25260,11,"""4""",25980,26100
6143,33604,403902,60,25260,11,"""4""",26100,26160
6143,403902,402402,60,25260,11,"""4""",26160,26220
6143,402402,406803,120,25260,11,"""4""",26220,26340
6143,406803,408002,180,25260,11,"""4""",26340,26520
6143,408002,402502,60,25260,11,"""4""",26520,26580
6143,402502,406603,120,25260,11,"""4""",26580,26700
6143,406603,402302,60,25260,11,"""4""",26700,26760
6143,402302,403104,180,25260,11,"""4""",26760,26940
6143,403104,112103,120,25260,11,"""4""",26940,27060
6143,112103,103003,180,25260,11,"""4""",27060,27240
6143,103003,118002,180,25260,11,"""4""",27240,27420
6143,118002,106002,60,25260,11,"""4""",27420,27480
6143,106002,118102,60,25260,11,"""4""",27480,27540
6143,118102,101003,120,25260,11,"""4""",27540,27660
6143,101003,502202,120,25260,11,"""4""",27660,27780
6143,502202,501002,60,25260,11,"""4""",27780,27840
6143,501002,502102,120,25260,11,"""4""",27840,27960
6143,502102,501302,60,25260,11,"""4""",27960,28020
6143,501302,500406,120,25260,11,"""4""",28020,28140
6143,500406,503203,60,25260,11,"""4""",28140,28200
6143,503203,503502,60,25260,11,"""4""",28200,28260
6143,503502,503403,120,25260,11,"""4""",28260,28380
6143,503403,503300,120,25260,11,"""4""",28380,28500
6143,410202,403300,60,26460,11,"""4""",26460,26520
6143,403300,401402,60,26460,11,"""4""",26520,26580
6143,401402,401902,60,26460,11,"""4""",26580,26640
6143,401902,401503,60,26460,11,"""4""",26640,26700
6143,401503,26502,120,26460,11,"""4""",26700,26820
6143,26502,401302,60,26460,11,"""4""",26820,26880
6143,401302,400800,120,26460,11,"""4""",26880,27000
6143,400800,408901,60,26460,11,"""4""",27000,27060
6143,408901,407501,120,26460,11,"""4""",27060,27180
6143,407501,33604,120,26460,11,"""4""",27180,27300
6143,33604,403902,60,26460,11,"""4""",27300,27360
6143,403902,402402,60,26460,11,"""4""",27360,27420
6143,402402,406803,120,26460,11,"""4""",27420,27540
6143,406803,408002,180,26460,11,"""4""",27540,27720
6143,408002,402502,60,26460,11,"""4""",27720,27780
6143,402502,406603,120,26460,11,"""4""",27780,27900
6143,406603,402302,60,26460,11,"""4""",27900,27960
6143,402302,403104,180,26460,11,"""4""",27960,28140
6143,403104,112103,120,26460,11,"""4""",28140,28260
6143,112103,103003,180,26460,11,"""4""",28260,28440
6143,103003,118002,180,26460,11,"""4""",28440,28620
6143,118002,106002,60,26460,11,"""4""",28620,28680
6143,106002,118102,60,26460,11,"""4""",28680,28740
6143,118102,101003,120,26460,11,"""4""",28740,28860
6143,101003,502202,120,26460,11,"""4""",28860,28980
6143,502202,501002,60,26460,11,"""4""",28980,29040
6143,501002,502102,120,26460,11,"""4""",29040,29160
6143,502102,501302,60,26460,11,"""4""",29160,29220
6143,501302,500406,120,26460,11,"""4""",29220,29340
6143,500406,503203,60,26460,11,"""4""",29340,29400
6143,503203,503502,60,26460,11,"""4""",29400,29460
6143,503502,503403,120,26460,11,"""4""",29460,29580
6143,503403,503300,120,26460,11,"""4""",29580,29700
6143,410202,403300,60,27660,11,"""4""",27660,27720
6143,403300,401402,60,27660,11,"""4""",27720,27780
6143,401402,401902,60,27660,11,"""4""",27780,27840
6143,401902,401503,60,27660,11,"""4""",27840,27900
6143,401503,26502,120,27660,11,"""4""",27900,28020
6143,26502,401302,60,27660,11,"""4""",28020,28080
6143,401302,400800,120,27660,11,"""4""",28080,28200
6143,400800,408901,60,27660,11,"""4""",28200,28260
6143,408901,407501,120,27660,11,"""4""",28260,28380
6143,407501,33604,120,27660,11,"""4""",28380,28500
6143,33604,403902,60,27660,11,"""4""",28500,28560
6143,403902,402402,60,27660,11,"""4""",28560,28620
6143,402402,406803,120,27660,11,"""4""",28620,28740
6143,406803,408002,180,27660,11,"""4""",28740,28920
6143,408002,402502,60,27660,11,"""4""",28920,28980
6143,402502,406603,120,27660,11,"""4""",28980,29100
6143,406603,402302,60,27660,11,"""4""",29100,29160
6143,402302,403104,180,27660,11,"""4""",29160,29340
6143,403104,112103,120,27660,11,"""4""",29340,29460
6143,112103,103003,180,27660,11,"""4""",29460,29640
6143,103003,118002,180,27660,11,"""4""",29640,29820
6143,118002,106002,60,27660,11,"""4""",29820,29880
6143,106002,118102,60,27660,11,"""4""",29880,29940
6143,118102,101003,120,27660,11,"""4""",29940,30060
6143,101003,502202,120,27660,11,"""4""",30060,30180
6143,502202,501002,60,27660,11,"""4""",30180,30240
6143,501002,502102,120,27660,11,"""4""",30240,30360
6143,502102,501302,60,27660,11,"""4""",30360,30420
6143,501302,500406,120,27660,11,"""4""",30420,30540
6143,500406,503203,60,27660,11,"""4""",30540,30600
6143,503203,503502,60,27660,11,"""4""",30600,30660
6143,503502,503403,120,27660,11,"""4""",30660,30780
6143,503403,503300,120,27660,11,"""4""",30780,30900
6143,410202,403300,60,28860,11,"""4""",28860,28920
6143,403300,401402,60,28860,11,"""4""",28920,28980
6143,401402,401902,60,28860,11,"""4""",28980,29040
6143,401902,401503,60,28860,11,"""4""",29040,29100
6143,401503,26502,120,28860,11,"""4""",29100,29220
6143,26502,401302,60,28860,11,"""4""",29220,29280
6143,401302,400800,120,28860,11,"""4""",29280,29400
6143,400800,408901,60,28860,11,"""4""",29400,29460
6143,408901,407501,120,28860,11,"""4""",29460,29580
6143,407501,33604,120,28860,11,"""4""",29580,29700
6143,33604,403902,60,28860,11,"""4""",29700,29760
6143,403902,402402,60,28860,11,"""4""",29760,29820
6143,402402,406803,120,28860,11,"""4""",29820,29940
6143,406803,408002,180,28860,11,"""4""",29940,30120
6143,408002,402502,60,28860,11,"""4""",30120,30180
6143,402502,406603,120,28860,11,"""4""",30180,30300
6143,406603,402302,60,28860,11,"""4""",30300,30360
6143,402302,403104,180,28860,11,"""4""",30360,30540
6143,403104,112103,120,28860,11,"""4""",30540,30660
6143,112103,103003,180,28860,11,"""4""",30660,30840
6143,103003,118002,180,28860,11,"""4""",30840,31020
6143,118002,106002,60,28860,11,"""4""",31020,31080
6143,106002,118102,60,28860,11,"""4""",31080,31140
6143,118102,101003,120,28860,11,"""4""",31140,31260
6143,101003,502202,120,28860,11,"""4""",31260,31380
6143,502202,501002,60,28860,11,"""4""",31380,31440
6143,501002,502102,120,28860,11,"""4""",31440,31560
6143,502102,501302,60,28860,11,"""4""",31560,31620
6143,501302,500406,120,28860,11,"""4""",31620,31740
6143,500406,503203,60,28860,11,"""4""",31740,31800
6143,503203,503502,60,28860,11,"""4""",31800,31860
6143,503502,503403,120,28860,11,"""4""",31860,31980
6143,503403,503300,120,28860,11,"""4""",31980,32100
6143,410202,403300,60,30060,11,"""4""",30060,30120
6143,403300,401402,60,30060,11,"""4""",30120,30180
6143,401402,401902,60,30060,11,"""4""",30180,30240
6143,401902,401503,60,30060,11,"""4""",30240,30300
6143,401503,26502,120,30060,11,"""4""",30300,30420
6143,26502,401302,60,30060,11,"""4""",30420,30480
6143,401302,400800,120,30060,11,"""4""",30480,30600
6143,400800,408901,60,30060,11,"""4""",30600,30660
6143,408901,407501,120,30060,11,"""4""",30660,30780
6143,407501,33604,120,30060,11,"""4""",30780,30900
6143,33604,403902,60,30060,11,"""4""",30900,30960
6143,403902,402402,60,30060,11,"""4""",30960,31020
6143,402402,406803,120,30060,11,"""4""",31020,31140
6143,406803,408002,180,30060,11,"""4""",31140,31320
6143,408002,402502,60,30060,11,"""4""",31320,31380
6143,402502,406603,120,30060,11,"""4""",31380,31500
6143,406603,402302,60,30060,11,"""4""",31500,31560
6143,402302,403104,180,30060,11,"""4""",31560,31740
6143,403104,112103,120,30060,11,"""4""",31740,31860
6143,112103,103003,180,30060,11,"""4""",31860,32040
6143,103003,118002,180,30060,11,"""4""",32040,32220
6143,118002,106002,60,30060,11,"""4""",32220,32280
6143,106002,118102,60,30060,11,"""4""",32280,32340
6143,118102,101003,120,30060,11,"""4""",32340,32460
6143,101003,502202,120,30060,11,"""4""",32460,32580
6143,502202,501002,60,30060,11,"""4""",32580,32640
6143,501002,502102,120,30060,11,"""4""",32640,32760
6143,502102,501302,60,30060,11,"""4""",32760,32820
6143,501302,500406,120,30060,11,"""4""",32820,32940
6143,500406,503203,60,30060,11,"""4""",32940,33000
6143,503203,503502,60,30060,11,"""4""",33000,33060
6143,503502,503403,120,30060,11,"""4""",33060,33180
6143,503403,503300,120,30060,11,"""4""",33180,33300
6143,410202,403300,60,31260,11,"""4""",31260,31320
6143,403300,401402,60,31260,11,"""4""",31320,31380
6143,401402,401902,60,31260,11,"""4""",31380,31440
6143,401902,401503,60,31260,11,"""4""",31440,31500
6143,401503,26502,120,31260,11,"""4""",31500,31620
6143,26502,401302,60,31260,11,"""4""",31620,31680
6143,401302,400800,120,31260,11,"""4""",31680,31800
6143,400800,408901,60,31260,11,"""4""",31800,31860
6143,408901,407501,120,31260,11,"""4""",31860,31980
6143,407501,33604,120,31260,11,"""4""",31980,32100
6143,33604,403902,60,31260,11,"""4""",32100,32160
6143,403902,402402,60,31260,11,"""4""",32160,32220
6143,402402,406803,120,31260,11,"""4""",32220,32340
6143,406803,408002,180,31260,11,"""4""",32340,32520
6143,408002,402502,60,31260,11,"""4""",32520,32580
6143,402502,406603,120,31260,11,"""4""",32580,32700
6143,406603,402302,60,31260,11,"""4""",32700,32760
6143,402302,403104,180,31260,11,"""4""",32760,32940
6143,403104,112103,120,31260,11,"""4""",32940,33060
6143,112103,103003,180,31260,11,"""4""",33060,33240
6143,103003,118002,180,31260,11,"""4""",33240,33420
6143,118002,106002,60,31260,11,"""4""",33420,33480
6143,106002,118102,60,31260,11,"""4""",33480,33540
6143,118102,101003,120,31260,11,"""4""",33540,33660
6143,101003,502202,120,31260,11,"""4""",33660,33780
6143,502202,501002,60,31260,11,"""4""",33780,33840
6143,501002,502102,120,31260,11,"""4""",33840,33960
6143,502102,501302,60,31260,11,"""4""",33960,34020
6143,501302,500406,120,31260,11,"""4""",34020,34140
6143,500406,503203,60,31260,11,"""4""",34140,34200
6143,503203,503502,60,31260,11,"""4""",34200,34260
6143,503502,503403,120,31260,11,"""4""",34260,34380
6143,503403,503300,120,31260,11,"""4""",34380,34500
6143,410202,403300,60,32460,11,"""4""",32460,32520
6143,403300,401402,60,32460,11,"""4""",32520,32580
6143,401402,401902,60,32460,11,"""4""",32580,32640
6143,401902,401503,60,32460,11,"""4""",32640,32700
6143,401503,26502,120,32460,11,"""4""",32700,32820
6143,26502,401302,60,32460,11,"""4""",32820,32880
6143,401302,400800,120,32460,11,"""4""",32880,33000
6143,400800,408901,60,32460,11,"""4""",33000,33060
6143,408901,407501,120,32460,11,"""4""",33060,33180
6143,407501,33604,120,32460,11,"""4""",33180,33300
6143,33604,403902,60,32460,11,"""4""",33300,33360
6143,403902,402402,60,32460,11,"""4""",33360,33420
6143,402402,406803,120,32460,11,"""4""",33420,33540
6143,406803,408002,180,32460,11,"""4""",33540,33720
6143,408002,402502,60,32460,11,"""4""",33720,33780
6143,402502,406603,120,32460,11,"""4""",33780,33900
6143,406603,402302,60,32460,11,"""4""",33900,33960
6143,402302,403104,180,32460,11,"""4""",33960,34140
6143,403104,112103,120,32460,11,"""4""",34140,34260
6143,112103,103003,180,32460,11,"""4""",34260,34440
6143,103003,118002,180,32460,11,"""4""",34440,34620
6143,118002,106002,60,32460,11,"""4""",34620,34680
6143,106002,118102,60,32460,11,"""4""",34680,34740
6143,118102,101003,120,32460,11,"""4""",34740,34860
6143,101003,502202,120,32460,11,"""4""",34860,34980
6143,502202,501002,60,32460,11,"""4""",34980,35040
6143,501002,502102,120,32460,11,"""4""",35040,35160
6143,502102,501302,60,32460,11,"""4""",35160,35220
6143,501302,500406,120,32460,11,"""4""",35220,35340
6143,500406,503203,60,32460,11,"""4""",35340,35400
6143,503203,503502,60,32460,11,"""4""",35400,35460
6143,503502,503403,120,32460,11,"""4""",35460,35580
6143,503403,503300,120,32460,11,"""4""",35580,35700
6143,410202,403300,60,33660,11,"""4""",33660,33720
6143,403300,401402,60,33660,11,"""4""",33720,33780
6143,401402,401902,60,33660,11,"""4""",33780,33840
6143,401902,401503,60,33660,11,"""4""",33840,33900
6143,401503,26502,120,33660,11,"""4""",33900,34020
6143,26502,401302,60,33660,11,"""4""",34020,34080
6143,401302,400800,120,33660,11,"""4""",34080,34200
6143,400800,408901,60,33660,11,"""4""",34200,34260
6143,408901,407501,120,33660,11,"""4""",34260,34380
6143,407501,33604,120,33660,11,"""4""",34380,34500
6143,33604,403902,60,33660,11,"""4""",34500,34560
6143,403902,402402,60,33660,11,"""4""",34560,34620
6143,402402,406803,120,33660,11,"""4""",34620,34740
6143,406803,408002,180,33660,11,"""4""",34740,34920
6143,408002,402502,60,33660,11,"""4""",34920,34980
6143,402502,406603,120,33660,11,"""4""",34980,35100
6143,406603,402302,60,33660,11,"""4""",35100,35160
6143,402302,403104,180,33660,11,"""4""",35160,35340
6143,403104,112103,120,33660,11,"""4""",35340,35460
6143,112103,103003,180,33660,11,"""4""",35460,35640
6143,103003,118002,180,33660,11,"""4""",35640,35820
6143,118002,106002,60,33660,11,"""4""",35820,35880
6143,106002,118102,60,33660,11,"""4""",35880,35940
6143,118102,101003,120,33660,11,"""4""",35940,36060
6143,101003,502202,120,33660,11,"""4""",36060,36180
6143,502202,501002,60,33660,11,"""4""",36180,36240
6143,501002,502102,120,33660,11,"""4""",36240,36360
6143,502102,501302,60,33660,11,"""4""",36360,36420
6143,501302,500406,120,33660,11,"""4""",36420,36540
6143,500406,503203,60,33660,11,"""4""",36540,36600
6143,503203,503502,60,33660,11,"""4""",36600,36660
6143,503502,503403,120,33660,11,"""4""",36660,36780
6143,503403,503300,120,33660,11,"""4""",36780,36900
6143,410202,403300,60,34860,11,"""4""",34860,34920
6143,403300,401402,60,34860,11,"""4""",34920,34980
6143,401402,401902,60,34860,11,"""4""",34980,35040
6143,401902,401503,60,34860,11,"""4""",35040,35100
6143,401503,26502,120,34860,11,"""4""",35100,35220
6143,26502,401302,60,34860,11,"""4""",35220,35280
6143,401302,400800,120,34860,11,"""4""",35280,35400
6143,400800,408901,60,34860,11,"""4""",35400,35460
6143,408901,407501,120,34860,11,"""4""",35460,35580
6143,407501,33604,120,34860,11,"""4""",35580,35700
6143,33604,403902,60,34860,11,"""4""",35700,35760
6143,403902,402402,60,34860,11,"""4""",35760,35820
6143,402402,406803,120,34860,11,"""4""",35820,35940
6143,406803,408002,180,34860,11,"""4""",35940,36120
6143,408002,402502,60,34860,11,"""4""",36120,36180
6143,402502,406603,120,34860,11,"""4""",36180,36300
6143,406603,402302,60,34860,11,"""4""",36300,36360
6143,402302,403104,180,34860,11,"""4""",36360,36540
6143,403104,112103,120,34860,11,"""4""",36540,36660
6143,112103,103003,180,34860,11,"""4""",36660,36840
6143,103003,118002,180,34860,11,"""4""",36840,37020
6143,118002,106002,60,34860,11,"""4""",37020,37080
6143,106002,118102,60,34860,11,"""4""",37080,37140
6143,118102,101003,120,34860,11,"""4""",37140,37260
6143,101003,502202,120,34860,11,"""4""",37260,37380
6143,502202,501002,60,34860,11,"""4""",37380,37440
6143,501002,502102,120,34860,11,"""4""",37440,37560
6143,502102,501302,60,34860,11,"""4""",37560,37620
6143,501302,500406,120,34860,11,"""4""",37620,37740
6143,500406,503203,60,34860,11,"""4""",37740,37800
6143,503203,503502,60,34860,11,"""4""",37800,37860
6143,503502,503403,120,34860,11,"""4""",37860,37980
6143,503403,503300,120,34860,11,"""4""",37980,38100
6143,410202,403300,60,36060,11,"""4""",36060,36120
6143,403300,401402,60,36060,11,"""4""",36120,36180
6143,401402,401902,60,36060,11,"""4""",36180,36240
6143,401902,401503,60,36060,11,"""4""",36240,36300
6143,401503,26502,120,36060,11,"""4""",36300,36420
6143,26502,401302,60,36060,11,"""4""",36420,36480
6143,401302,400800,120,36060,11,"""4""",36480,36600
6143,400800,408901,60,36060,11,"""4""",36600,36660
6143,408901,407501,120,36060,11,"""4""",36660,36780
6143,407501,33604,120,36060,11,"""4""",36780,36900
6143,33604,403902,60,36060,11,"""4""",36900,36960
6143,403902,402402,60,36060,11,"""4""",36960,37020
6143,402402,406803,120,36060,11,"""4""",37020,37140
6143,406803,408002,180,36060,11,"""4""",37140,37320
6143,408002,402502,60,36060,11,"""4""",37320,37380
6143,402502,406603,120,36060,11,"""4""",37380,37500
6143,406603,402302,60,36060,11,"""4""",37500,37560
6143,402302,403104,180,36060,11,"""4""",37560,37740
6143,403104,112103,120,36060,11,"""4""",37740,37860
6143,112103,103003,180,36060,11,"""4""",37860,38040
6143,103003,118002,180,36060,11,"""4""",38040,38220
6143,118002,106002,60,36060,11,"""4""",38220,38280
6143,106002,118102,60,36060,11,"""4""",38280,38340
6143,118102,101003,120,36060,11,"""4""",38340,38460
6143,101003,502202,120,36060,11,"""4""",38460,38580
6143,502202,501002,60,36060,11,"""4""",38580,38640
6143,501002,502102,120,36060,11,"""4""",38640,38760
6143,502102,501302,60,36060,11,"""4""",38760,38820
6143,501302,500406,120,36060,11,"""4""",38820,38940
6143,500406,503203,60,36060,11,"""4""",38940,39000
6143,503203,503502,60,36060,11,"""4""",39000,39060
6143,503502,503403,120,36060,11,"""4""",39060,39180
6143,503403,503300,120,36060,11,"""4""",39180,39300
6143,410202,403300,60,37260,11,"""4""",37260,37320
6143,403300,401402,60,37260,11,"""4""",37320,37380
6143,401402,401902,60,37260,11,"""4""",37380,37440
6143,401902,401503,60,37260,11,"""4""",37440,37500
6143,401503,26502,120,37260,11,"""4""",37500,37620
6143,26502,401302,60,37260,11,"""4""",37620,37680
6143,401302,400800,120,37260,11,"""4""",37680,37800
6143,400800,408901,60,37260,11,"""4""",37800,37860
6143,408901,407501,120,37260,11,"""4""",37860,37980
6143,407501,33604,120,37260,11,"""4""",37980,38100
6143,33604,403902,60,37260,11,"""4""",38100,38160
6143,403902,402402,60,37260,11,"""4""",38160,38220
6143,402402,406803,120,37260,11,"""4""",38220,38340
6143,406803,408002,180,37260,11,"""4""",38340,38520
6143,408002,402502,60,37260,11,"""4""",38520,38580
6143,402502,406603,120,37260,11,"""4""",38580,38700
6143,406603,402302,60,37260,11,"""4""",38700,38760
6143,402302,403104,180,37260,11,"""4""",38760,38940
6143,403104,112103,120,37260,11,"""4""",38940,39060
6143,112103,103003,180,37260,11,"""4""",39060,39240
6143,103003,118002,180,37260,11,"""4""",39240,39420
6143,118002,106002,60,37260,11,"""4""",39420,39480
6143,106002,118102,60,37260,11,"""4""",39480,39540
6143,118102,101003,120,37260,11,"""4""",39540,39660
6143,101003,502202,120,37260,11,"""4""",39660,39780
6143,502202,501002,60,37260,11,"""4""",39780,39840
6143,501002,502102,120,37260,11,"""4""",39840,39960
6143,502102,501302,60,37260,11,"""4""",39960,40020
6143,501302,500406,120,37260,11,"""4""",40020,40140
6143,500406,503203,60,37260,11,"""4""",40140,40200
6143,503203,503502,60,37260,11,"""4""",40200,40260
6143,503502,503403,120,37260,11,"""4""",40260,40380
6143,503403,503300,120,37260,11,"""4""",40380,40500
6143,410202,403300,60,38460,11,"""4""",38460,38520
6143,403300,401402,60,38460,11,"""4""",38520,38580
6143,401402,401902,60,38460,11,"""4""",38580,38640
6143,401902,401503,60,38460,11,"""4""",38640,38700
6143,401503,26502,120,38460,11,"""4""",38700,38820
6143,26502,401302,60,38460,11,"""4""",38820,38880
6143,401302,400800,120,38460,11,"""4""",38880,39000
6143,400800,408901,60,38460,11,"""4""",39000,39060
6143,408901,407501,120,38460,11,"""4""",39060,39180
6143,407501,33604,120,38460,11,"""4""",39180,39300
6143,33604,403902,60,38460,11,"""4""",39300,39360
6143,403902,402402,60,38460,11,"""4""",39360,39420
6143,402402,406803,120,38460,11,"""4""",39420,39540
6143,406803,408002,180,38460,11,"""4""",39540,39720
6143,408002,402502,60,38460,11,"""4""",39720,39780
6143,402502,406603,120,38460,11,"""4""",39780,39900
6143,406603,402302,60,38460,11,"""4""",39900,39960
6143,402302,403104,180,38460,11,"""4""",39960,40140
6143,403104,112103,120,38460,11,"""4""",40140,40260
6143,112103,103003,180,38460,11,"""4""",40260,40440
6143,103003,118002,180,38460,11,"""4""",40440,40620
6143,118002,106002,60,38460,11,"""4""",40620,40680
6143,106002,118102,60,38460,11,"""4""",40680,40740
6143,118102,101003,120,38460,11,"""4""",40740,40860
6143,101003,502202,120,38460,11,"""4""",40860,40980
6143,502202,501002,60,38460,11,"""4""",40980,41040
6143,501002,502102,120,38460,11,"""4""",41040,41160
6143,502102,501302,60,38460,11,"""4""",41160,41220
6143,501302,500406,120,38460,11,"""4""",41220,41340
6143,500406,503203,60,38460,11,"""4""",41340,41400
6143,503203,503502,60,38460,11,"""4""",41400,41460
6143,503502,503403,120,38460,11,"""4""",41460,41580
6143,503403,503300,120,38460,11,"""4""",41580,41700
6143,410202,403300,60,39660,11,"""4""",39660,39720
6143,403300,401402,60,39660,11,"""4""",39720,39780
6143,401402,401902,60,39660,11,"""4""",39780,39840
6143,401902,401503,60,39660,11,"""4""",39840,39900
6143,401503,26502,120,39660,11,"""4""",39900,40020
6143,26502,401302,60,39660,11,"""4""",40020,40080
6143,401302,400800,120,39660,11,"""4""",40080,40200
6143,400800,408901,60,39660,11,"""4""",40200,40260
6143,408901,407501,120,39660,11,"""4""",40260,40380
6143,407501,33604,120,39660,11,"""4""",40380,40500
6143,33604,403902,60,39660,11,"""4""",40500,40560
6143,403902,402402,60,39660,11,"""4""",40560,40620
6143,402402,406803,120,39660,11,"""4""",40620,40740
6143,406803,408002,180,39660,11,"""4""",40740,40920
6143,408002,402502,60,39660,11,"""4""",40920,40980
6143,402502,406603,120,39660,11,"""4""",40980,41100
6143,406603,402302,60,39660,11,"""4""",41100,41160
6143,402302,403104,180,39660,11,"""4""",41160,41340
6143,403104,112103,120,39660,11,"""4""",41340,41460
6143,112103,103003,180,39660,11,"""4""",41460,41640
6143,103003,118002,180,39660,11,"""4""",41640,41820
6143,118002,106002,60,39660,11,"""4""",41820,41880
6143,106002,118102,60,39660,11,"""4""",41880,41940
6143,118102,101003,120,39660,11,"""4""",41940,42060
6143,101003,502202,120,39660,11,"""4""",42060,42180
6143,502202,501002,60,39660,11,"""4""",42180,42240
6143,501002,502102,120,39660,11,"""4""",42240,42360
6143,502102,501302,60,39660,11,"""4""",42360,42420
6143,501302,500406,120,39660,11,"""4""",42420,42540
6143,500406,503203,60,39660,11,"""4""",42540,42600
6143,503203,503502,60,39660,11,"""4""",42600,42660
6143,503502,503403,120,39660,11,"""4""",42660,42780
6143,503403,503300,120,39660,11,"""4""",42780,42900
6143,410202,403300,60,40860,11,"""4""",40860,40920
6143,403300,401402,60,40860,11,"""4""",40920,40980
6143,401402,401902,60,40860,11,"""4""",40980,41040
6143,401902,401503,60,40860,11,"""4""",41040,41100
6143,401503,26502,120,40860,11,"""4""",41100,41220
6143,26502,401302,60,40860,11,"""4""",41220,41280
6143,401302,400800,120,40860,11,"""4""",41280,41400
6143,400800,408901,60,40860,11,"""4""",41400,41460
6143,408901,407501,120,40860,11,"""4""",41460,41580
6143,407501,33604,120,40860,11,"""4""",41580,41700
6143,33604,403902,60,40860,11,"""4""",41700,41760
6143,403902,402402,60,40860,11,"""4""",41760,41820
6143,402402,406803,120,40860,11,"""4""",41820,41940
6143,406803,408002,180,40860,11,"""4""",41940,42120
6143,408002,402502,60,40860,11,"""4""",42120,42180
6143,402502,406603,120,40860,11,"""4""",42180,42300
6143,406603,402302,60,40860,11,"""4""",42300,42360
6143,402302,403104,180,40860,11,"""4""",42360,42540
6143,403104,112103,120,40860,11,"""4""",42540,42660
6143,112103,103003,180,40860,11,"""4""",42660,42840
6143,103003,118002,180,40860,11,"""4""",42840,43020
6143,118002,106002,60,40860,11,"""4""",43020,43080
6143,106002,118102,60,40860,11,"""4""",43080,43140
6143,118102,101003,120,40860,11,"""4""",43140,43260
6143,101003,502202,120,40860,11,"""4""",43260,43380
6143,502202,501002,60,40860,11,"""4""",43380,43440
6143,501002,502102,120,40860,11,"""4""",43440,43560
6143,502102,501302,60,40860,11,"""4""",43560,43620
6143,501302,500406,120,40860,11,"""4""",43620,43740
6143,500406,503203,60,40860,11,"""4""",43740,43800
6143,503203,503502,60,40860,11,"""4""",43800,43860
6143,503502,503403,120,40860,11,"""4""",43860,43980
6143,503403,503300,120,40860,11,"""4""",43980,44100
6143,410202,403300,60,42060,11,"""4""",42060,42120
6143,403300,401402,60,42060,11,"""4""",42120,42180
6143,401402,401902,60,42060,11,"""4""",42180,42240
6143,401902,401503,60,42060,11,"""4""",42240,42300
6143,401503,26502,120,42060,11,"""4""",42300,42420
6143,26502,401302,60,42060,11,"""4""",42420,42480
6143,401302,400800,120,42060,11,"""4""",42480,42600
6143,400800,408901,60,42060,11,"""4""",42600,42660
6143,408901,407501,120,42060,11,"""4""",42660,42780
6143,407501,33604,120,42060,11,"""4""",42780,42900
6143,33604,403902,60,42060,11,"""4""",42900,42960
6143,403902,402402,60,42060,11,"""4""",42960,43020
6143,402402,406803,120,42060,11,"""4""",43020,43140
6143,406803,408002,180,42060,11,"""4""",43140,43320
6143,408002,402502,60,42060,11,"""4""",43320,43380
6143,402502,406603,120,42060,11,"""4""",43380,43500
6143,406603,402302,60,42060,11,"""4""",43500,43560
6143,402302,403104,180,42060,11,"""4""",43560,43740
6143,403104,112103,120,42060,11,"""4""",43740,43860
6143,112103,103003,180,42060,11,"""4""",43860,44040
6143,103003,118002,180,42060,11,"""4""",44040,44220
6143,118002,106002,60,42060,11,"""4""",44220,44280
6143,106002,118102,60,42060,11,"""4""",44280,44340
6143,118102,101003,120,42060,11,"""4""",44340,44460
6143,101003,502202,120,42060,11,"""4""",44460,44580
6143,502202,501002,60,42060,11,"""4""",44580,44640
6143,501002,502102,120,42060,11,"""4""",44640,44760
6143,502102,501302,60,42060,11,"""4""",44760,44820
6143,501302,500406,120,42060,11,"""4""",44820,44940
6143,500406,503203,60,42060,11,"""4""",44940,45000
6143,503203,503502,60,42060,11,"""4""",45000,45060
6143,503502,503403,120,42060,11,"""4""",45060,45180
6143,503403,503300,120,42060,11,"""4""",45180,45300
6143,410202,403300,60,43260,11,"""4""",43260,43320
6143,403300,401402,60,43260,11,"""4""",43320,43380
6143,401402,401902,60,43260,11,"""4""",43380,43440
6143,401902,401503,60,43260,11,"""4""",43440,43500
6143,401503,26502,120,43260,11,"""4""",43500,43620
6143,26502,401302,60,43260,11,"""4""",43620,43680
6143,401302,400800,120,43260,11,"""4""",43680,43800
6143,400800,408901,60,43260,11,"""4""",43800,43860
6143,408901,407501,120,43260,11,"""4""",43860,43980
6143,407501,33604,120,43260,11,"""4""",43980,44100
6143,33604,403902,60,43260,11,"""4""",44100,44160
6143,403902,402402,60,43260,11,"""4""",44160,44220
6143,402402,406803,120,43260,11,"""4""",44220,44340
6143,406803,408002,180,43260,11,"""4""",44340,44520
6143,408002,402502,60,43260,11,"""4""",44520,44580
6143,402502,406603,120,43260,11,"""4""",44580,44700
6143,406603,402302,60,43260,11,"""4""",44700,44760
6143,402302,403104,180,43260,11,"""4""",44760,44940
6143,403104,112103,120,43260,11,"""4""",44940,45060
6143,112103,103003,180,43260,11,"""4""",45060,45240
6143,103003,118002,180,43260,11,"""4""",45240,45420
6143,118002,106002,60,43260,11,"""4""",45420,45480
6143,106002,118102,60,43260,11,"""4""",45480,45540
6143,118102,101003,120,43260,11,"""4""",45540,45660
6143,101003,502202,120,43260,11,"""4""",45660,45780
6143,502202,501002,60,43260,11,"""4""",45780,45840
6143,501002,502102,120,43260,11,"""4""",45840,45960
6143,502102,501302,60,43260,11,"""4""",45960,46020
6143,501302,500406,120,43260,11,"""4""",46020,46140
6143,500406,503203,60,43260,11,"""4""",46140,46200
6143,503203,503502,60,43260,11,"""4""",46200,46260
6143,503502,503403,120,43260,11,"""4""",46260,46380
6143,503403,503300,120,43260,11,"""4""",46380,46500
6143,410202,403300,60,44460,11,"""4""",44460,44520
6143,403300,401402,60,44460,11,"""4""",44520,44580
6143,401402,401902,60,44460,11,"""4""",44580,44640
6143,401902,401503,60,44460,11,"""4""",44640,44700
6143,401503,26502,120,44460,11,"""4""",44700,44820
6143,26502,401302,60,44460,11,"""4""",44820,44880
6143,401302,400800,120,44460,11,"""4""",44880,45000
6143,400800,408901,60,44460,11,"""4""",45000,45060
6143,408901,407501,120,44460,11,"""4""",45060,45180
6143,407501,33604,120,44460,11,"""4""",45180,45300
6143,33604,403902,60,44460,11,"""4""",45300,45360
6143,403902,402402,60,44460,11,"""4""",45360,45420
6143,402402,406803,120,44460,11,"""4""",45420,45540
6143,406803,408002,180,44460,11,"""4""",45540,45720
6143,408002,402502,60,44460,11,"""4""",45720,45780
6143,402502,406603,120,44460,11,"""4""",45780,45900
6143,406603,402302,60,44460,11,"""4""",45900,45960
6143,402302,403104,180,44460,11,"""4""",45960,46140
6143,403104,112103,120,44460,11,"""4""",46140,46260
6143,112103,103003,180,44460,11,"""4""",46260,46440
6143,103003,118002,180,44460,11,"""4""",46440,46620
6143,118002,106002,60,44460,11,"""4""",46620,46680
6143,106002,118102,60,44460,11,"""4""",46680,46740
6143,118102,101003,120,44460,11,"""4""",46740,46860
6143,101003,502202,120,44460,11,"""4""",46860,46980
6143,502202,501002,60,44460,11,"""4""",46980,47040
6143,501002,502102,120,44460,11,"""4""",47040,47160
6143,502102,501302,60,44460,11,"""4""",47160,47220
6143,501302,500406,120,44460,11,"""4""",47220,47340
6143,500406,503203,60,44460,11,"""4""",47340,47400
6143,503203,503502,60,44460,11,"""4""",47400,47460
6143,503502,503403,120,44460,11,"""4""",47460,47580
6143,503403,503300,120,44460,11,"""4""",47580,47700
6143,410202,403300,60,45660,11,"""4""",45660,45720
6143,403300,401402,60,45660,11,"""4""",45720,45780
6143,401402,401902,60,45660,11,"""4""",45780,45840
6143,401902,401503,60,45660,11,"""4""",45840,45900
6143,401503,26502,120,45660,11,"""4""",45900,46020
6143,26502,401302,60,45660,11,"""4""",46020,46080
6143,401302,400800,120,45660,11,"""4""",46080,46200
6143,400800,408901,60,45660,11,"""4""",46200,46260
6143,408901,407501,120,45660,11,"""4""",46260,46380
6143,407501,33604,120,45660,11,"""4""",46380,46500
6143,33604,403902,60,45660,11,"""4""",46500,46560
6143,403902,402402,60,45660,11,"""4""",46560,46620
6143,402402,406803,120,45660,11,"""4""",46620,46740
6143,406803,408002,180,45660,11,"""4""",46740,46920
6143,408002,402502,60,45660,11,"""4""",46920,46980
6143,402502,406603,120,45660,11,"""4""",46980,47100
6143,406603,402302,60,45660,11,"""4""",47100,47160
6143,402302,403104,180,45660,11,"""4""",47160,47340
6143,403104,112103,120,45660,11,"""4""",47340,47460
6143,112103,103003,180,45660,11,"""4""",47460,47640
6143,103003,118002,180,45660,11,"""4""",47640,47820
6143,118002,106002,60,45660,11,"""4""",47820,47880
6143,106002,118102,60,45660,11,"""4""",47880,47940
6143,118102,101003,120,45660,11,"""4""",47940,48060
6143,101003,502202,120,45660,11,"""4""",48060,48180
6143,502202,501002,60,45660,11,"""4""",48180,48240
6143,501002,502102,120,45660,11,"""4""",48240,48360
6143,502102,501302,60,45660,11,"""4""",48360,48420
6143,501302,500406,120,45660,11,"""4""",48420,48540
6143,500406,503203,60,45660,11,"""4""",48540,48600
6143,503203,503502,60,45660,11,"""4""",48600,48660
6143,503502,503403,120,45660,11,"""4""",48660,48780
6143,503403,503300,120,45660,11,"""4""",48780,48900
6143,410202,403300,60,46860,11,"""4""",46860,46920
6143,403300,401402,60,46860,11,"""4""",46920,46980
6143,401402,401902,60,46860,11,"""4""",46980,47040
6143,401902,401503,60,46860,11,"""4""",47040,47100
6143,401503,26502,120,46860,11,"""4""",47100,47220
6143,26502,401302,60,46860,11,"""4""",47220,47280
6143,401302,400800,120,46860,11,"""4""",47280,47400
6143,400800,408901,60,46860,11,"""4""",47400,47460
6143,408901,407501,120,46860,11,"""4""",47460,47580
6143,407501,33604,120,46860,11,"""4""",47580,47700
6143,33604,403902,60,46860,11,"""4""",47700,47760
6143,403902,402402,60,46860,11,"""4""",47760,47820
6143,402402,406803,120,46860,11,"""4""",47820,47940
6143,406803,408002,180,46860,11,"""4""",47940,48120
6143,408002,402502,60,46860,11,"""4""",48120,48180
6143,402502,406603,120,46860,11,"""4""",48180,48300
6143,406603,402302,60,46860,11,"""4""",48300,48360
6143,402302,403104,180,46860,11,"""4""",48360,48540
6143,403104,112103,120,46860,11,"""4""",48540,48660
6143,112103,103003,180,46860,11,"""4""",48660,48840
6143,103003,118002,180,46860,11,"""4""",48840,49020
6143,118002,106002,60,46860,11,"""4""",49020,49080
6143,106002,118102,60,46860,11,"""4""",49080,49140
6143,118102,101003,120,46860,11,"""4""",49140,49260
6143,101003,502202,120,46860,11,"""4""",49260,49380
6143,502202,501002,60,46860,11,"""4""",49380,49440
6143,501002,502102,120,46860,11,"""4""",49440,49560
6143,502102,501302,60,46860,11,"""4""",49560,49620
6143,501302,500406,120,46860,11,"""4""",49620,49740
6143,500406,503203,60,46860,11,"""4""",49740,49800
6143,503203,503502,60,46860,11,"""4""",49800,49860
6143,503502,503403,120,46860,11,"""4""",49860,49980
6143,503403,503300,120,46860,11,"""4""",49980,50100
6143,410202,403300,60,48060,11,"""4""",48060,48120
6143,403300,401402,60,48060,11,"""4""",48120,48180
6143,401402,401902,60,48060,11,"""4""",48180,48240
6143,401902,401503,60,48060,11,"""4""",48240,48300
6143,401503,26502,120,48060,11,"""4""",48300,48420
6143,26502,401302,60,48060,11,"""4""",48420,48480
6143,401302,400800,120,48060,11,"""4""",48480,48600
6143,400800,408901,60,48060,11,"""4""",48600,48660
6143,408901,407501,120,48060,11,"""4""",48660,48780
6143,407501,33604,120,48060,11,"""4""",48780,48900
6143,33604,403902,60,48060,11,"""4""",48900,48960
6143,403902,402402,60,48060,11,"""4""",48960,49020
6143,402402,406803,120,48060,11,"""4""",49020,49140
6143,406803,408002,180,48060,11,"""4""",49140,49320
6143,408002,402502,60,48060,11,"""4""",49320,49380
6143,402502,406603,120,48060,11,"""4""",49380,49500
6143,406603,402302,60,48060,11,"""4""",49500,49560
6143,402302,403104,180,48060,11,"""4""",49560,49740
6143,403104,112103,120,48060,11,"""4""",49740,49860
6143,112103,103003,180,48060,11,"""4""",49860,50040
6143,103003,118002,180,48060,11,"""4""",50040,50220
6143,118002,106002,60,48060,11,"""4""",50220,50280
6143,106002,118102,60,48060,11,"""4""",50280,50340
6143,118102,101003,120,48060,11,"""4""",50340,50460
6143,101003,502202,120,48060,11,"""4""",50460,50580
6143,502202,501002,60,48060,11,"""4""",50580,50640
6143,501002,502102,120,48060,11,"""4""",50640,50760
6143,502102,501302,60,48060,11,"""4""",50760,50820
6143,501302,500406,120,48060,11,"""4""",50820,50940
6143,500406,503203,60,48060,11,"""4""",50940,51000
6143,503203,503502,60,48060,11,"""4""",51000,51060
6143,503502,503403,120,48060,11,"""4""",51060,51180
6143,503403,503300,120,48060,11,"""4""",51180,51300
6143,410202,403300,60,49260,11,"""4""",49260,49320
6143,403300,401402,60,49260,11,"""4""",49320,49380
6143,401402,401902,60,49260,11,"""4""",49380,49440
6143,401902,401503,60,49260,11,"""4""",49440,49500
6143,401503,26502,120,49260,11,"""4""",49500,49620
6143,26502,401302,60,49260,11,"""4""",49620,49680
6143,401302,400800,120,49260,11,"""4""",49680,49800
6143,400800,408901,60,49260,11,"""4""",49800,49860
6143,408901,407501,120,49260,11,"""4""",49860,49980
6143,407501,33604,120,49260,11,"""4""",49980,50100
6143,33604,403902,60,49260,11,"""4""",50100,50160
6143,403902,402402,60,49260,11,"""4""",50160,50220
6143,402402,406803,120,49260,11,"""4""",50220,50340
6143,406803,408002,180,49260,11,"""4""",50340,50520
6143,408002,402502,60,49260,11,"""4""",50520,50580
6143,402502,406603,120,49260,11,"""4""",50580,50700
6143,406603,402302,60,49260,11,"""4""",50700,50760
6143,402302,403104,180,49260,11,"""4""",50760,50940
6143,403104,112103,120,49260,11,"""4""",50940,51060
6143,112103,103003,180,49260,11,"""4""",51060,51240
6143,103003,118002,180,49260,11,"""4""",51240,51420
6143,118002,106002,60,49260,11,"""4""",51420,51480
6143,106002,118102,60,49260,11,"""4""",51480,51540
6143,118102,101003,120,49260,11,"""4""",51540,51660
6143,101003,502202,120,49260,11,"""4""",51660,51780
6143,502202,501002,60,49260,11,"""4""",51780,51840
6143,501002,502102,120,49260,11,"""4""",51840,51960
6143,502102,501302,60,49260,11,"""4""",51960,52020
6143,501302,500406,120,49260,11,"""4""",52020,52140
6143,500406,503203,60,49260,11,"""4""",52140,52200
6143,503203,503502,60,49260,11,"""4""",52200,52260
6143,503502,503403,120,49260,11,"""4""",52260,52380
6143,503403,503300,120,49260,11,"""4""",52380,52500
6143,410202,403300,60,50460,11,"""4""",50460,50520
6143,403300,401402,60,50460,11,"""4""",50520,50580
6143,401402,401902,60,50460,11,"""4""",50580,50640
6143,401902,401503,60,50460,11,"""4""",50640,50700
6143,401503,26502,120,50460,11,"""4""",50700,50820
6143,26502,401302,60,50460,11,"""4""",50820,50880
6143,401302,400800,120,50460,11,"""4""",50880,51000
6143,400800,408901,60,50460,11,"""4""",51000,51060
6143,408901,407501,120,50460,11,"""4""",51060,51180
6143,407501,33604,120,50460,11,"""4""",51180,51300
6143,33604,403902,60,50460,11,"""4""",51300,51360
6143,403902,402402,60,50460,11,"""4""",51360,51420
6143,402402,406803,120,50460,11,"""4""",51420,51540
6143,406803,408002,180,50460,11,"""4""",51540,51720
6143,408002,402502,60,50460,11,"""4""",51720,51780
6143,402502,406603,120,50460,11,"""4""",51780,51900
6143,406603,402302,60,50460,11,"""4""",51900,51960
6143,402302,403104,180,50460,11,"""4""",51960,52140
6143,403104,112103,120,50460,11,"""4""",52140,52260
6143,112103,103003,180,50460,11,"""4""",52260,52440
6143,103003,118002,180,50460,11,"""4""",52440,52620
6143,118002,106002,60,50460,11,"""4""",52620,52680
6143,106002,118102,60,50460,11,"""4""",52680,52740
6143,118102,101003,120,50460,11,"""4""",52740,52860
6143,101003,502202,120,50460,11,"""4""",52860,52980
6143,502202,501002,60,50460,11,"""4""",52980,53040
6143,501002,502102,120,50460,11,"""4""",53040,53160
6143,502102,501302,60,50460,11,"""4""",53160,53220
6143,501302,500406,120,50460,11,"""4""",53220,53340
6143,500406,503203,60,50460,11,"""4""",53340,53400
6143,503203,503502,60,50460,11,"""4""",53400,53460
6143,503502,503403,120,50460,11,"""4""",53460,53580
6143,503403,503300,120,50460,11,"""4""",53580,53700
6143,410202,403300,60,51660,11,"""4""",51660,51720
6143,403300,401402,60,51660,11,"""4""",51720,51780
6143,401402,401902,60,51660,11,"""4""",51780,51840
6143,401902,401503,60,51660,11,"""4""",51840,51900
6143,401503,26502,120,51660,11,"""4""",51900,52020
6143,26502,401302,60,51660,11,"""4""",52020,52080
6143,401302,400800,120,51660,11,"""4""",52080,52200
6143,400800,408901,60,51660,11,"""4""",52200,52260
6143,408901,407501,120,51660,11,"""4""",52260,52380
6143,407501,33604,120,51660,11,"""4""",52380,52500
6143,33604,403902,60,51660,11,"""4""",52500,52560
6143,403902,402402,60,51660,11,"""4""",52560,52620
6143,402402,406803,120,51660,11,"""4""",52620,52740
6143,406803,408002,180,51660,11,"""4""",52740,52920
6143,408002,402502,60,51660,11,"""4""",52920,52980
6143,402502,406603,120,51660,11,"""4""",52980,53100
6143,406603,402302,60,51660,11,"""4""",53100,53160
6143,402302,403104,180,51660,11,"""4""",53160,53340
6143,403104,112103,120,51660,11,"""4""",53340,53460
6143,112103,103003,180,51660,11,"""4""",53460,53640
6143,103003,118002,180,51660,11,"""4""",53640,53820
6143,118002,106002,60,51660,11,"""4""",53820,53880
6143,106002,118102,60,51660,11,"""4""",53880,53940
6143,118102,101003,120,51660,11,"""4""",53940,54060
6143,101003,502202,120,51660,11,"""4""",54060,54180
6143,502202,501002,60,51660,11,"""4""",54180,54240
6143,501002,502102,120,51660,11,"""4""",54240,54360
6143,502102,501302,60,51660,11,"""4""",54360,54420
6143,501302,500406,120,51660,11,"""4""",54420,54540
6143,500406,503203,60,51660,11,"""4""",54540,54600
6143,503203,503502,60,51660,11,"""4""",54600,54660
6143,503502,503403,120,51660,11,"""4""",54660,54780
6143,503403,503300,120,51660,11,"""4""",54780,54900
6143,410202,403300,60,52860,11,"""4""",52860,52920
6143,403300,401402,60,52860,11,"""4""",52920,52980
6143,401402,401902,60,52860,11,"""4""",52980,53040
6143,401902,401503,60,52860,11,"""4""",53040,53100
6143,401503,26502,120,52860,11,"""4""",53100,53220
6143,26502,401302,60,52860,11,"""4""",53220,53280
6143,401302,400800,120,52860,11,"""4""",53280,53400
6143,400800,408901,60,52860,11,"""4""",53400,53460
6143,408901,407501,120,52860,11,"""4""",53460,53580
6143,407501,33604,120,52860,11,"""4""",53580,53700
6143,33604,403902,60,52860,11,"""4""",53700,53760
6143,403902,402402,60,52860,11,"""4""",53760,53820
6143,402402,406803,120,52860,11,"""4""",53820,53940
6143,406803,408002,180,52860,11,"""4""",53940,54120
6143,408002,402502,60,52860,11,"""4""",54120,54180
6143,402502,406603,120,52860,11,"""4""",54180,54300
6143,406603,402302,60,52860,11,"""4""",54300,54360
6143,402302,403104,180,52860,11,"""4""",54360,54540
6143,403104,112103,120,52860,11,"""4""",54540,54660
6143,112103,103003,180,52860,11,"""4""",54660,54840
6143,103003,118002,180,52860,11,"""4""",54840,55020
6143,118002,106002,60,52860,11,"""4""",55020,55080
6143,106002,118102,60,52860,11,"""4""",55080,55140
6143,118102,101003,120,52860,11,"""4""",55140,55260
6143,101003,502202,120,52860,11,"""4""",55260,55380
6143,502202,501002,60,52860,11,"""4""",55380,55440
6143,501002,502102,120,52860,11,"""4""",55440,55560
6143,502102,501302,60,52860,11,"""4""",55560,55620
6143,501302,500406,120,52860,11,"""4""",55620,55740
6143,500406,503203,60,52860,11,"""4""",55740,55800
6143,503203,503502,60,52860,11,"""4""",55800,55860
6143,503502,503403,120,52860,11,"""4""",55860,55980
6143,503403,503300,120,52860,11,"""4""",55980,56100
6143,410202,403300,60,54060,11,"""4""",54060,54120
6143,403300,401402,60,54060,11,"""4""",54120,54180
6143,401402,401902,60,54060,11,"""4""",54180,54240
6143,401902,401503,60,54060,11,"""4""",54240,54300
6143,401503,26502,120,54060,11,"""4""",54300,54420
6143,26502,401302,60,54060,11,"""4""",54420,54480
6143,401302,400800,120,54060,11,"""4""",54480,54600
6143,400800,408901,60,54060,11,"""4""",54600,54660
6143,408901,407501,120,54060,11,"""4""",54660,54780
6143,407501,33604,120,54060,11,"""4""",54780,54900
6143,33604,403902,60,54060,11,"""4""",54900,54960
6143,403902,402402,60,54060,11,"""4""",54960,55020
6143,402402,406803,120,54060,11,"""4""",55020,55140
6143,406803,408002,180,54060,11,"""4""",55140,55320
6143,408002,402502,60,54060,11,"""4""",55320,55380
6143,402502,406603,120,54060,11,"""4""",55380,55500
6143,406603,402302,60,54060,11,"""4""",55500,55560
6143,402302,403104,180,54060,11,"""4""",55560,55740
6143,403104,112103,120,54060,11,"""4""",55740,55860
6143,112103,103003,180,54060,11,"""4""",55860,56040
6143,103003,118002,180,54060,11,"""4""",56040,56220
6143,118002,106002,60,54060,11,"""4""",56220,56280
6143,106002,118102,60,54060,11,"""4""",56280,56340
6143,118102,101003,120,54060,11,"""4""",56340,56460
6143,101003,502202,120,54060,11,"""4""",56460,56580
6143,502202,501002,60,54060,11,"""4""",56580,56640
6143,501002,502102,120,54060,11,"""4""",56640,56760
6143,502102,501302,60,54060,11,"""4""",56760,56820
6143,501302,500406,120,54060,11,"""4""",56820,56940
6143,500406,503203,60,54060,11,"""4""",56940,57000
6143,503203,503502,60,54060,11,"""4""",57000,57060
6143,503502,503403,120,54060,11,"""4""",57060,57180
6143,503403,503300,120,54060,11,"""4""",57180,57300
6143,410202,403300,60,55260,11,"""4""",55260,55320
6143,403300,401402,60,55260,11,"""4""",55320,55380
6143,401402,401902,60,55260,11,"""4""",55380,55440
6143,401902,401503,60,55260,11,"""4""",55440,55500
6143,401503,26502,120,55260,11,"""4""",55500,55620
6143,26502,401302,60,55260,11,"""4""",55620,55680
6143,401302,400800,120,55260,11,"""4""",55680,55800
6143,400800,408901,60,55260,11,"""4""",55800,55860
6143,408901,407501,120,55260,11,"""4""",55860,55980
6143,407501,33604,120,55260,11,"""4""",55980,56100
6143,33604,403902,60,55260,11,"""4""",56100,56160
6143,403902,402402,60,55260,11,"""4""",56160,56220
6143,402402,406803,120,55260,11,"""4""",56220,56340
6143,406803,408002,180,55260,11,"""4""",56340,56520
6143,408002,402502,60,55260,11,"""4""",56520,56580
6143,402502,406603,120,55260,11,"""4""",56580,56700
6143,406603,402302,60,55260,11,"""4""",56700,56760
6143,402302,403104,180,55260,11,"""4""",56760,56940
6143,403104,112103,120,55260,11,"""4""",56940,57060
6143,112103,103003,180,55260,11,"""4""",57060,57240
6143,103003,118002,180,55260,11,"""4""",57240,57420
6143,118002,106002,60,55260,11,"""4""",57420,57480
6143,106002,118102,60,55260,11,"""4""",57480,57540
6143,118102,101003,120,55260,11,"""4""",57540,57660
6143,101003,502202,120,55260,11,"""4""",57660,57780
6143,502202,501002,60,55260,11,"""4""",57780,57840
6143,501002,502102,120,55260,11,"""4""",57840,57960
6143,502102,501302,60,55260,11,"""4""",57960,58020
6143,501302,500406,120,55260,11,"""4""",58020,58140
6143,500406,503203,60,55260,11,"""4""",58140,58200
6143,503203,503502,60,55260,11,"""4""",58200,58260
6143,503502,503403,120,55260,11,"""4""",58260,58380
6143,503403,503300,120,55260,11,"""4""",58380,58500
6143,410202,403300,60,56460,11,"""4""",56460,56520
6143,403300,401402,60,56460,11,"""4""",56520,56580
6143,401402,401902,60,56460,11,"""4""",56580,56640
6143,401902,401503,60,56460,11,"""4""",56640,56700
6143,401503,26502,120,56460,11,"""4""",56700,56820
6143,26502,401302,60,56460,11,"""4""",56820,56880
6143,401302,400800,120,56460,11,"""4""",56880,57000
6143,400800,408901,60,56460,11,"""4""",57000,57060
6143,408901,407501,120,56460,11,"""4""",57060,57180
6143,407501,33604,120,56460,11,"""4""",57180,57300
6143,33604,403902,60,56460,11,"""4""",57300,57360
6143,403902,402402,60,56460,11,"""4""",57360,57420
6143,402402,406803,120,56460,11,"""4""",57420,57540
6143,406803,408002,180,56460,11,"""4""",57540,57720
6143,408002,402502,60,56460,11,"""4""",57720,57780
6143,402502,406603,120,56460,11,"""4""",57780,57900
6143,406603,402302,60,56460,11,"""4""",57900,57960
6143,402302,403104,180,56460,11,"""4""",57960,58140
6143,403104,112103,120,56460,11,"""4""",58140,58260
6143,112103,103003,180,56460,11,"""4""",58260,58440
6143,103003,118002,180,56460,11,"""4""",58440,58620
6143,118002,106002,60,56460,11,"""4""",58620,58680
6143,106002,118102,60,56460,11,"""4""",58680,58740
6143,118102,101003,120,56460,11,"""4""",58740,58860
6143,101003,502202,120,56460,11,"""4""",58860,58980
6143,502202,501002,60,56460,11,"""4""",58980,59040
6143,501002,502102,120,56460,11,"""4""",59040,59160
6143,502102,501302,60,56460,11,"""4""",59160,59220
6143,501302,500406,120,56460,11,"""4""",59220,59340
6143,500406,503203,60,56460,11,"""4""",59340,59400
6143,503203,503502,60,56460,11,"""4""",59400,59460
6143,503502,503403,120,56460,11,"""4""",59460,59580
6143,503403,503300,120,56460,11,"""4""",59580,59700
6143,410202,403300,60,57660,11,"""4""",57660,57720
6143,403300,401402,60,57660,11,"""4""",57720,57780
6143,401402,401902,60,57660,11,"""4""",57780,57840
6143,401902,401503,60,57660,11,"""4""",57840,57900
6143,401503,26502,120,57660,11,"""4""",57900,58020
6143,26502,401302,60,57660,11,"""4""",58020,58080
6143,401302,400800,120,57660,11,"""4""",58080,58200
6143,400800,408901,60,57660,11,"""4""",58200,58260
6143,408901,407501,120,57660,11,"""4""",58260,58380
6143,407501,33604,120,57660,11,"""4""",58380,58500
6143,33604,403902,60,57660,11,"""4""",58500,58560
6143,403902,402402,60,57660,11,"""4""",58560,58620
6143,402402,406803,120,57660,11,"""4""",58620,58740
6143,406803,408002,180,57660,11,"""4""",58740,58920
6143,408002,402502,60,57660,11,"""4""",58920,58980
6143,402502,406603,120,57660,11,"""4""",58980,59100
6143,406603,402302,60,57660,11,"""4""",59100,59160
6143,402302,403104,180,57660,11,"""4""",59160,59340
6143,403104,112103,120,57660,11,"""4""",59340,59460
6143,112103,103003,180,57660,11,"""4""",59460,59640
6143,103003,118002,180,57660,11,"""4""",59640,59820
6143,118002,106002,60,57660,11,"""4""",59820,59880
6143,106002,118102,60,57660,11,"""4""",59880,59940
6143,118102,101003,120,57660,11,"""4""",59940,60060
6143,101003,502202,120,57660,11,"""4""",60060,60180
6143,502202,501002,60,57660,11,"""4""",60180,60240
6143,501002,502102,120,57660,11,"""4""",60240,60360
6143,502102,501302,60,57660,11,"""4""",60360,60420
6143,501302,500406,120,57660,11,"""4""",60420,60540
6143,500406,503203,60,57660,11,"""4""",60540,60600
6143,503203,503502,60,57660,11,"""4""",60600,60660
6143,503502,503403,120,57660,11,"""4""",60660,60780
6143,503403,503300,120,57660,11,"""4""",60780,60900
6143,410202,403300,60,58860,11,"""4""",58860,58920
6143,403300,401402,60,58860,11,"""4""",58920,58980
6143,401402,401902,60,58860,11,"""4""",58980,59040
6143,401902,401503,60,58860,11,"""4""",59040,59100
6143,401503,26502,120,58860,11,"""4""",59100,59220
6143,26502,401302,60,58860,11,"""4""",59220,59280
6143,401302,400800,120,58860,11,"""4""",59280,59400
6143,400800,408901,60,58860,11,"""4""",59400,59460
6143,408901,407501,120,58860,11,"""4""",59460,59580
6143,407501,33604,120,58860,11,"""4""",59580,59700
6143,33604,403902,60,58860,11,"""4""",59700,59760
6143,403902,402402,60,58860,11,"""4""",59760,59820
6143,402402,406803,120,58860,11,"""4""",59820,59940
6143,406803,408002,180,58860,11,"""4""",59940,60120
6143,408002,402502,60,58860,11,"""4""",60120,60180
6143,402502,406603,120,58860,11,"""4""",60180,60300
6143,406603,402302,60,58860,11,"""4""",60300,60360
6143,402302,403104,180,58860,11,"""4""",60360,60540
6143,403104,112103,120,58860,11,"""4""",60540,60660
6143,112103,103003,180,58860,11,"""4""",60660,60840
6143,103003,118002,180,58860,11,"""4""",60840,61020
6143,118002,106002,60,58860,11,"""4""",61020,61080
6143,106002,118102,60,58860,11,"""4""",61080,61140
6143,118102,101003,120,58860,11,"""4""",61140,61260
6143,101003,502202,120,58860,11,"""4""",61260,61380
6143,502202,501002,60,58860,11,"""4""",61380,61440
6143,501002,502102,120,58860,11,"""4""",61440,61560
6143,502102,501302,60,58860,11,"""4""",61560,61620
6143,501302,500406,120,58860,11,"""4""",61620,61740
6143,500406,503203,60,58860,11,"""4""",61740,61800
6143,503203,503502,60,58860,11,"""4""",61800,61860
6143,503502,503403,120,58860,11,"""4""",61860,61980
6143,503403,503300,120,58860,11,"""4""",61980,62100
6143,410202,403300,60,60060,11,"""4""",60060,60120
6143,403300,401402,60,60060,11,"""4""",60120,60180
6143,401402,401902,60,60060,11,"""4""",60180,60240
6143,401902,401503,60,60060,11,"""4""",60240,60300
6143,401503,26502,120,60060,11,"""4""",60300,60420
6143,26502,401302,60,60060,11,"""4""",60420,60480
6143,401302,400800,120,60060,11,"""4""",60480,60600
6143,400800,408901,60,60060,11,"""4""",60600,60660
6143,408901,407501,120,60060,11,"""4""",60660,60780
6143,407501,33604,120,60060,11,"""4""",60780,60900
6143,33604,403902,60,60060,11,"""4""",60900,60960
6143,403902,402402,60,60060,11,"""4""",60960,61020
6143,402402,406803,120,60060,11,"""4""",61020,61140
6143,406803,408002,180,60060,11,"""4""",61140,61320
6143,408002,402502,60,60060,11,"""4""",61320,61380
6143,402502,406603,120,60060,11,"""4""",61380,61500
6143,406603,402302,60,60060,11,"""4""",61500,61560
6143,402302,403104,180,60060,11,"""4""",61560,61740
6143,403104,112103,120,60060,11,"""4""",61740,61860
6143,112103,103003,180,60060,11,"""4""",61860,62040
6143,103003,118002,180,60060,11,"""4""",62040,62220
6143,118002,106002,60,60060,11,"""4""",62220,62280
6143,106002,118102,60,60060,11,"""4""",62280,62340
6143,118102,101003,120,60060,11,"""4""",62340,62460
6143,101003,502202,120,60060,11,"""4""",62460,62580
6143,502202,501002,60,60060,11,"""4""",62580,62640
6143,501002,502102,120,60060,11,"""4""",62640,62760
6143,502102,501302,60,60060,11,"""4""",62760,62820
6143,501302,500406,120,60060,11,"""4""",62820,62940
6143,500406,503203,60,60060,11,"""4""",62940,63000
6143,503203,503502,60,60060,11,"""4""",63000,63060
6143,503502,503403,120,60060,11,"""4""",63060,63180
6143,503403,503300,120,60060,11,"""4""",63180,63300
6143,410202,403300,60,61260,11,"""4""",61260,61320
6143,403300,401402,60,61260,11,"""4""",61320,61380
6143,401402,401902,60,61260,11,"""4""",61380,61440
6143,401902,401503,60,61260,11,"""4""",61440,61500
6143,401503,26502,120,61260,11,"""4""",61500,61620
6143,26502,401302,60,61260,11,"""4""",61620,61680
6143,401302,400800,120,61260,11,"""4""",61680,61800
6143,400800,408901,60,61260,11,"""4""",61800,61860
6143,408901,407501,120,61260,11,"""4""",61860,61980
6143,407501,33604,120,61260,11,"""4""",61980,62100
6143,33604,403902,60,61260,11,"""4""",62100,62160
6143,403902,402402,60,61260,11,"""4""",62160,62220
6143,402402,406803,120,61260,11,"""4""",62220,62340
6143,406803,408002,180,61260,11,"""4""",62340,62520
6143,408002,402502,60,61260,11,"""4""",62520,62580
6143,402502,406603,120,61260,11,"""4""",62580,62700
6143,406603,402302,60,61260,11,"""4""",62700,62760
6143,402302,403104,180,61260,11,"""4""",62760,62940
6143,403104,112103,120,61260,11,"""4""",62940,63060
6143,112103,103003,180,61260,11,"""4""",63060,63240
6143,103003,118002,180,61260,11,"""4""",63240,63420
6143,118002,106002,60,61260,11,"""4""",63420,63480
6143,106002,118102,60,61260,11,"""4""",63480,63540
6143,118102,101003,120,61260,11,"""4""",63540,63660
6143,101003,502202,120,61260,11,"""4""",63660,63780
6143,502202,501002,60,61260,11,"""4""",63780,63840
6143,501002,502102,120,61260,11,"""4""",63840,63960
6143,502102,501302,60,61260,11,"""4""",63960,64020
6143,501302,500406,120,61260,11,"""4""",64020,64140
6143,500406,503203,60,61260,11,"""4""",64140,64200
6143,503203,503502,60,61260,11,"""4""",64200,64260
6143,503502,503403,120,61260,11,"""4""",64260,64380
6143,503403,503300,120,61260,11,"""4""",64380,64500
6143,410202,403300,60,62460,11,"""4""",62460,62520
6143,403300,401402,60,62460,11,"""4""",62520,62580
6143,401402,401902,60,62460,11,"""4""",62580,62640
6143,401902,401503,60,62460,11,"""4""",62640,62700
6143,401503,26502,120,62460,11,"""4""",62700,62820
6143,26502,401302,60,62460,11,"""4""",62820,62880
6143,401302,400800,120,62460,11,"""4""",62880,63000
6143,400800,408901,60,62460,11,"""4""",63000,63060
6143,408901,407501,120,62460,11,"""4""",63060,63180
6143,407501,33604,120,62460,11,"""4""",63180,63300
6143,33604,403902,60,62460,11,"""4""",63300,63360
6143,403902,402402,60,62460,11,"""4""",63360,63420
6143,402402,406803,120,62460,11,"""4""",63420,63540
6143,406803,408002,180,62460,11,"""4""",63540,63720
6143,408002,402502,60,62460,11,"""4""",63720,63780
6143,402502,406603,120,62460,11,"""4""",63780,63900
6143,406603,402302,60,62460,11,"""4""",63900,63960
6143,402302,403104,180,62460,11,"""4""",63960,64140
6143,403104,112103,120,62460,11,"""4""",64140,64260
6143,112103,103003,180,62460,11,"""4""",64260,64440
6143,103003,118002,180,62460,11,"""4""",64440,64620
6143,118002,106002,60,62460,11,"""4""",64620,64680
6143,106002,118102,60,62460,11,"""4""",64680,64740
6143,118102,101003,120,62460,11,"""4""",64740,64860
6143,101003,502202,120,62460,11,"""4""",64860,64980
6143,502202,501002,60,62460,11,"""4""",64980,65040
6143,501002,502102,120,62460,11,"""4""",65040,65160
6143,502102,501302,60,62460,11,"""4""",65160,65220
6143,501302,500406,120,62460,11,"""4""",65220,65340
6143,500406,503203,60,62460,11,"""4""",65340,65400
6143,503203,503502,60,62460,11,"""4""",65400,65460
6143,503502,503403,120,62460,11,"""4""",65460,65580
6143,503403,503300,120,62460,11,"""4""",65580,65700
6143,410202,403300,60,63660,11,"""4""",63660,63720
6143,403300,401402,60,63660,11,"""4""",63720,63780
6143,401402,401902,60,63660,11,"""4""",63780,63840
6143,401902,401503,60,63660,11,"""4""",63840,63900
6143,401503,26502,120,63660,11,"""4""",63900,64020
6143,26502,401302,60,63660,11,"""4""",64020,64080
6143,401302,400800,120,63660,11,"""4""",64080,64200
6143,400800,408901,60,63660,11,"""4""",64200,64260
6143,408901,407501,120,63660,11,"""4""",64260,64380
6143,407501,33604,120,63660,11,"""4""",64380,64500
6143,33604,403902,60,63660,11,"""4""",64500,64560
6143,403902,402402,60,63660,11,"""4""",64560,64620
6143,402402,406803,120,63660,11,"""4""",64620,64740
6143,406803,408002,180,63660,11,"""4""",64740,64920
6143,408002,402502,60,63660,11,"""4""",64920,64980
6143,402502,406603,120,63660,11,"""4""",64980,65100
6143,406603,402302,60,63660,11,"""4""",65100,65160
6143,402302,403104,180,63660,11,"""4""",65160,65340
6143,403104,112103,120,63660,11,"""4""",65340,65460
6143,112103,103003,180,63660,11,"""4""",65460,65640
6143,103003,118002,180,63660,11,"""4""",65640,65820
6143,118002,106002,60,63660,11,"""4""",65820,65880
6143,106002,118102,60,63660,11,"""4""",65880,65940
6143,118102,101003,120,63660,11,"""4""",65940,66060
6143,101003,502202,120,63660,11,"""4""",66060,66180
6143,502202,501002,60,63660,11,"""4""",66180,66240
6143,501002,502102,120,63660,11,"""4""",66240,66360
6143,502102,501302,60,63660,11,"""4""",66360,66420
6143,501302,500406,120,63660,11,"""4""",66420,66540
6143,500406,503203,60,63660,11,"""4""",66540,66600
6143,503203,503502,60,63660,11,"""4""",66600,66660
6143,503502,503403,120,63660,11,"""4""",66660,66780
6143,503403,503300,120,63660,11,"""4""",66780,66900
6143,410202,403300,60,64860,11,"""4""",64860,64920
6143,403300,401402,60,64860,11,"""4""",64920,64980
6143,401402,401902,60,64860,11,"""4""",64980,65040
6143,401902,401503,60,64860,11,"""4""",65040,65100
6143,401503,26502,120,64860,11,"""4""",65100,65220
6143,26502,401302,60,64860,11,"""4""",65220,65280
6143,401302,400800,120,64860,11,"""4""",65280,65400
6143,400800,408901,60,64860,11,"""4""",65400,65460
6143,408901,407501,120,64860,11,"""4""",65460,65580
6143,407501,33604,120,64860,11,"""4""",65580,65700
6143,33604,403902,60,64860,11,"""4""",65700,65760
6143,403902,402402,60,64860,11,"""4""",65760,65820
6143,402402,406803,120,64860,11,"""4""",65820,65940
6143,406803,408002,180,64860,11,"""4""",65940,66120
6143,408002,402502,60,64860,11,"""4""",66120,66180
6143,402502,406603,120,64860,11,"""4""",66180,66300
6143,406603,402302,60,64860,11,"""4""",66300,66360
6143,402302,403104,180,64860,11,"""4""",66360,66540
6143,403104,112103,120,64860,11,"""4""",66540,66660
6143,112103,103003,180,64860,11,"""4""",66660,66840
6143,103003,118002,180,64860,11,"""4""",66840,67020
6143,118002,106002,60,64860,11,"""4""",67020,67080
6143,106002,118102,60,64860,11,"""4""",67080,67140
6143,118102,101003,120,64860,11,"""4""",67140,67260
6143,101003,502202,120,64860,11,"""4""",67260,67380
6143,502202,501002,60,64860,11,"""4""",67380,67440
6143,501002,502102,120,64860,11,"""4""",67440,67560
6143,502102,501302,60,64860,11,"""4""",67560,67620
6143,501302,500406,120,64860,11,"""4""",67620,67740
6143,500406,503203,60,64860,11,"""4""",67740,67800
6143,503203,503502,60,64860,11,"""4""",67800,67860
6143,503502,503403,120,64860,11,"""4""",67860,67980
6143,503403,503300,120,64860,11,"""4""",67980,68100
6143,410202,403300,60,66060,11,"""4""",66060,66120
6143,403300,401402,60,66060,11,"""4""",66120,66180
6143,401402,401902,60,66060,11,"""4""",66180,66240
6143,401902,401503,60,66060,11,"""4""",66240,66300
6143,401503,26502,120,66060,11,"""4""",66300,66420
6143,26502,401302,60,66060,11,"""4""",66420,66480
6143,401302,400800,120,66060,11,"""4""",66480,66600
6143,400800,408901,60,66060,11,"""4""",66600,66660
6143,408901,407501,120,66060,11,"""4""",66660,66780
6143,407501,33604,120,66060,11,"""4""",66780,66900
6143,33604,403902,60,66060,11,"""4""",66900,66960
6143,403902,402402,60,66060,11,"""4""",66960,67020
6143,402402,406803,120,66060,11,"""4""",67020,67140
6143,406803,408002,180,66060,11,"""4""",67140,67320
6143,408002,402502,60,66060,11,"""4""",67320,67380
6143,402502,406603,120,66060,11,"""4""",67380,67500
6143,406603,402302,60,66060,11,"""4""",67500,67560
6143,402302,403104,180,66060,11,"""4""",67560,67740
6143,403104,112103,120,66060,11,"""4""",67740,67860
6143,112103,103003,180,66060,11,"""4""",67860,68040
6143,103003,118002,180,66060,11,"""4""",68040,68220
6143,118002,106002,60,66060,11,"""4""",68220,68280
6143,106002,118102,60,66060,11,"""4""",68280,68340
6143,118102,101003,120,66060,11,"""4""",68340,68460
6143,101003,502202,120,66060,11,"""4""",68460,68580
6143,502202,501002,60,66060,11,"""4""",68580,68640
6143,501002,502102,120,66060,11,"""4""",68640,68760
6143,502102,501302,60,66060,11,"""4""",68760,68820
6143,501302,500406,120,66060,11,"""4""",68820,68940
6143,500406,503203,60,66060,11,"""4""",68940,69000
6143,503203,503502,60,66060,11,"""4""",69000,69060
6143,503502,503403,120,66060,11,"""4""",69060,69180
6143,503403,503300,120,66060,11,"""4""",69180,69300
6143,410202,403300,60,67380,11,"""4""",67380,67440
6143,403300,401402,60,67380,11,"""4""",67440,67500
6143,401402,401902,60,67380,11,"""4""",67500,67560
6143,401902,401503,60,67380,11,"""4""",67560,67620
6143,401503,26502,120,67380,11,"""4""",67620,67740
6143,26502,401302,60,67380,11,"""4""",67740,67800
6143,401302,400800,120,67380,11,"""4""",67800,67920
6143,400800,408901,60,67380,11,"""4""",67920,67980
6143,408901,407501,120,67380,11,"""4""",67980,68100
6143,407501,33604,120,67380,11,"""4""",68100,68220
6143,33604,403902,60,67380,11,"""4""",68220,68280
6143,403902,402402,60,67380,11,"""4""",68280,68340
6143,402402,406803,120,67380,11,"""4""",68340,68460
6143,406803,408002,180,67380,11,"""4""",68460,68640
6143,408002,402502,60,67380,11,"""4""",68640,68700
6143,402502,406603,120,67380,11,"""4""",68700,68820
6143,406603,402302,60,67380,11,"""4""",68820,68880
6143,402302,403104,180,67380,11,"""4""",68880,69060
6143,403104,112103,120,67380,11,"""4""",69060,69180
6143,112103,103003,180,67380,11,"""4""",69180,69360
6143,103003,118002,180,67380,11,"""4""",69360,69540
6143,118002,106002,60,67380,11,"""4""",69540,69600
6143,106002,118102,60,67380,11,"""4""",69600,69660
6143,118102,101003,120,67380,11,"""4""",69660,69780
6143,101003,502202,120,67380,11,"""4""",69780,69900
6143,502202,501002,60,67380,11,"""4""",69900,69960
6143,501002,502102,120,67380,11,"""4""",69960,70080
6143,502102,501302,60,67380,11,"""4""",70080,70140
6143,501302,500406,120,67380,11,"""4""",70140,70260
6143,500406,503203,60,67380,11,"""4""",70260,70320
6143,503203,503502,60,67380,11,"""4""",70320,70380
6143,503502,503403,120,67380,11,"""4""",70380,70500
6143,503403,503300,120,67380,11,"""4""",70500,70620
6143,410202,403300,60,69180,11,"""4""",69180,69240
6143,403300,401402,60,69180,11,"""4""",69240,69300
6143,401402,401902,60,69180,11,"""4""",69300,69360
6143,401902,401503,60,69180,11,"""4""",69360,69420
6143,401503,26502,120,69180,11,"""4""",69420,69540
6143,26502,401302,60,69180,11,"""4""",69540,69600
6143,401302,400800,120,69180,11,"""4""",69600,69720
6143,400800,408901,60,69180,11,"""4""",69720,69780
6143,408901,407501,120,69180,11,"""4""",69780,69900
6143,407501,33604,120,69180,11,"""4""",69900,70020
6143,33604,403902,60,69180,11,"""4""",70020,70080
6143,403902,402402,60,69180,11,"""4""",70080,70140
6143,402402,406803,120,69180,11,"""4""",70140,70260
6143,406803,408002,180,69180,11,"""4""",70260,70440
6143,408002,402502,60,69180,11,"""4""",70440,70500
6143,402502,406603,120,69180,11,"""4""",70500,70620
6143,406603,402302,60,69180,11,"""4""",70620,70680
6143,402302,403104,180,69180,11,"""4""",70680,70860
6143,403104,112103,120,69180,11,"""4""",70860,70980
6143,112103,103003,180,69180,11,"""4""",70980,71160
6143,103003,118002,180,69180,11,"""4""",71160,71340
6143,118002,106002,60,69180,11,"""4""",71340,71400
6143,106002,118102,60,69180,11,"""4""",71400,71460
6143,118102,101003,120,69180,11,"""4""",71460,71580
6143,101003,502202,120,69180,11,"""4""",71580,71700
6143,502202,501002,60,69180,11,"""4""",71700,71760
6143,501002,502102,120,69180,11,"""4""",71760,71880
6143,502102,501302,60,69180,11,"""4""",71880,71940
6143,501302,500406,120,69180,11,"""4""",71940,72060
6143,500406,503203,60,69180,11,"""4""",72060,72120
6143,503203,503502,60,69180,11,"""4""",72120,72180
6143,503502,503403,120,69180,11,"""4""",72180,72300
6143,503403,503300,120,69180,11,"""4""",72300,72420
6144,410202,403300,60,71040,11,"""4""",71040,71100
6144,403300,401402,60,71040,11,"""4""",71100,71160
6144,401402,401902,60,71040,11,"""4""",71160,71220
6144,401902,401503,60,71040,11,"""4""",71220,71280
6144,401503,26502,120,71040,11,"""4""",71280,71400
6144,26502,401302,60,71040,11,"""4""",71400,71460
6144,401302,400800,120,71040,11,"""4""",71460,71580
6144,400800,408901,60,71040,11,"""4""",71580,71640
6144,408901,407501,120,71040,11,"""4""",71640,71760
6144,407501,33604,120,71040,11,"""4""",71760,71880
6144,33604,403902,60,71040,11,"""4""",71880,71940
6144,403902,402402,60,71040,11,"""4""",71940,72000
6144,402402,406803,120,71040,11,"""4""",72000,72120
6144,406803,408002,180,71040,11,"""4""",72120,72300
6144,408002,402502,60,71040,11,"""4""",72300,72360
6144,402502,406603,60,71040,11,"""4""",72360,72420
6144,406603,402302,60,71040,11,"""4""",72420,72480
6144,402302,403104,120,71040,11,"""4""",72480,72600
6144,403104,112103,120,71040,11,"""4""",72600,72720
6144,112103,103003,180,71040,11,"""4""",72720,72900
6144,103003,118002,120,71040,11,"""4""",72900,73020
6144,118002,106002,60,71040,11,"""4""",73020,73080
6144,106002,118102,60,71040,11,"""4""",73080,73140
6144,118102,101003,120,71040,11,"""4""",73140,73260
6144,101003,502202,120,71040,11,"""4""",73260,73380
6144,502202,501002,60,71040,11,"""4""",73380,73440
6144,501002,502102,60,71040,11,"""4""",73440,73500
6144,502102,501302,60,71040,11,"""4""",73500,73560
6144,501302,500406,120,71040,11,"""4""",73560,73680
6144,500406,503203,60,71040,11,"""4""",73680,73740
6144,503203,503502,60,71040,11,"""4""",73740,73800
6144,503502,503403,120,71040,11,"""4""",73800,73920
6144,503403,503300,120,71040,11,"""4""",73920,74040
6144,410202,403300,60,72840,11,"""4""",72840,72900
6144,403300,401402,60,72840,11,"""4""",72900,72960
6144,401402,401902,60,72840,11,"""4""",72960,73020
6144,401902,401503,60,72840,11,"""4""",73020,73080
6144,401503,26502,120,72840,11,"""4""",73080,73200
6144,26502,401302,60,72840,11,"""4""",73200,73260
6144,401302,400800,120,72840,11,"""4""",73260,73380
6144,400800,408901,60,72840,11,"""4""",73380,73440
6144,408901,407501,120,72840,11,"""4""",73440,73560
6144,407501,33604,120,72840,11,"""4""",73560,73680
6144,33604,403902,60,72840,11,"""4""",73680,73740
6144,403902,402402,60,72840,11,"""4""",73740,73800
6144,402402,406803,120,72840,11,"""4""",73800,73920
6144,406803,408002,180,72840,11,"""4""",73920,74100
6144,408002,402502,60,72840,11,"""4""",74100,74160
6144,402502,406603,60,72840,11,"""4""",74160,74220
6144,406603,402302,60,72840,11,"""4""",74220,74280
6144,402302,403104,120,72840,11,"""4""",74280,74400
6144,403104,112103,120,72840,11,"""4""",74400,74520
6144,112103,103003,180,72840,11,"""4""",74520,74700
6144,103003,118002,120,72840,11,"""4""",74700,74820
6144,118002,106002,60,72840,11,"""4""",74820,74880
6144,106002,118102,60,72840,11,"""4""",74880,74940
6144,118102,101003,120,72840,11,"""4""",74940,75060
6144,101003,502202,120,72840,11,"""4""",75060,75180
6144,502202,501002,60,72840,11,"""4""",75180,75240
6144,501002,502102,60,72840,11,"""4""",75240,75300
6144,502102,501302,60,72840,11,"""4""",75300,75360
6144,501302,500406,120,72840,11,"""4""",75360,75480
6144,500406,503203,60,72840,11,"""4""",75480,75540
6144,503203,503502,60,72840,11,"""4""",75540,75600
6144,503502,503403,120,72840,11,"""4""",75600,75720
6144,503403,503300,120,72840,11,"""4""",75720,75840
6144,410202,403300,60,74640,11,"""4""",74640,74700
6144,403300,401402,60,74640,11,"""4""",74700,74760
6144,401402,401902,60,74640,11,"""4""",74760,74820
6144,401902,401503,60,74640,11,"""4""",74820,74880
6144,401503,26502,120,74640,11,"""4""",74880,75000
6144,26502,401302,60,74640,11,"""4""",75000,75060
6144,401302,400800,120,74640,11,"""4""",75060,75180
6144,400800,408901,60,74640,11,"""4""",75180,75240
6144,408901,407501,120,74640,11,"""4""",75240,75360
6144,407501,33604,120,74640,11,"""4""",75360,75480
6144,33604,403902,60,74640,11,"""4""",75480,75540
6144,403902,402402,60,74640,11,"""4""",75540,75600
6144,402402,406803,120,74640,11,"""4""",75600,75720
6144,406803,408002,180,74640,11,"""4""",75720,75900
6144,408002,402502,60,74640,11,"""4""",75900,75960
6144,402502,406603,60,74640,11,"""4""",75960,76020
6144,406603,402302,60,74640,11,"""4""",76020,76080
6144,402302,403104,120,74640,11,"""4""",76080,76200
6144,403104,112103,120,74640,11,"""4""",76200,76320
6144,112103,103003,180,74640,11,"""4""",76320,76500
6144,103003,118002,120,74640,11,"""4""",76500,76620
6144,118002,106002,60,74640,11,"""4""",76620,76680
6144,106002,118102,60,74640,11,"""4""",76680,76740
6144,118102,101003,120,74640,11,"""4""",76740,76860
6144,101003,502202,120,74640,11,"""4""",76860,76980
6144,502202,501002,60,74640,11,"""4""",76980,77040
6144,501002,502102,60,74640,11,"""4""",77040,77100
6144,502102,501302,60,74640,11,"""4""",77100,77160
6144,501302,500406,120,74640,11,"""4""",77160,77280
6144,500406,503203,60,74640,11,"""4""",77280,77340
6144,503203,503502,60,74640,11,"""4""",77340,77400
6144,503502,503403,120,74640,11,"""4""",77400,77520
6144,503403,503300,120,74640,11,"""4""",77520,77640
6144,410202,403300,60,76440,11,"""4""",76440,76500
6144,403300,401402,60,76440,11,"""4""",76500,76560
6144,401402,401902,60,76440,11,"""4""",76560,76620
6144,401902,401503,60,76440,11,"""4""",76620,76680
6144,401503,26502,120,76440,11,"""4""",76680,76800
6144,26502,401302,60,76440,11,"""4""",76800,76860
6144,401302,400800,120,76440,11,"""4""",76860,76980
6144,400800,408901,60,76440,11,"""4""",76980,77040
6144,408901,407501,120,76440,11,"""4""",77040,77160
6144,407501,33604,120,76440,11,"""4""",77160,77280
6144,33604,403902,60,76440,11,"""4""",77280,77340
6144,403902,402402,60,76440,11,"""4""",77340,77400
6144,402402,406803,120,76440,11,"""4""",77400,77520
6144,406803,408002,180,76440,11,"""4""",77520,77700
6144,408002,402502,60,76440,11,"""4""",77700,77760
6144,402502,406603,60,76440,11,"""4""",77760,77820
6144,406603,402302,60,76440,11,"""4""",77820,77880
6144,402302,403104,120,76440,11,"""4""",77880,78000
6144,403104,112103,120,76440,11,"""4""",78000,78120
6144,112103,103003,180,76440,11,"""4""",78120,78300
6144,103003,118002,120,76440,11,"""4""",78300,78420
6144,118002,106002,60,76440,11,"""4""",78420,78480
6144,106002,118102,60,76440,11,"""4""",78480,78540
6144,118102,101003,120,76440,11,"""4""",78540,78660
6144,101003,502202,120,76440,11,"""4""",78660,78780
6144,502202,501002,60,76440,11,"""4""",78780,78840
6144,501002,502102,60,76440,11,"""4""",78840,78900
6144,502102,501302,60,76440,11,"""4""",78900,78960
6144,501302,500406,120,76440,11,"""4""",78960,79080
6144,500406,503203,60,76440,11,"""4""",79080,79140
6144,503203,503502,60,76440,11,"""4""",79140,79200
6144,503502,503403,120,76440,11,"""4""",79200,79320
6144,503403,503300,120,76440,11,"""4""",79320,79440
6144,410202,403300,60,78240,11,"""4""",78240,78300
6144,403300,401402,60,78240,11,"""4""",78300,78360
6144,401402,401902,60,78240,11,"""4""",78360,78420
6144,401902,401503,60,78240,11,"""4""",78420,78480
6144,401503,26502,120,78240,11,"""4""",78480,78600
6144,26502,401302,60,78240,11,"""4""",78600,78660
6144,401302,400800,120,78240,11,"""4""",78660,78780
6144,400800,408901,60,78240,11,"""4""",78780,78840
6144,408901,407501,120,78240,11,"""4""",78840,78960
6144,407501,33604,120,78240,11,"""4""",78960,79080
6144,33604,403902,60,78240,11,"""4""",79080,79140
6144,403902,402402,60,78240,11,"""4""",79140,79200
6144,402402,406803,120,78240,11,"""4""",79200,79320
6144,406803,408002,180,78240,11,"""4""",79320,79500
6144,408002,402502,60,78240,11,"""4""",79500,79560
6144,402502,406603,60,78240,11,"""4""",79560,79620
6144,406603,402302,60,78240,11,"""4""",79620,79680
6144,402302,403104,120,78240,11,"""4""",79680,79800
6144,403104,112103,120,78240,11,"""4""",79800,79920
6144,112103,103003,180,78240,11,"""4""",79920,80100
6144,103003,118002,120,78240,11,"""4""",80100,80220
6144,118002,106002,60,78240,11,"""4""",80220,80280
6144,106002,118102,60,78240,11,"""4""",80280,80340
6144,118102,101003,120,78240,11,"""4""",80340,80460
6144,101003,502202,120,78240,11,"""4""",80460,80580
6144,502202,501002,60,78240,11,"""4""",80580,80640
6144,501002,502102,60,78240,11,"""4""",80640,80700
6144,502102,501302,60,78240,11,"""4""",80700,80760
6144,501302,500406,120,78240,11,"""4""",80760,80880
6144,500406,503203,60,78240,11,"""4""",80880,80940
6144,503203,503502,60,78240,11,"""4""",80940,81000
6144,503502,503403,120,78240,11,"""4""",81000,81120
6144,503403,503300,120,78240,11,"""4""",81120,81240
6144,410202,403300,60,80040,11,"""4""",80040,80100
6144,403300,401402,60,80040,11,"""4""",80100,80160
6144,401402,401902,60,80040,11,"""4""",80160,80220
6144,401902,401503,60,80040,11,"""4""",80220,80280
6144,401503,26502,120,80040,11,"""4""",80280,80400
6144,26502,401302,60,80040,11,"""4""",80400,80460
6144,401302,400800,120,80040,11,"""4""",80460,80580
6144,400800,408901,60,80040,11,"""4""",80580,80640
6144,408901,407501,120,80040,11,"""4""",80640,80760
6144,407501,33604,120,80040,11,"""4""",80760,80880
6144,33604,403902,60,80040,11,"""4""",80880,80940
6144,403902,402402,60,80040,11,"""4""",80940,81000
6144,402402,406803,120,80040,11,"""4""",81000,81120
6144,406803,408002,180,80040,11,"""4""",81120,81300
6144,408002,402502,60,80040,11,"""4""",81300,81360
6144,402502,406603,60,80040,11,"""4""",81360,81420
6144,406603,402302,60,80040,11,"""4""",81420,81480
6144,402302,403104,120,80040,11,"""4""",81480,81600
6144,403104,112103,120,80040,11,"""4""",81600,81720
6144,112103,103003,180,80040,11,"""4""",81720,81900
6144,103003,118002,120,80040,11,"""4""",81900,82020
6144,118002,106002,60,80040,11,"""4""",82020,82080
6144,106002,118102,60,80040,11,"""4""",82080,82140
6144,118102,101003,120,80040,11,"""4""",82140,82260
6144,101003,502202,120,80040,11,"""4""",82260,82380
6144,502202,501002,60,80040,11,"""4""",82380,82440
6144,501002,502102,60,80040,11,"""4""",82440,82500
6144,502102,501302,60,80040,11,"""4""",82500,82560
6144,501302,500406,120,80040,11,"""4""",82560,82680
6144,500406,503203,60,80040,11,"""4""",82680,82740
6144,503203,503502,60,80040,11,"""4""",82740,82800
6144,503502,503403,120,80040,11,"""4""",82800,82920
6144,503403,503300,120,80040,11,"""4""",82920,83040
6144,410202,403300,60,81840,11,"""4""",81840,81900
6144,403300,401402,60,81840,11,"""4""",81900,81960
6144,401402,401902,60,81840,11,"""4""",81960,82020
6144,401902,401503,60,81840,11,"""4""",82020,82080
6144,401503,26502,120,81840,11,"""4""",82080,82200
6144,26502,401302,60,81840,11,"""4""",82200,82260
6144,401302,400800,120,81840,11,"""4""",82260,82380
6144,400800,408901,60,81840,11,"""4""",82380,82440
6144,408901,407501,120,81840,11,"""4""",82440,82560
6144,407501,33604,120,81840,11,"""4""",82560,82680
6144,33604,403902,60,81840,11,"""4""",82680,82740
6144,403902,402402,60,81840,11,"""4""",82740,82800
6144,402402,406803,120,81840,11,"""4""",82800,82920
6144,406803,408002,180,81840,11,"""4""",82920,83100
6144,408002,402502,60,81840,11,"""4""",83100,83160
6144,402502,406603,60,81840,11,"""4""",83160,83220
6144,406603,402302,60,81840,11,"""4""",83220,83280
6144,402302,403104,120,81840,11,"""4""",83280,83400
6144,403104,112103,120,81840,11,"""4""",83400,83520
6144,112103,103003,180,81840,11,"""4""",83520,83700
6144,103003,118002,120,81840,11,"""4""",83700,83820
6144,118002,106002,60,81840,11,"""4""",83820,83880
6144,106002,118102,60,81840,11,"""4""",83880,83940
6144,118102,101003,120,81840,11,"""4""",83940,84060
6144,101003,502202,120,81840,11,"""4""",84060,84180
6144,502202,501002,60,81840,11,"""4""",84180,84240
6144,501002,502102,60,81840,11,"""4""",84240,84300
6144,502102,501302,60,81840,11,"""4""",84300,84360
6144,501302,500406,120,81840,11,"""4""",84360,84480
6144,500406,503203,60,81840,11,"""4""",84480,84540
6144,503203,503502,60,81840,11,"""4""",84540,84600
6144,503502,503403,120,81840,11,"""4""",84600,84720
6144,503403,503300,120,81840,11,"""4""",84720,84840
6144,410202,403300,60,83640,11,"""4""",83640,83700
6144,403300,401402,60,83640,11,"""4""",83700,83760
6144,401402,401902,60,83640,11,"""4""",83760,83820
6144,401902,401503,60,83640,11,"""4""",83820,83880
6144,401503,26502,120,83640,11,"""4""",83880,84000
6144,26502,401302,60,83640,11,"""4""",84000,84060
6144,401302,400800,120,83640,11,"""4""",84060,84180
6144,400800,408901,60,83640,11,"""4""",84180,84240
6144,408901,407501,120,83640,11,"""4""",84240,84360
6144,407501,33604,120,83640,11,"""4""",84360,84480
6144,33604,403902,60,83640,11,"""4""",84480,84540
6144,403902,402402,60,83640,11,"""4""",84540,84600
6144,402402,406803,120,83640,11,"""4""",84600,84720
6144,406803,408002,180,83640,11,"""4""",84720,84900
6144,408002,402502,60,83640,11,"""4""",84900,84960
6144,402502,406603,60,83640,11,"""4""",84960,85020
6144,406603,402302,60,83640,11,"""4""",85020,85080
6144,402302,403104,120,83640,11,"""4""",85080,85200
6144,403104,112103,120,83640,11,"""4""",85200,85320
6144,112103,103003,180,83640,11,"""4""",85320,85500
6144,103003,118002,120,83640,11,"""4""",85500,85620
6144,118002,106002,60,83640,11,"""4""",85620,85680
6144,106002,118102,60,83640,11,"""4""",85680,85740
6144,118102,101003,120,83640,11,"""4""",85740,85860
6144,101003,502202,120,83640,11,"""4""",85860,85980
6144,502202,501002,60,83640,11,"""4""",85980,86040
6144,501002,502102,60,83640,11,"""4""",86040,86100
6144,502102,501302,60,83640,11,"""4""",86100,86160
6144,501302,500406,120,83640,11,"""4""",86160,86280
6144,500406,503203,60,83640,11,"""4""",86280,86340
6144,503203,503502,60,83640,11,"""4""",86340,86400
6144,503502,503403,120,83640,11,"""4""",86400,86520
6144,503403,503300,120,83640,11,"""4""",86520,86640
6147,410202,403300,60,20160,11,"""4""",20160,20220
6147,403300,401402,60,20160,11,"""4""",20220,20280
6147,401402,401902,60,20160,11,"""4""",20280,20340
6147,401902,401503,60,20160,11,"""4""",20340,20400
6147,401503,26502,120,20160,11,"""4""",20400,20520
6147,26502,401302,60,20160,11,"""4""",20520,20580
6147,401302,400800,120,20160,11,"""4""",20580,20700
6147,400800,408901,60,20160,11,"""4""",20700,20760
6147,408901,407501,120,20160,11,"""4""",20760,20880
6147,407501,33604,120,20160,11,"""4""",20880,21000
6147,33604,403902,60,20160,11,"""4""",21000,21060
6147,403902,402402,60,20160,11,"""4""",21060,21120
6147,402402,406803,120,20160,11,"""4""",21120,21240
6147,406803,408002,180,20160,11,"""4""",21240,21420
6147,408002,402502,60,20160,11,"""4""",21420,21480
6147,402502,406603,60,20160,11,"""4""",21480,21540
6147,406603,402302,60,20160,11,"""4""",21540,21600
6147,402302,403104,180,20160,11,"""4""",21600,21780
6147,403104,112103,120,20160,11,"""4""",21780,21900
6147,112103,103003,180,20160,11,"""4""",21900,22080
6147,103003,118002,180,20160,11,"""4""",22080,22260
6147,118002,106002,60,20160,11,"""4""",22260,22320
6147,106002,118102,60,20160,11,"""4""",22320,22380
6147,118102,101003,120,20160,11,"""4""",22380,22500
6147,101003,502202,120,20160,11,"""4""",22500,22620
6147,502202,501002,60,20160,11,"""4""",22620,22680
6147,501002,502102,120,20160,11,"""4""",22680,22800
6147,502102,501302,60,20160,11,"""4""",22800,22860
6147,501302,500406,120,20160,11,"""4""",22860,22980
6147,500406,503203,60,20160,11,"""4""",22980,23040
6147,503203,503502,60,20160,11,"""4""",23040,23100
6147,503502,503403,120,20160,11,"""4""",23100,23220
6147,503403,503300,120,20160,11,"""4""",23220,23340
6147,410202,403300,60,21720,11,"""4""",21720,21780
6147,403300,401402,60,21720,11,"""4""",21780,21840
6147,401402,401902,60,21720,11,"""4""",21840,21900
6147,401902,401503,60,21720,11,"""4""",21900,21960
6147,401503,26502,120,21720,11,"""4""",21960,22080
6147,26502,401302,60,21720,11,"""4""",22080,22140
6147,401302,400800,120,21720,11,"""4""",22140,22260
6147,400800,408901,60,21720,11,"""4""",22260,22320
6147,408901,407501,120,21720,11,"""4""",22320,22440
6147,407501,33604,120,21720,11,"""4""",22440,22560
6147,33604,403902,60,21720,11,"""4""",22560,22620
6147,403902,402402,60,21720,11,"""4""",22620,22680
6147,402402,406803,120,21720,11,"""4""",22680,22800
6147,406803,408002,180,21720,11,"""4""",22800,22980
6147,408002,402502,60,21720,11,"""4""",22980,23040
6147,402502,406603,60,21720,11,"""4""",23040,23100
6147,406603,402302,60,21720,11,"""4""",23100,23160
6147,402302,403104,180,21720,11,"""4""",23160,23340
6147,403104,112103,120,21720,11,"""4""",23340,23460
6147,112103,103003,180,21720,11,"""4""",23460,23640
6147,103003,118002,180,21720,11,"""4""",23640,23820
6147,118002,106002,60,21720,11,"""4""",23820,23880
6147,106002,118102,60,21720,11,"""4""",23880,23940
6147,118102,101003,120,21720,11,"""4""",23940,24060
6147,101003,502202,120,21720,11,"""4""",24060,24180
6147,502202,501002,60,21720,11,"""4""",24180,24240
6147,501002,502102,120,21720,11,"""4""",24240,24360
6147,502102,501302,60,21720,11,"""4""",24360,24420
6147,501302,500406,120,21720,11,"""4""",24420,24540
6147,500406,503203,60,21720,11,"""4""",24540,24600
6147,503203,503502,60,21720,11,"""4""",24600,24660
6147,503502,503403,120,21720,11,"""4""",24660,24780
6147,503403,503300,120,21720,11,"""4""",24780,24900
6147,410202,403300,60,22920,11,"""4""",22920,22980
6147,403300,401402,60,22920,11,"""4""",22980,23040
6147,401402,401902,60,22920,11,"""4""",23040,23100
6147,401902,401503,60,22920,11,"""4""",23100,23160
6147,401503,26502,120,22920,11,"""4""",23160,23280
6147,26502,401302,60,22920,11,"""4""",23280,23340
6147,401302,400800,120,22920,11,"""4""",23340,23460
6147,400800,408901,60,22920,11,"""4""",23460,23520
6147,408901,407501,120,22920,11,"""4""",23520,23640
6147,407501,33604,120,22920,11,"""4""",23640,23760
6147,33604,403902,60,22920,11,"""4""",23760,23820
6147,403902,402402,60,22920,11,"""4""",23820,23880
6147,402402,406803,120,22920,11,"""4""",23880,24000
6147,406803,408002,180,22920,11,"""4""",24000,24180
6147,408002,402502,60,22920,11,"""4""",24180,24240
6147,402502,406603,60,22920,11,"""4""",24240,24300
6147,406603,402302,60,22920,11,"""4""",24300,24360
6147,402302,403104,180,22920,11,"""4""",24360,24540
6147,403104,112103,120,22920,11,"""4""",24540,24660
6147,112103,103003,180,22920,11,"""4""",24660,24840
6147,103003,118002,180,22920,11,"""4""",24840,25020
6147,118002,106002,60,22920,11,"""4""",25020,25080
6147,106002,118102,60,22920,11,"""4""",25080,25140
6147,118102,101003,120,22920,11,"""4""",25140,25260
6147,101003,502202,120,22920,11,"""4""",25260,25380
6147,502202,501002,60,22920,11,"""4""",25380,25440
6147,501002,502102,120,22920,11,"""4""",25440,25560
6147,502102,501302,60,22920,11,"""4""",25560,25620
6147,501302,500406,120,22920,11,"""4""",25620,25740
6147,500406,503203,60,22920,11,"""4""",25740,25800
6147,503203,503502,60,22920,11,"""4""",25800,25860
6147,503502,503403,120,22920,11,"""4""",25860,25980
6147,503403,503300,120,22920,11,"""4""",25980,26100
6149,410202,403300,60,19020,11,"""4""",19020,19080
6149,403300,401402,60,19020,11,"""4""",19080,19140
6149,401402,401902,60,19020,11,"""4""",19140,19200
6149,401902,401503,60,19020,11,"""4""",19200,19260
6149,401503,26502,120,19020,11,"""4""",19260,19380
6149,26502,401302,60,19020,11,"""4""",19380,19440
6149,401302,400800,120,19020,11,"""4""",19440,19560
6149,400800,408901,60,19020,11,"""4""",19560,19620
6149,408901,407501,60,19020,11,"""4""",19620,19680
6149,407501,33604,60,19020,11,"""4""",19680,19740
6149,33604,403902,60,19020,11,"""4""",19740,19800
6149,403902,402402,60,19020,11,"""4""",19800,19860
6149,402402,406803,60,19020,11,"""4""",19860,19920
6149,406803,408002,120,19020,11,"""4""",19920,20040
6149,408002,402502,60,19020,11,"""4""",20040,20100
6149,402502,406603,60,19020,11,"""4""",20100,20160
6149,406603,402302,60,19020,11,"""4""",20160,20220
6149,402302,403104,120,19020,11,"""4""",20220,20340
6149,403104,112103,120,19020,11,"""4""",20340,20460
6149,112103,103003,180,19020,11,"""4""",20460,20640
6149,103003,118002,120,19020,11,"""4""",20640,20760
6149,118002,106002,60,19020,11,"""4""",20760,20820
6149,106002,118102,60,19020,11,"""4""",20820,20880
6149,118102,101003,120,19020,11,"""4""",20880,21000
6149,101003,502202,120,19020,11,"""4""",21000,21120
6149,502202,501002,60,19020,11,"""4""",21120,21180
6149,501002,502102,60,19020,11,"""4""",21180,21240
6149,502102,501302,60,19020,11,"""4""",21240,21300
6149,501302,500406,120,19020,11,"""4""",21300,21420
6149,500406,503203,60,19020,11,"""4""",21420,21480
6149,503203,503502,60,19020,11,"""4""",21480,21540
6149,503502,503403,120,19020,11,"""4""",21540,21660
6149,503403,503300,120,19020,11,"""4""",21660,21780
6194,302100,302002,60,83760,10,"""15""",83760,83820
6194,302002,302202,60,83760,10,"""15""",83820,83880
6194,302202,303002,60,83760,10,"""15""",83880,83940
6194,303002,302502,60,83760,10,"""15""",83940,84000
6194,302502,119005,120,83760,10,"""15""",84000,84120
6194,119005,106503,60,83760,10,"""15""",84120,84180
6194,106503,103005,120,83760,10,"""15""",84180,84300
6194,103005,112107,120,83760,10,"""15""",84300,84420
6283,304302,109202,0,79140,9,"""3""",79140,79140
6283,109202,304803,60,79140,9,"""3""",79140,79200
6283,304803,306001,60,79140,9,"""3""",79200,79260
6283,306001,304401,120,79140,9,"""3""",79260,79380
6283,304401,305202,120,79140,9,"""3""",79380,79500
6283,305202,301101,60,79140,9,"""3""",79500,79560
6283,301101,301502,60,79140,9,"""3""",79560,79620
6283,301502,301201,0,79140,9,"""3""",79620,79620
6283,301201,301600,60,79140,9,"""3""",79620,79680
6283,301600,301001,60,79140,9,"""3""",79680,79740
6283,301001,301302,60,79140,9,"""3""",79740,79800
6283,301302,305001,60,79140,9,"""3""",79800,79860
6283,305001,33902,120,79140,9,"""3""",79860,79980
6283,33902,26502,120,79140,9,"""3""",79980,80100
6283,26502,401302,60,79140,9,"""3""",80100,80160
6283,401302,400801,120,79140,9,"""3""",80160,80280
6283,400801,400704,60,79140,9,"""3""",80280,80340
6283,400704,408503,60,79140,9,"""3""",80340,80400
6283,408503,405602,60,79140,9,"""3""",80400,80460
6283,405602,407102,60,79140,9,"""3""",80460,80520
6283,407102,404202,60,79140,9,"""3""",80520,80580
6283,404202,117000,60,79140,9,"""3""",80580,80640
6283,117000,112103,180,79140,9,"""3""",80640,80820
6737,33902,403300,180,26100,9,"""39""",26100,26280
6737,403300,401402,60,26100,9,"""39""",26280,26340
6737,401402,401902,60,26100,9,"""39""",26340,26400
6737,401902,401503,60,26100,9,"""39""",26400,26460
6737,401503,26502,120,26100,9,"""39""",26460,26580
6737,26502,401302,60,26100,9,"""39""",26580,26640
6737,401302,400801,120,26100,9,"""39""",26640,26760
6737,400801,400704,120,26100,9,"""39""",26760,26880
6737,400704,408503,60,26100,9,"""39""",26880,26940
6737,408503,405602,60,26100,9,"""39""",26940,27000
6737,405602,407302,300,26100,9,"""39""",27000,27300
6737,407302,101102,480,26100,9,"""39""",27300,27780
6737,101102,102001,120,26100,9,"""39""",27780,27900
6737,102001,502202,180,26100,9,"""39""",27900,28080
6737,502202,501003,60,26100,9,"""39""",28080,28140
6737,501003,16302,120,26100,9,"""39""",28140,28260
7056,112110,111101,60,32460,97,"""1""",32460,32520
7056,111101,111001,60,32460,97,"""1""",32520,32580
7056,111001,104001,60,32460,97,"""1""",32580,32640
7056,104001,100100,120,32460,97,"""1""",32640,32760
7056,100100,108000,60,32460,97,"""1""",32760,32820
7056,108000,101005,180,32460,97,"""1""",32820,33000
7056,112110,111101,60,33060,97,"""1""",33060,33120
7056,111101,111001,60,33060,97,"""1""",33120,33180
7056,111001,104001,60,33060,97,"""1""",33180,33240
7056,104001,100100,120,33060,97,"""1""",33240,33360
7056,100100,108000,60,33060,97,"""1""",33360,33420
7056,108000,101005,180,33060,97,"""1""",33420,33600
7056,112110,111101,60,33660,97,"""1""",33660,33720
7056,111101,111001,60,33660,97,"""1""",33720,33780
7056,111001,104001,60,33660,97,"""1""",33780,33840
7056,104001,100100,120,33660,97,"""1""",33840,33960
7056,100100,108000,60,33660,97,"""1""",33960,34020
7056,108000,101005,180,33660,97,"""1""",34020,34200
7056,112110,111101,60,34260,97,"""1""",34260,34320
7056,111101,111001,60,34260,97,"""1""",34320,34380
7056,111001,104001,60,34260,97,"""1""",34380,34440
7056,104001,100100,120,34260,97,"""1""",34440,34560
7056,100100,108000,60,34260,97,"""1""",34560,34620
7056,108000,101005,180,34260,97,"""1""",34620,34800
7056,112110,111101,60,34860,97,"""1""",34860,34920
7056,111101,111001,60,34860,97,"""1""",34920,34980
7056,111001,104001,60,34860,97,"""1""",34980,35040
7056,104001,100100,120,34860,97,"""1""",35040,35160
7056,100100,108000,60,34860,97,"""1""",35160,35220
7056,108000,101005,180,34860,97,"""1""",35220,35400
7056,112110,111101,60,35460,97,"""1""",35460,35520
7056,111101,111001,60,35460,97,"""1""",35520,35580
7056,111001,104001,60,35460,97,"""1""",35580,35640
7056,104001,100100,120,35460,97,"""1""",35640,35760
7056,100100,108000,60,35460,97,"""1""",35760,35820
7056,108000,101005,180,35460,97,"""1""",35820,36000
7056,112110,111101,60,36060,97,"""1""",36060,36120
7056,111101,111001,60,36060,97,"""1""",36120,36180
7056,111001,104001,60,36060,97,"""1""",36180,36240
7056,104001,100100,120,36060,97,"""1""",36240,36360
7056,100100,108000,60,36060,97,"""1""",36360,36420
7056,108000,101005,180,36060,97,"""1""",36420,36600
7056,112110,111101,60,36660,97,"""1""",36660,36720
7056,111101,111001,60,36660,97,"""1""",36720,36780
7056,111001,104001,60,36660,97,"""1""",36780,36840
7056,104001,100100,120,36660,97,"""1""",36840,36960
7056,100100,108000,60,36660,97,"""1""",36960,37020
7056,108000,101005,180,36660,97,"""1""",37020,37200
7056,112110,111101,60,37260,97,"""1""",37260,37320
7056,111101,111001,60,37260,97,"""1""",37320,37380
7056,111001,104001,60,37260,97,"""1""",37380,37440
7056,104001,100100,120,37260,97,"""1""",37440,37560
7056,100100,108000,60,37260,97,"""1""",37560,37620
7056,108000,101005,180,37260,97,"""1""",37620,37800
7056,112110,111101,60,37860,97,"""1""",37860,37920
7056,111101,111001,60,37860,97,"""1""",37920,37980
7056,111001,104001,60,37860,97,"""1""",37980,38040
7056,104001,100100,120,37860,97,"""1""",38040,38160
7056,100100,108000,60,37860,97,"""1""",38160,38220
7056,108000,101005,180,37860,97,"""1""",38220,38400
7056,112110,111101,60,38460,97,"""1""",38460,38520
7056,111101,111001,60,38460,97,"""1""",38520,38580
7056,111001,104001,60,38460,97,"""1""",38580,38640
7056,104001,100100,120,38460,97,"""1""",38640,38760
7056,100100,108000,60,38460,97,"""1""",38760,38820
7056,108000,101005,180,38460,97,"""1""",38820,39000
7056,112110,111101,60,39060,97,"""1""",39060,39120
7056,111101,111001,60,39060,97,"""1""",39120,39180
7056,111001,104001,60,39060,97,"""1""",39180,39240
7056,104001,100100,120,39060,97,"""1""",39240,39360
7056,100100,108000,60,39060,97,"""1""",39360,39420
7056,108000,101005,180,39060,97,"""1""",39420,39600
7056,112110,111101,60,39660,97,"""1""",39660,39720
7056,111101,111001,60,39660,97,"""1""",39720,39780
7056,111001,104001,60,39660,97,"""1""",39780,39840
7056,104001,100100,120,39660,97,"""1""",39840,39960
7056,100100,108000,60,39660,97,"""1""",39960,40020
7056,108000,101005,180,39660,97,"""1""",40020,40200
7056,112110,111101,60,40260,97,"""1""",40260,40320
7056,111101,111001,60,40260,97,"""1""",40320,40380
7056,111001,104001,60,40260,97,"""1""",40380,40440
7056,104001,100100,120,40260,97,"""1""",40440,40560
7056,100100,108000,60,40260,97,"""1""",40560,40620
7056,108000,101005,180,40260,97,"""1""",40620,40800
7056,112110,111101,60,40860,97,"""1""",40860,40920
7056,111101,111001,60,40860,97,"""1""",40920,40980
7056,111001,104001,60,40860,97,"""1""",40980,41040
7056,104001,100100,120,40860,97,"""1""",41040,41160
7056,100100,108000,60,40860,97,"""1""",41160,41220
7056,108000,101005,180,40860,97,"""1""",41220,41400
7056,112110,111101,60,41460,97,"""1""",41460,41520
7056,111101,111001,60,41460,97,"""1""",41520,41580
7056,111001,104001,60,41460,97,"""1""",41580,41640
7056,104001,100100,120,41460,97,"""1""",41640,41760
7056,100100,108000,60,41460,97,"""1""",41760,41820
7056,108000,101005,180,41460,97,"""1""",41820,42000
7056,112110,111101,60,42060,97,"""1""",42060,42120
7056,111101,111001,60,42060,97,"""1""",42120,42180
7056,111001,104001,60,42060,97,"""1""",42180,42240
7056,104001,100100,120,42060,97,"""1""",42240,42360
7056,100100,108000,60,42060,97,"""1""",42360,42420
7056,108000,101005,180,42060,97,"""1""",42420,42600
7056,112110,111101,60,42660,97,"""1""",42660,42720
7056,111101,111001,60,42660,97,"""1""",42720,42780
7056,111001,104001,60,42660,97,"""1""",42780,42840
7056,104001,100100,120,42660,97,"""1""",42840,42960
7056,100100,108000,60,42660,97,"""1""",42960,43020
7056,108000,101005,180,42660,97,"""1""",43020,43200
7056,112110,111101,60,43260,97,"""1""",43260,43320
7056,111101,111001,60,43260,97,"""1""",43320,43380
7056,111001,104001,60,43260,97,"""1""",43380,43440
7056,104001,100100,120,43260,97,"""1""",43440,43560
7056,100100,108000,60,43260,97,"""1""",43560,43620
7056,108000,101005,180,43260,97,"""1""",43620,43800
7056,112110,111101,60,43860,97,"""1""",43860,43920
7056,111101,111001,60,43860,97,"""1""",43920,43980
7056,111001,104001,60,43860,97,"""1""",43980,44040
7056,104001,100100,120,43860,97,"""1""",44040,44160
7056,100100,108000,60,43860,97,"""1""",44160,44220
7056,108000,101005,180,43860,97,"""1""",44220,44400
7056,112110,111101,60,44460,97,"""1""",44460,44520
7056,111101,111001,60,44460,97,"""1""",44520,44580
7056,111001,104001,60,44460,97,"""1""",44580,44640
7056,104001,100100,120,44460,97,"""1""",44640,44760
7056,100100,108000,60,44460,97,"""1""",44760,44820
7056,108000,101005,180,44460,97,"""1""",44820,45000
7056,112110,111101,60,45060,97,"""1""",45060,45120
7056,111101,111001,60,45060,97,"""1""",45120,45180
7056,111001,104001,60,45060,97,"""1""",45180,45240
7056,104001,100100,120,45060,97,"""1""",45240,45360
7056,100100,108000,60,45060,97,"""1""",45360,45420
7056,108000,101005,180,45060,97,"""1""",45420,45600
7056,112110,111101,60,45660,97,"""1""",45660,45720
7056,111101,111001,60,45660,97,"""1""",45720,45780
7056,111001,104001,60,45660,97,"""1""",45780,45840
7056,104001,100100,120,45660,97,"""1""",45840,45960
7056,100100,108000,60,45660,97,"""1""",45960,46020
7056,108000,101005,180,45660,97,"""1""",46020,46200
7056,112110,111101,60,46260,97,"""1""",46260,46320
7056,111101,111001,60,46260,97,"""1""",46320,46380
7056,111001,104001,60,46260,97,"""1""",46380,46440
7056,104001,100100,120,46260,97,"""1""",46440,46560
7056,100100,108000,60,46260,97,"""1""",46560,46620
7056,108000,101005,180,46260,97,"""1""",46620,46800
7056,112110,111101,60,46860,97,"""1""",46860,46920
7056,111101,111001,60,46860,97,"""1""",46920,46980
7056,111001,104001,60,46860,97,"""1""",46980,47040
7056,104001,100100,120,46860,97,"""1""",47040,47160
7056,100100,108000,60,46860,97,"""1""",47160,47220
7056,108000,101005,180,46860,97,"""1""",47220,47400
7056,112110,111101,60,47460,97,"""1""",47460,47520
7056,111101,111001,60,47460,97,"""1""",47520,47580
7056,111001,104001,60,47460,97,"""1""",47580,47640
7056,104001,100100,120,47460,97,"""1""",47640,47760
7056,100100,108000,60,47460,97,"""1""",47760,47820
7056,108000,101005,180,47460,97,"""1""",47820,48000
7056,112110,111101,60,48060,97,"""1""",48060,48120
7056,111101,111001,60,48060,97,"""1""",48120,48180
7056,111001,104001,60,48060,97,"""1""",48180,48240
7056,104001,100100,120,48060,97,"""1""",48240,48360
7056,100100,108000,60,48060,97,"""1""",48360,48420
7056,108000,101005,180,48060,97,"""1""",48420,48600
7056,112110,111101,60,48660,97,"""1""",48660,48720
7056,111101,111001,60,48660,97,"""1""",48720,48780
7056,111001,104001,60,48660,97,"""1""",48780,48840
7056,104001,100100,120,48660,97,"""1""",48840,48960
7056,100100,108000,60,48660,97,"""1""",48960,49020
7056,108000,101005,180,48660,97,"""1""",49020,49200
7056,112110,111101,60,49260,97,"""1""",49260,49320
7056,111101,111001,60,49260,97,"""1""",49320,49380
7056,111001,104001,60,49260,97,"""1""",49380,49440
7056,104001,100100,120,49260,97,"""1""",49440,49560
7056,100100,108000,60,49260,97,"""1""",49560,49620
7056,108000,101005,180,49260,97,"""1""",49620,49800
7056,112110,111101,60,49860,97,"""1""",49860,49920
7056,111101,111001,60,49860,97,"""1""",49920,49980
7056,111001,104001,60,49860,97,"""1""",49980,50040
7056,104001,100100,120,49860,97,"""1""",50040,50160
7056,100100,108000,60,49860,97,"""1""",50160,50220
7056,108000,101005,180,49860,97,"""1""",50220,50400
7056,112110,111101,60,50460,97,"""1""",50460,50520
7056,111101,111001,60,50460,97,"""1""",50520,50580
7056,111001,104001,60,50460,97,"""1""",50580,50640
7056,104001,100100,120,50460,97,"""1""",50640,50760
7056,100100,108000,60,50460,97,"""1""",50760,50820
7056,108000,101005,180,50460,97,"""1""",50820,51000
7056,112110,111101,60,51060,97,"""1""",51060,51120
7056,111101,111001,60,51060,97,"""1""",51120,51180
7056,111001,104001,60,51060,97,"""1""",51180,51240
7056,104001,100100,120,51060,97,"""1""",51240,51360
7056,100100,108000,60,51060,97,"""1""",51360,51420
7056,108000,101005,180,51060,97,"""1""",51420,51600
7056,112110,111101,60,51660,97,"""1""",51660,51720
7056,111101,111001,60,51660,97,"""1""",51720,51780
7056,111001,104001,60,51660,97,"""1""",51780,51840
7056,104001,100100,120,51660,97,"""1""",51840,51960
7056,100100,108000,60,51660,97,"""1""",51960,52020
7056,108000,101005,180,51660,97,"""1""",52020,52200
7056,112110,111101,60,52260,97,"""1""",52260,52320
7056,111101,111001,60,52260,97,"""1""",52320,52380
7056,111001,104001,60,52260,97,"""1""",52380,52440
7056,104001,100100,120,52260,97,"""1""",52440,52560
7056,100100,108000,60,52260,97,"""1""",52560,52620
7056,108000,101005,180,52260,97,"""1""",52620,52800
7056,112110,111101,60,52860,97,"""1""",52860,52920
7056,111101,111001,60,52860,97,"""1""",52920,52980
7056,111001,104001,60,52860,97,"""1""",52980,53040
7056,104001,100100,120,52860,97,"""1""",53040,53160
7056,100100,108000,60,52860,97,"""1""",53160,53220
7056,108000,101005,180,52860,97,"""1""",53220,53400
7056,112110,111101,60,53460,97,"""1""",53460,53520
7056,111101,111001,60,53460,97,"""1""",53520,53580
7056,111001,104001,60,53460,97,"""1""",53580,53640
7056,104001,100100,120,53460,97,"""1""",53640,53760
7056,100100,108000,60,53460,97,"""1""",53760,53820
7056,108000,101005,180,53460,97,"""1""",53820,54000
7056,112110,111101,60,54060,97,"""1""",54060,54120
7056,111101,111001,60,54060,97,"""1""",54120,54180
7056,111001,104001,60,54060,97,"""1""",54180,54240
7056,104001,100100,120,54060,97,"""1""",54240,54360
7056,100100,108000,60,54060,97,"""1""",54360,54420
7056,108000,101005,180,54060,97,"""1""",54420,54600
7056,112110,111101,60,54660,97,"""1""",54660,54720
7056,111101,111001,60,54660,97,"""1""",54720,54780
7056,111001,104001,60,54660,97,"""1""",54780,54840
7056,104001,100100,120,54660,97,"""1""",54840,54960
7056,100100,108000,60,54660,97,"""1""",54960,55020
7056,108000,101005,180,54660,97,"""1""",55020,55200
7056,112110,111101,60,55260,97,"""1""",55260,55320
7056,111101,111001,60,55260,97,"""1""",55320,55380
7056,111001,104001,60,55260,97,"""1""",55380,55440
7056,104001,100100,120,55260,97,"""1""",55440,55560
7056,100100,108000,60,55260,97,"""1""",55560,55620
7056,108000,101005,180,55260,97,"""1""",55620,55800
7056,112110,111101,60,55860,97,"""1""",55860,55920
7056,111101,111001,60,55860,97,"""1""",55920,55980
7056,111001,104001,60,55860,97,"""1""",55980,56040
7056,104001,100100,120,55860,97,"""1""",56040,56160
7056,100100,108000,60,55860,97,"""1""",56160,56220
7056,108000,101005,180,55860,97,"""1""",56220,56400
7056,112110,111101,60,56460,97,"""1""",56460,56520
7056,111101,111001,60,56460,97,"""1""",56520,56580
7056,111001,104001,60,56460,97,"""1""",56580,56640
7056,104001,100100,120,56460,97,"""1""",56640,56760
7056,100100,108000,60,56460,97,"""1""",56760,56820
7056,108000,101005,180,56460,97,"""1""",56820,57000
7056,112110,111101,60,57060,97,"""1""",57060,57120
7056,111101,111001,60,57060,97,"""1""",57120,57180
7056,111001,104001,60,57060,97,"""1""",57180,57240
7056,104001,100100,120,57060,97,"""1""",57240,57360
7056,100100,108000,60,57060,97,"""1""",57360,57420
7056,108000,101005,180,57060,97,"""1""",57420,57600
7056,112110,111101,60,57660,97,"""1""",57660,57720
7056,111101,111001,60,57660,97,"""1""",57720,57780
7056,111001,104001,60,57660,97,"""1""",57780,57840
7056,104001,100100,120,57660,97,"""1""",57840,57960
7056,100100,108000,60,57660,97,"""1""",57960,58020
7056,108000,101005,180,57660,97,"""1""",58020,58200
7056,112110,111101,60,58260,97,"""1""",58260,58320
7056,111101,111001,60,58260,97,"""1""",58320,58380
7056,111001,104001,60,58260,97,"""1""",58380,58440
7056,104001,100100,120,58260,97,"""1""",58440,58560
7056,100100,108000,60,58260,97,"""1""",58560,58620
7056,108000,101005,180,58260,97,"""1""",58620,58800
7056,112110,111101,60,58860,97,"""1""",58860,58920
7056,111101,111001,60,58860,97,"""1""",58920,58980
7056,111001,104001,60,58860,97,"""1""",58980,59040
7056,104001,100100,120,58860,97,"""1""",59040,59160
7056,100100,108000,60,58860,97,"""1""",59160,59220
7056,108000,101005,180,58860,97,"""1""",59220,59400
7056,112110,111101,60,59460,97,"""1""",59460,59520
7056,111101,111001,60,59460,97,"""1""",59520,59580
7056,111001,104001,60,59460,97,"""1""",59580,59640
7056,104001,100100,120,59460,97,"""1""",59640,59760
7056,100100,108000,60,59460,97,"""1""",59760,59820
7056,108000,101005,180,59460,97,"""1""",59820,60000
7056,112110,111101,60,60060,97,"""1""",60060,60120
7056,111101,111001,60,60060,97,"""1""",60120,60180
7056,111001,104001,60,60060,97,"""1""",60180,60240
7056,104001,100100,120,60060,97,"""1""",60240,60360
7056,100100,108000,60,60060,97,"""1""",60360,60420
7056,108000,101005,180,60060,97,"""1""",60420,60600
7056,112110,111101,60,60660,97,"""1""",60660,60720
7056,111101,111001,60,60660,97,"""1""",60720,60780
7056,111001,104001,60,60660,97,"""1""",60780,60840
7056,104001,100100,120,60660,97,"""1""",60840,60960
7056,100100,108000,60,60660,97,"""1""",60960,61020
7056,108000,101005,180,60660,97,"""1""",61020,61200
7056,112110,111101,60,61260,97,"""1""",61260,61320
7056,111101,111001,60,61260,97,"""1""",61320,61380
7056,111001,104001,60,61260,97,"""1""",61380,61440
7056,104001,100100,120,61260,97,"""1""",61440,61560
7056,100100,108000,60,61260,97,"""1""",61560,61620
7056,108000,101005,180,61260,97,"""1""",61620,61800
7056,112110,111101,60,61860,97,"""1""",61860,61920
7056,111101,111001,60,61860,97,"""1""",61920,61980
7056,111001,104001,60,61860,97,"""1""",61980,62040
7056,104001,100100,120,61860,97,"""1""",62040,62160
7056,100100,108000,60,61860,97,"""1""",62160,62220
7056,108000,101005,180,61860,97,"""1""",62220,62400
7056,112110,111101,60,62460,97,"""1""",62460,62520
7056,111101,111001,60,62460,97,"""1""",62520,62580
7056,111001,104001,60,62460,97,"""1""",62580,62640
7056,104001,100100,120,62460,97,"""1""",62640,62760
7056,100100,108000,60,62460,97,"""1""",62760,62820
7056,108000,101005,180,62460,97,"""1""",62820,63000
7056,112110,111101,60,63060,97,"""1""",63060,63120
7056,111101,111001,60,63060,97,"""1""",63120,63180
7056,111001,104001,60,63060,97,"""1""",63180,63240
7056,104001,100100,120,63060,97,"""1""",63240,63360
7056,100100,108000,60,63060,97,"""1""",63360,63420
7056,108000,101005,180,63060,97,"""1""",63420,63600
7056,112110,111101,60,63660,97,"""1""",63660,63720
7056,111101,111001,60,63660,97,"""1""",63720,63780
7056,111001,104001,60,63660,97,"""1""",63780,63840
7056,104001,100100,120,63660,97,"""1""",63840,63960
7056,100100,108000,60,63660,97,"""1""",63960,64020
7056,108000,101005,180,63660,97,"""1""",64020,64200
7056,112110,111101,60,64260,97,"""1""",64260,64320
7056,111101,111001,60,64260,97,"""1""",64320,64380
7056,111001,104001,60,64260,97,"""1""",64380,64440
7056,104001,100100,120,64260,97,"""1""",64440,64560
7056,100100,108000,60,64260,97,"""1""",64560,64620
7056,108000,101005,180,64260,97,"""1""",64620,64800
7056,112110,111101,60,64860,97,"""1""",64860,64920
7056,111101,111001,60,64860,97,"""1""",64920,64980
7056,111001,104001,60,64860,97,"""1""",64980,65040
7056,104001,100100,120,64860,97,"""1""",65040,65160
7056,100100,108000,60,64860,97,"""1""",65160,65220
7056,108000,101005,180,64860,97,"""1""",65220,65400
7056,112110,111101,60,65460,97,"""1""",65460,65520
7056,111101,111001,60,65460,97,"""1""",65520,65580
7056,111001,104001,60,65460,97,"""1""",65580,65640
7056,104001,100100,120,65460,97,"""1""",65640,65760
7056,100100,108000,60,65460,97,"""1""",65760,65820
7056,108000,101005,180,65460,97,"""1""",65820,66000
7056,112110,111101,60,66060,97,"""1""",66060,66120
7056,111101,111001,60,66060,97,"""1""",66120,66180
7056,111001,104001,60,66060,97,"""1""",66180,66240
7056,104001,100100,120,66060,97,"""1""",66240,66360
7056,100100,108000,60,66060,97,"""1""",66360,66420
7056,108000,101005,180,66060,97,"""1""",66420,66600
7056,112110,111101,60,66660,97,"""1""",66660,66720
7056,111101,111001,60,66660,97,"""1""",66720,66780
7056,111001,104001,60,66660,97,"""1""",66780,66840
7056,104001,100100,120,66660,97,"""1""",66840,66960
7056,100100,108000,60,66660,97,"""1""",66960,67020
7056,108000,101005,180,66660,97,"""1""",67020,67200
7056,112110,111101,60,67260,97,"""1""",67260,67320
7056,111101,111001,60,67260,97,"""1""",67320,67380
7056,111001,104001,60,67260,97,"""1""",67380,67440
7056,104001,100100,120,67260,97,"""1""",67440,67560
7056,100100,108000,60,67260,97,"""1""",67560,67620
7056,108000,101005,180,67260,97,"""1""",67620,67800
7056,112110,111101,60,67860,97,"""1""",67860,67920
7056,111101,111001,60,67860,97,"""1""",67920,67980
7056,111001,104001,60,67860,97,"""1""",67980,68040
7056,104001,100100,120,67860,97,"""1""",68040,68160
7056,100100,108000,60,67860,97,"""1""",68160,68220
7056,108000,101005,180,67860,97,"""1""",68220,68400
7056,112110,111101,60,68760,97,"""1""",68760,68820
7056,111101,111001,60,68760,97,"""1""",68820,68880
7056,111001,104001,60,68760,97,"""1""",68880,68940
7056,104001,100100,120,68760,97,"""1""",68940,69060
7056,100100,108000,60,68760,97,"""1""",69060,69120
7056,108000,101005,180,68760,97,"""1""",69120,69300
7056,112110,111101,60,69660,97,"""1""",69660,69720
7056,111101,111001,60,69660,97,"""1""",69720,69780
7056,111001,104001,60,69660,97,"""1""",69780,69840
7056,104001,100100,120,69660,97,"""1""",69840,69960
7056,100100,108000,60,69660,97,"""1""",69960,70020
7056,108000,101005,180,69660,97,"""1""",70020,70200
7056,112110,111101,60,70560,97,"""1""",70560,70620
7056,111101,111001,60,70560,97,"""1""",70620,70680
7056,111001,104001,60,70560,97,"""1""",70680,70740
7056,104001,100100,120,70560,97,"""1""",70740,70860
7056,100100,108000,60,70560,97,"""1""",70860,70920
7056,108000,101005,180,70560,97,"""1""",70920,71100
7056,112110,111101,60,71460,97,"""1""",71460,71520
7056,111101,111001,60,71460,97,"""1""",71520,71580
7056,111001,104001,60,71460,97,"""1""",71580,71640
7056,104001,100100,120,71460,97,"""1""",71640,71760
7056,100100,108000,60,71460,97,"""1""",71760,71820
7056,108000,101005,180,71460,97,"""1""",71820,72000
7056,112110,111101,60,72360,97,"""1""",72360,72420
7056,111101,111001,60,72360,97,"""1""",72420,72480
7056,111001,104001,60,72360,97,"""1""",72480,72540
7056,104001,100100,120,72360,97,"""1""",72540,72660
7056,100100,108000,60,72360,97,"""1""",72660,72720
7056,108000,101005,180,72360,97,"""1""",72720,72900
7057,101005,102004,60,33000,97,"""2""",33000,33060
7057,102004,107000,120,33000,97,"""2""",33060,33180
7057,107000,114000,120,33000,97,"""2""",33180,33300
7057,114000,104002,120,33000,97,"""2""",33300,33420
7057,104002,111002,60,33000,97,"""2""",33420,33480
7057,111002,111102,60,33000,97,"""2""",33480,33540
7057,111102,112109,60,33000,97,"""2""",33540,33600
7057,101005,102004,60,33600,97,"""2""",33600,33660
7057,102004,107000,120,33600,97,"""2""",33660,33780
7057,107000,114000,120,33600,97,"""2""",33780,33900
7057,114000,104002,120,33600,97,"""2""",33900,34020
7057,104002,111002,60,33600,97,"""2""",34020,34080
7057,111002,111102,60,33600,97,"""2""",34080,34140
7057,111102,112109,60,33600,97,"""2""",34140,34200
7057,101005,102004,60,34200,97,"""2""",34200,34260
7057,102004,107000,120,34200,97,"""2""",34260,34380
7057,107000,114000,120,34200,97,"""2""",34380,34500
7057,114000,104002,120,34200,97,"""2""",34500,34620
7057,104002,111002,60,34200,97,"""2""",34620,34680
7057,111002,111102,60,34200,97,"""2""",34680,34740
7057,111102,112109,60,34200,97,"""2""",34740,34800
7057,101005,102004,60,34800,97,"""2""",34800,34860
7057,102004,107000,120,34800,97,"""2""",34860,34980
7057,107000,114000,120,34800,97,"""2""",34980,35100
7057,114000,104002,120,34800,97,"""2""",35100,35220
7057,104002,111002,60,34800,97,"""2""",35220,35280
7057,111002,111102,60,34800,97,"""2""",35280,35340
7057,111102,112109,60,34800,97,"""2""",35340,35400
7057,101005,102004,60,35400,97,"""2""",35400,35460
7057,102004,107000,120,35400,97,"""2""",35460,35580
7057,107000,114000,120,35400,97,"""2""",35580,35700
7057,114000,104002,120,35400,97,"""2""",35700,35820
7057,104002,111002,60,35400,97,"""2""",35820,35880
7057,111002,111102,60,35400,97,"""2""",35880,35940
7057,111102,112109,60,35400,97,"""2""",35940,36000
7057,101005,102004,60,36000,97,"""2""",36000,36060
7057,102004,107000,120,36000,97,"""2""",36060,36180
7057,107000,114000,120,36000,97,"""2""",36180,36300
7057,114000,104002,120,36000,97,"""2""",36300,36420
7057,104002,111002,60,36000,97,"""2""",36420,36480
7057,111002,111102,60,36000,97,"""2""",36480,36540
7057,111102,112109,60,36000,97,"""2""",36540,36600
7057,101005,102004,60,36600,97,"""2""",36600,36660
7057,102004,107000,120,36600,97,"""2""",36660,36780
7057,107000,114000,120,36600,97,"""2""",36780,36900
7057,114000,104002,120,36600,97,"""2""",36900,37020
7057,104002,111002,60,36600,97,"""2""",37020,37080
7057,111002,111102,60,36600,97,"""2""",37080,37140
7057,111102,112109,60,36600,97,"""2""",37140,37200
7057,101005,102004,60,37200,97,"""2""",37200,37260
7057,102004,107000,120,37200,97,"""2""",37260,37380
7057,107000,114000,120,37200,97,"""2""",37380,37500
7057,114000,104002,120,37200,97,"""2""",37500,37620
7057,104002,111002,60,37200,97,"""2""",37620,37680
7057,111002,111102,60,37200,97,"""2""",37680,37740
7057,111102,112109,60,37200,97,"""2""",37740,37800
7057,101005,102004,60,37800,97,"""2""",37800,37860
7057,102004,107000,120,37800,97,"""2""",37860,37980
7057,107000,114000,120,37800,97,"""2""",37980,38100
7057,114000,104002,120,37800,97,"""2""",38100,38220
7057,104002,111002,60,37800,97,"""2""",38220,38280
7057,111002,111102,60,37800,97,"""2""",38280,38340
7057,111102,112109,60,37800,97,"""2""",38340,38400
7057,101005,102004,60,38400,97,"""2""",38400,38460
7057,102004,107000,120,38400,97,"""2""",38460,38580
7057,107000,114000,120,38400,97,"""2""",38580,38700
7057,114000,104002,120,38400,97,"""2""",38700,38820
7057,104002,111002,60,38400,97,"""2""",38820,38880
7057,111002,111102,60,38400,97,"""2""",38880,38940
7057,111102,112109,60,38400,97,"""2""",38940,39000
7057,101005,102004,60,39000,97,"""2""",39000,39060
7057,102004,107000,120,39000,97,"""2""",39060,39180
7057,107000,114000,120,39000,97,"""2""",39180,39300
7057,114000,104002,120,39000,97,"""2""",39300,39420
7057,104002,111002,60,39000,97,"""2""",39420,39480
7057,111002,111102,60,39000,97,"""2""",39480,39540
7057,111102,112109,60,39000,97,"""2""",39540,39600
7057,101005,102004,60,39600,97,"""2""",39600,39660
7057,102004,107000,120,39600,97,"""2""",39660,39780
7057,107000,114000,120,39600,97,"""2""",39780,39900
7057,114000,104002,120,39600,97,"""2""",39900,40020
7057,104002,111002,60,39600,97,"""2""",40020,40080
7057,111002,111102,60,39600,97,"""2""",40080,40140
7057,111102,112109,60,39600,97,"""2""",40140,40200
7057,101005,102004,60,40200,97,"""2""",40200,40260
7057,102004,107000,120,40200,97,"""2""",40260,40380
7057,107000,114000,120,40200,97,"""2""",40380,40500
7057,114000,104002,120,40200,97,"""2""",40500,40620
7057,104002,111002,60,40200,97,"""2""",40620,40680
7057,111002,111102,60,40200,97,"""2""",40680,40740
7057,111102,112109,60,40200,97,"""2""",40740,40800
7057,101005,102004,60,40800,97,"""2""",40800,40860
7057,102004,107000,120,40800,97,"""2""",40860,40980
7057,107000,114000,120,40800,97,"""2""",40980,41100
7057,114000,104002,120,40800,97,"""2""",41100,41220
7057,104002,111002,60,40800,97,"""2""",41220,41280
7057,111002,111102,60,40800,97,"""2""",41280,41340
7057,111102,112109,60,40800,97,"""2""",41340,41400
7057,101005,102004,60,41400,97,"""2""",41400,41460
7057,102004,107000,120,41400,97,"""2""",41460,41580
7057,107000,114000,120,41400,97,"""2""",41580,41700
7057,114000,104002,120,41400,97,"""2""",41700,41820
7057,104002,111002,60,41400,97,"""2""",41820,41880
7057,111002,111102,60,41400,97,"""2""",41880,41940
7057,111102,112109,60,41400,97,"""2""",41940,42000
7057,101005,102004,60,42000,97,"""2""",42000,42060
7057,102004,107000,120,42000,97,"""2""",42060,42180
7057,107000,114000,120,42000,97,"""2""",42180,42300
7057,114000,104002,120,42000,97,"""2""",42300,42420
7057,104002,111002,60,42000,97,"""2""",42420,42480
7057,111002,111102,60,42000,97,"""2""",42480,42540
7057,111102,112109,60,42000,97,"""2""",42540,42600
7057,101005,102004,60,42600,97,"""2""",42600,42660
7057,102004,107000,120,42600,97,"""2""",42660,42780
7057,107000,114000,120,42600,97,"""2""",42780,42900
7057,114000,104002,120,42600,97,"""2""",42900,43020
7057,104002,111002,60,42600,97,"""2""",43020,43080
7057,111002,111102,60,42600,97,"""2""",43080,43140
7057,111102,112109,60,42600,97,"""2""",43140,43200
7057,101005,102004,60,43200,97,"""2""",43200,43260
7057,102004,107000,120,43200,97,"""2""",43260,43380
7057,107000,114000,120,43200,97,"""2""",43380,43500
7057,114000,104002,120,43200,97,"""2""",43500,43620
7057,104002,111002,60,43200,97,"""2""",43620,43680
7057,111002,111102,60,43200,97,"""2""",43680,43740
7057,111102,112109,60,43200,97,"""2""",43740,43800
7057,101005,102004,60,43800,97,"""2""",43800,43860
7057,102004,107000,120,43800,97,"""2""",43860,43980
7057,107000,114000,120,43800,97,"""2""",43980,44100
7057,114000,104002,120,43800,97,"""2""",44100,44220
7057,104002,111002,60,43800,97,"""2""",44220,44280
7057,111002,111102,60,43800,97,"""2""",44280,44340
7057,111102,112109,60,43800,97,"""2""",44340,44400
7057,101005,102004,60,44400,97,"""2""",44400,44460
7057,102004,107000,120,44400,97,"""2""",44460,44580
7057,107000,114000,120,44400,97,"""2""",44580,44700
7057,114000,104002,120,44400,97,"""2""",44700,44820
7057,104002,111002,60,44400,97,"""2""",44820,44880
7057,111002,111102,60,44400,97,"""2""",44880,44940
7057,111102,112109,60,44400,97,"""2""",44940,45000
7057,101005,102004,60,45000,97,"""2""",45000,45060
7057,102004,107000,120,45000,97,"""2""",45060,45180
7057,107000,114000,120,45000,97,"""2""",45180,45300
7057,114000,104002,120,45000,97,"""2""",45300,45420
7057,104002,111002,60,45000,97,"""2""",45420,45480
7057,111002,111102,60,45000,97,"""2""",45480,45540
7057,111102,112109,60,45000,97,"""2""",45540,45600
7057,101005,102004,60,45600,97,"""2""",45600,45660
7057,102004,107000,120,45600,97,"""2""",45660,45780
7057,107000,114000,120,45600,97,"""2""",45780,45900
7057,114000,104002,120,45600,97,"""2""",45900,46020
7057,104002,111002,60,45600,97,"""2""",46020,46080
7057,111002,111102,60,45600,97,"""2""",46080,46140
7057,111102,112109,60,45600,97,"""2""",46140,46200
7057,101005,102004,60,46200,97,"""2""",46200,46260
7057,102004,107000,120,46200,97,"""2""",46260,46380
7057,107000,114000,120,46200,97,"""2""",46380,46500
7057,114000,104002,120,46200,97,"""2""",46500,46620
7057,104002,111002,60,46200,97,"""2""",46620,46680
7057,111002,111102,60,46200,97,"""2""",46680,46740
7057,111102,112109,60,46200,97,"""2""",46740,46800
7057,101005,102004,60,46800,97,"""2""",46800,46860
7057,102004,107000,120,46800,97,"""2""",46860,46980
7057,107000,114000,120,46800,97,"""2""",46980,47100
7057,114000,104002,120,46800,97,"""2""",47100,47220
7057,104002,111002,60,46800,97,"""2""",47220,47280
7057,111002,111102,60,46800,97,"""2""",47280,47340
7057,111102,112109,60,46800,97,"""2""",47340,47400
7057,101005,102004,60,47400,97,"""2""",47400,47460
7057,102004,107000,120,47400,97,"""2""",47460,47580
7057,107000,114000,120,47400,97,"""2""",47580,47700
7057,114000,104002,120,47400,97,"""2""",47700,47820
7057,104002,111002,60,47400,97,"""2""",47820,47880
7057,111002,111102,60,47400,97,"""2""",47880,47940
7057,111102,112109,60,47400,97,"""2""",47940,48000
7057,101005,102004,60,48000,97,"""2""",48000,48060
7057,102004,107000,120,48000,97,"""2""",48060,48180
7057,107000,114000,120,48000,97,"""2""",48180,48300
7057,114000,104002,120,48000,97,"""2""",48300,48420
7057,104002,111002,60,48000,97,"""2""",48420,48480
7057,111002,111102,60,48000,97,"""2""",48480,48540
7057,111102,112109,60,48000,97,"""2""",48540,48600
7057,101005,102004,60,48600,97,"""2""",48600,48660
7057,102004,107000,120,48600,97,"""2""",48660,48780
7057,107000,114000,120,48600,97,"""2""",48780,48900
7057,114000,104002,120,48600,97,"""2""",48900,49020
7057,104002,111002,60,48600,97,"""2""",49020,49080
7057,111002,111102,60,48600,97,"""2""",49080,49140
7057,111102,112109,60,48600,97,"""2""",49140,49200
7057,101005,102004,60,49200,97,"""2""",49200,49260
7057,102004,107000,120,49200,97,"""2""",49260,49380
7057,107000,114000,120,49200,97,"""2""",49380,49500
7057,114000,104002,120,49200,97,"""2""",49500,49620
7057,104002,111002,60,49200,97,"""2""",49620,49680
7057,111002,111102,60,49200,97,"""2""",49680,49740
7057,111102,112109,60,49200,97,"""2""",49740,49800
7057,101005,102004,60,49800,97,"""2""",49800,49860
7057,102004,107000,120,49800,97,"""2""",49860,49980
7057,107000,114000,120,49800,97,"""2""",49980,50100
7057,114000,104002,120,49800,97,"""2""",50100,50220
7057,104002,111002,60,49800,97,"""2""",50220,50280
7057,111002,111102,60,49800,97,"""2""",50280,50340
7057,111102,112109,60,49800,97,"""2""",50340,50400
7057,101005,102004,60,50400,97,"""2""",50400,50460
7057,102004,107000,120,50400,97,"""2""",50460,50580
7057,107000,114000,120,50400,97,"""2""",50580,50700
7057,114000,104002,120,50400,97,"""2""",50700,50820
7057,104002,111002,60,50400,97,"""2""",50820,50880
7057,111002,111102,60,50400,97,"""2""",50880,50940
7057,111102,112109,60,50400,97,"""2""",50940,51000
7057,101005,102004,60,51000,97,"""2""",51000,51060
7057,102004,107000,120,51000,97,"""2""",51060,51180
7057,107000,114000,120,51000,97,"""2""",51180,51300
7057,114000,104002,120,51000,97,"""2""",51300,51420
7057,104002,111002,60,51000,97,"""2""",51420,51480
7057,111002,111102,60,51000,97,"""2""",51480,51540
7057,111102,112109,60,51000,97,"""2""",51540,51600
7057,101005,102004,60,51600,97,"""2""",51600,51660
7057,102004,107000,120,51600,97,"""2""",51660,51780
7057,107000,114000,120,51600,97,"""2""",51780,51900
7057,114000,104002,120,51600,97,"""2""",51900,52020
7057,104002,111002,60,51600,97,"""2""",52020,52080
7057,111002,111102,60,51600,97,"""2""",52080,52140
7057,111102,112109,60,51600,97,"""2""",52140,52200
7057,101005,102004,60,52200,97,"""2""",52200,52260
7057,102004,107000,120,52200,97,"""2""",52260,52380
7057,107000,114000,120,52200,97,"""2""",52380,52500
7057,114000,104002,120,52200,97,"""2""",52500,52620
7057,104002,111002,60,52200,97,"""2""",52620,52680
7057,111002,111102,60,52200,97,"""2""",52680,52740
7057,111102,112109,60,52200,97,"""2""",52740,52800
7057,101005,102004,60,52800,97,"""2""",52800,52860
7057,102004,107000,120,52800,97,"""2""",52860,52980
7057,107000,114000,120,52800,97,"""2""",52980,53100
7057,114000,104002,120,52800,97,"""2""",53100,53220
7057,104002,111002,60,52800,97,"""2""",53220,53280
7057,111002,111102,60,52800,97,"""2""",53280,53340
7057,111102,112109,60,52800,97,"""2""",53340,53400
7057,101005,102004,60,53400,97,"""2""",53400,53460
7057,102004,107000,120,53400,97,"""2""",53460,53580
7057,107000,114000,120,53400,97,"""2""",53580,53700
7057,114000,104002,120,53400,97,"""2""",53700,53820
7057,104002,111002,60,53400,97,"""2""",53820,53880
7057,111002,111102,60,53400,97,"""2""",53880,53940
7057,111102,112109,60,53400,97,"""2""",53940,54000
7057,101005,102004,60,54000,97,"""2""",54000,54060
7057,102004,107000,120,54000,97,"""2""",54060,54180
7057,107000,114000,120,54000,97,"""2""",54180,54300
7057,114000,104002,120,54000,97,"""2""",54300,54420
7057,104002,111002,60,54000,97,"""2""",54420,54480
7057,111002,111102,60,54000,97,"""2""",54480,54540
7057,111102,112109,60,54000,97,"""2""",54540,54600
7057,101005,102004,60,54600,97,"""2""",54600,54660
7057,102004,107000,120,54600,97,"""2""",54660,54780
7057,107000,114000,120,54600,97,"""2""",54780,54900
7057,114000,104002,120,54600,97,"""2""",54900,55020
7057,104002,111002,60,54600,97,"""2""",55020,55080
7057,111002,111102,60,54600,97,"""2""",55080,55140
7057,111102,112109,60,54600,97,"""2""",55140,55200
7057,101005,102004,60,55200,97,"""2""",55200,55260
7057,102004,107000,120,55200,97,"""2""",55260,55380
7057,107000,114000,120,55200,97,"""2""",55380,55500
7057,114000,104002,120,55200,97,"""2""",55500,55620
7057,104002,111002,60,55200,97,"""2""",55620,55680
7057,111002,111102,60,55200,97,"""2""",55680,55740
7057,111102,112109,60,55200,97,"""2""",55740,55800
7057,101005,102004,60,55800,97,"""2""",55800,55860
7057,102004,107000,120,55800,97,"""2""",55860,55980
7057,107000,114000,120,55800,97,"""2""",55980,56100
7057,114000,104002,120,55800,97,"""2""",56100,56220
7057,104002,111002,60,55800,97,"""2""",56220,56280
7057,111002,111102,60,55800,97,"""2""",56280,56340
7057,111102,112109,60,55800,97,"""2""",56340,56400
7057,101005,102004,60,56400,97,"""2""",56400,56460
7057,102004,107000,120,56400,97,"""2""",56460,56580
7057,107000,114000,120,56400,97,"""2""",56580,56700
7057,114000,104002,120,56400,97,"""2""",56700,56820
7057,104002,111002,60,56400,97,"""2""",56820,56880
7057,111002,111102,60,56400,97,"""2""",56880,56940
7057,111102,112109,60,56400,97,"""2""",56940,57000
7057,101005,102004,60,57000,97,"""2""",57000,57060
7057,102004,107000,120,57000,97,"""2""",57060,57180
7057,107000,114000,120,57000,97,"""2""",57180,57300
7057,114000,104002,120,57000,97,"""2""",57300,57420
7057,104002,111002,60,57000,97,"""2""",57420,57480
7057,111002,111102,60,57000,97,"""2""",57480,57540
7057,111102,112109,60,57000,97,"""2""",57540,57600
7057,101005,102004,60,57600,97,"""2""",57600,57660
7057,102004,107000,120,57600,97,"""2""",57660,57780
7057,107000,114000,120,57600,97,"""2""",57780,57900
7057,114000,104002,120,57600,97,"""2""",57900,58020
7057,104002,111002,60,57600,97,"""2""",58020,58080
7057,111002,111102,60,57600,97,"""2""",58080,58140
7057,111102,112109,60,57600,97,"""2""",58140,58200
7057,101005,102004,60,58200,97,"""2""",58200,58260
7057,102004,107000,120,58200,97,"""2""",58260,58380
7057,107000,114000,120,58200,97,"""2""",58380,58500
7057,114000,104002,120,58200,97,"""2""",58500,58620
7057,104002,111002,60,58200,97,"""2""",58620,58680
7057,111002,111102,60,58200,97,"""2""",58680,58740
7057,111102,112109,60,58200,97,"""2""",58740,58800
7057,101005,102004,60,58800,97,"""2""",58800,58860
7057,102004,107000,120,58800,97,"""2""",58860,58980
7057,107000,114000,120,58800,97,"""2""",58980,59100
7057,114000,104002,120,58800,97,"""2""",59100,59220
7057,104002,111002,60,58800,97,"""2""",59220,59280
7057,111002,111102,60,58800,97,"""2""",59280,59340
7057,111102,112109,60,58800,97,"""2""",59340,59400
7057,101005,102004,60,59400,97,"""2""",59400,59460
7057,102004,107000,120,59400,97,"""2""",59460,59580
7057,107000,114000,120,59400,97,"""2""",59580,59700
7057,114000,104002,120,59400,97,"""2""",59700,59820
7057,104002,111002,60,59400,97,"""2""",59820,59880
7057,111002,111102,60,59400,97,"""2""",59880,59940
7057,111102,112109,60,59400,97,"""2""",59940,60000
7057,101005,102004,60,60000,97,"""2""",60000,60060
7057,102004,107000,120,60000,97,"""2""",60060,60180
7057,107000,114000,120,60000,97,"""2""",60180,60300
7057,114000,104002,120,60000,97,"""2""",60300,60420
7057,104002,111002,60,60000,97,"""2""",60420,60480
7057,111002,111102,60,60000,97,"""2""",60480,60540
7057,111102,112109,60,60000,97,"""2""",60540,60600
7057,101005,102004,60,60600,97,"""2""",60600,60660
7057,102004,107000,120,60600,97,"""2""",60660,60780
7057,107000,114000,120,60600,97,"""2""",60780,60900
7057,114000,104002,120,60600,97,"""2""",60900,61020
7057,104002,111002,60,60600,97,"""2""",61020,61080
7057,111002,111102,60,60600,97,"""2""",61080,61140
7057,111102,112109,60,60600,97,"""2""",61140,61200
7057,101005,102004,60,61200,97,"""2""",61200,61260
7057,102004,107000,120,61200,97,"""2""",61260,61380
7057,107000,114000,120,61200,97,"""2""",61380,61500
7057,114000,104002,120,61200,97,"""2""",61500,61620
7057,104002,111002,60,61200,97,"""2""",61620,61680
7057,111002,111102,60,61200,97,"""2""",61680,61740
7057,111102,112109,60,61200,97,"""2""",61740,61800
7057,101005,102004,60,61800,97,"""2""",61800,61860
7057,102004,107000,120,61800,97,"""2""",61860,61980
7057,107000,114000,120,61800,97,"""2""",61980,62100
7057,114000,104002,120,61800,97,"""2""",62100,62220
7057,104002,111002,60,61800,97,"""2""",62220,62280
7057,111002,111102,60,61800,97,"""2""",62280,62340
7057,111102,112109,60,61800,97,"""2""",62340,62400
7057,101005,102004,60,62400,97,"""2""",62400,62460
7057,102004,107000,120,62400,97,"""2""",62460,62580
7057,107000,114000,120,62400,97,"""2""",62580,62700
7057,114000,104002,120,62400,97,"""2""",62700,62820
7057,104002,111002,60,62400,97,"""2""",62820,62880
7057,111002,111102,60,62400,97,"""2""",62880,62940
7057,111102,112109,60,62400,97,"""2""",62940,63000
7057,101005,102004,60,63000,97,"""2""",63000,63060
7057,102004,107000,120,63000,97,"""2""",63060,63180
7057,107000,114000,120,63000,97,"""2""",63180,63300
7057,114000,104002,120,63000,97,"""2""",63300,63420
7057,104002,111002,60,63000,97,"""2""",63420,63480
7057,111002,111102,60,63000,97,"""2""",63480,63540
7057,111102,112109,60,63000,97,"""2""",63540,63600
7057,101005,102004,60,63600,97,"""2""",63600,63660
7057,102004,107000,120,63600,97,"""2""",63660,63780
7057,107000,114000,120,63600,97,"""2""",63780,63900
7057,114000,104002,120,63600,97,"""2""",63900,64020
7057,104002,111002,60,63600,97,"""2""",64020,64080
7057,111002,111102,60,63600,97,"""2""",64080,64140
7057,111102,112109,60,63600,97,"""2""",64140,64200
7057,101005,102004,60,64200,97,"""2""",64200,64260
7057,102004,107000,120,64200,97,"""2""",64260,64380
7057,107000,114000,120,64200,97,"""2""",64380,64500
7057,114000,104002,120,64200,97,"""2""",64500,64620
7057,104002,111002,60,64200,97,"""2""",64620,64680
7057,111002,111102,60,64200,97,"""2""",64680,64740
7057,111102,112109,60,64200,97,"""2""",64740,64800
7057,101005,102004,60,64800,97,"""2""",64800,64860
7057,102004,107000,120,64800,97,"""2""",64860,64980
7057,107000,114000,120,64800,97,"""2""",64980,65100
7057,114000,104002,120,64800,97,"""2""",65100,65220
7057,104002,111002,60,64800,97,"""2""",65220,65280
7057,111002,111102,60,64800,97,"""2""",65280,65340
7057,111102,112109,60,64800,97,"""2""",65340,65400
7057,101005,102004,60,65400,97,"""2""",65400,65460
7057,102004,107000,120,65400,97,"""2""",65460,65580
7057,107000,114000,120,65400,97,"""2""",65580,65700
7057,114000,104002,120,65400,97,"""2""",65700,65820
7057,104002,111002,60,65400,97,"""2""",65820,65880
7057,111002,111102,60,65400,97,"""2""",65880,65940
7057,111102,112109,60,65400,97,"""2""",65940,66000
7057,101005,102004,60,66000,97,"""2""",66000,66060
7057,102004,107000,120,66000,97,"""2""",66060,66180
7057,107000,114000,120,66000,97,"""2""",66180,66300
7057,114000,104002,120,66000,97,"""2""",66300,66420
7057,104002,111002,60,66000,97,"""2""",66420,66480
7057,111002,111102,60,66000,97,"""2""",66480,66540
7057,111102,112109,60,66000,97,"""2""",66540,66600
7057,101005,102004,60,66600,97,"""2""",66600,66660
7057,102004,107000,120,66600,97,"""2""",66660,66780
7057,107000,114000,120,66600,97,"""2""",66780,66900
7057,114000,104002,120,66600,97,"""2""",66900,67020
7057,104002,111002,60,66600,97,"""2""",67020,67080
7057,111002,111102,60,66600,97,"""2""",67080,67140
7057,111102,112109,60,66600,97,"""2""",67140,67200
7057,101005,102004,60,67200,97,"""2""",67200,67260
7057,102004,107000,120,67200,97,"""2""",67260,67380
7057,107000,114000,120,67200,97,"""2""",67380,67500
7057,114000,104002,120,67200,97,"""2""",67500,67620
7057,104002,111002,60,67200,97,"""2""",67620,67680
7057,111002,111102,60,67200,97,"""2""",67680,67740
7057,111102,112109,60,67200,97,"""2""",67740,67800
7057,101005,102004,60,67800,97,"""2""",67800,67860
7057,102004,107000,120,67800,97,"""2""",67860,67980
7057,107000,114000,120,67800,97,"""2""",67980,68100
7057,114000,104002,120,67800,97,"""2""",68100,68220
7057,104002,111002,60,67800,97,"""2""",68220,68280
7057,111002,111102,60,67800,97,"""2""",68280,68340
7057,111102,112109,60,67800,97,"""2""",68340,68400
7057,101005,102004,60,68400,97,"""2""",68400,68460
7057,102004,107000,120,68400,97,"""2""",68460,68580
7057,107000,114000,120,68400,97,"""2""",68580,68700
7057,114000,104002,120,68400,97,"""2""",68700,68820
7057,104002,111002,60,68400,97,"""2""",68820,68880
7057,111002,111102,60,68400,97,"""2""",68880,68940
7057,111102,112109,60,68400,97,"""2""",68940,69000
7057,101005,102004,60,69300,97,"""2""",69300,69360
7057,102004,107000,120,69300,97,"""2""",69360,69480
7057,107000,114000,120,69300,97,"""2""",69480,69600
7057,114000,104002,120,69300,97,"""2""",69600,69720
7057,104002,111002,60,69300,97,"""2""",69720,69780
7057,111002,111102,60,69300,97,"""2""",69780,69840
7057,111102,112109,60,69300,97,"""2""",69840,69900
7057,101005,102004,60,70200,97,"""2""",70200,70260
7057,102004,107000,120,70200,97,"""2""",70260,70380
7057,107000,114000,120,70200,97,"""2""",70380,70500
7057,114000,104002,120,70200,97,"""2""",70500,70620
7057,104002,111002,60,70200,97,"""2""",70620,70680
7057,111002,111102,60,70200,97,"""2""",70680,70740
7057,111102,112109,60,70200,97,"""2""",70740,70800
7057,101005,102004,60,71100,97,"""2""",71100,71160
7057,102004,107000,120,71100,97,"""2""",71160,71280
7057,107000,114000,120,71100,97,"""2""",71280,71400
7057,114000,104002,120,71100,97,"""2""",71400,71520
7057,104002,111002,60,71100,97,"""2""",71520,71580
7057,111002,111102,60,71100,97,"""2""",71580,71640
7057,111102,112109,60,71100,97,"""2""",71640,71700
7057,101005,102004,60,72000,97,"""2""",72000,72060
7057,102004,107000,120,72000,97,"""2""",72060,72180
7057,107000,114000,120,72000,97,"""2""",72180,72300
7057,114000,104002,120,72000,97,"""2""",72300,72420
7057,104002,111002,60,72000,97,"""2""",72420,72480
7057,111002,111102,60,72000,97,"""2""",72480,72540
7057,111102,112109,60,72000,97,"""2""",72540,72600
7057,101005,102004,60,72900,97,"""2""",72900,72960
7057,102004,107000,120,72900,97,"""2""",72960,73080
7057,107000,114000,120,72900,97,"""2""",73080,73200
7057,114000,104002,120,72900,97,"""2""",73200,73320
7057,104002,111002,60,72900,97,"""2""",73320,73380
7057,111002,111102,60,72900,97,"""2""",73380,73440
7057,111102,112109,60,72900,97,"""2""",73440,73500
7090,17701,700101,60,26580,55,"""13""",26580,26640
7090,700101,202701,60,26580,55,"""13""",26640,26700
7090,202701,202302,60,26580,55,"""13""",26700,26760
7090,202302,700501,60,26580,55,"""13""",26760,26820
7090,700501,203201,60,26580,55,"""13""",26820,26880
7090,203201,203101,60,26580,55,"""13""",26880,26940
7090,203101,200201,60,26580,55,"""13""",26940,27000
7090,200201,201701,60,26580,55,"""13""",27000,27060
7090,201701,200701,60,26580,55,"""13""",27060,27120
7090,200701,204103,120,26580,55,"""13""",27120,27240
7090,204103,203604,60,26580,55,"""13""",27240,27300
7090,203604,201903,60,26580,55,"""13""",27300,27360
7090,201903,203900,120,26580,55,"""13""",27360,27480
7090,203900,201503,60,26580,55,"""13""",27480,27540
7090,201503,106503,420,26580,55,"""13""",27540,27960
7243,404400,408603,60,67320,3,"""3""",67320,67380
7243,408603,407801,60,67320,3,"""3""",67380,67440
7243,407801,400301,60,67320,3,"""3""",67440,67500
7243,400301,401202,60,67320,3,"""3""",67500,67560
7243,401202,400101,60,67320,3,"""3""",67560,67620
7243,400101,407302,60,67320,3,"""3""",67620,67680
7243,407302,408202,60,67320,3,"""3""",67680,67740
7243,408202,403104,120,67320,3,"""3""",67740,67860
7243,403104,112103,120,67320,3,"""3""",67860,67980
7243,112103,103001,180,67320,3,"""3""",67980,68160
7243,103001,8001,120,67320,3,"""3""",68160,68280
7243,8001,105001,60,67320,3,"""3""",68280,68340
7243,105001,34103,60,67320,3,"""3""",68340,68400
7243,34103,208102,120,67320,3,"""3""",68400,68520
7243,208102,201502,120,67320,3,"""3""",68520,68640
7243,201502,203904,120,67320,3,"""3""",68640,68760
7243,203904,204802,60,67320,3,"""3""",68760,68820
7243,204802,204702,60,67320,3,"""3""",68820,68880
7243,204702,202801,60,67320,3,"""3""",68880,68940
7243,202801,205201,60,67320,3,"""3""",68940,69000
7243,205201,205102,60,67320,3,"""3""",69000,69060
7243,205102,201401,120,67320,3,"""3""",69060,69180
7243,201401,203301,60,67320,3,"""3""",69180,69240
7243,203301,205701,120,67320,3,"""3""",69240,69360
7243,205701,200301,60,67320,3,"""3""",69360,69420
7243,200301,208700,180,67320,3,"""3""",69420,69600
7244,404400,408603,60,75780,3,"""3""",75780,75840
7244,408603,407801,60,75780,3,"""3""",75840,75900
7244,407801,400301,60,75780,3,"""3""",75900,75960
7244,400301,401202,0,75780,3,"""3""",75960,75960
7244,401202,400101,60,75780,3,"""3""",75960,76020
7244,400101,407302,60,75780,3,"""3""",76020,76080
7244,407302,408202,60,75780,3,"""3""",76080,76140
7244,408202,403104,60,75780,3,"""3""",76140,76200
7244,403104,112103,120,75780,3,"""3""",76200,76320
7244,112103,103001,180,75780,3,"""3""",76320,76500
7244,103001,8001,120,75780,3,"""3""",76500,76620
7244,8001,105001,60,75780,3,"""3""",76620,76680
7244,105001,34103,60,75780,3,"""3""",76680,76740
7244,34103,208102,120,75780,3,"""3""",76740,76860
7244,208102,201502,120,75780,3,"""3""",76860,76980
7244,201502,203904,120,75780,3,"""3""",76980,77100
7244,203904,204802,60,75780,3,"""3""",77100,77160
7244,204802,204702,60,75780,3,"""3""",77160,77220
7244,204702,202801,60,75780,3,"""3""",77220,77280
7244,202801,205201,60,75780,3,"""3""",77280,77340
7244,205201,205102,60,75780,3,"""3""",77340,77400
7244,205102,201401,60,75780,3,"""3""",77400,77460
7244,201401,203301,60,75780,3,"""3""",77460,77520
7244,203301,205701,120,75780,3,"""3""",77520,77640
7244,205701,200301,60,75780,3,"""3""",77640,77700
7244,200301,208700,180,75780,3,"""3""",77700,77880
7244,404400,408603,60,79380,3,"""3""",79380,79440
7244,408603,407801,60,79380,3,"""3""",79440,79500
7244,407801,400301,60,79380,3,"""3""",79500,79560
7244,400301,401202,0,79380,3,"""3""",79560,79560
7244,401202,400101,60,79380,3,"""3""",79560,79620
7244,400101,407302,60,79380,3,"""3""",79620,79680
7244,407302,408202,60,79380,3,"""3""",79680,79740
7244,408202,403104,60,79380,3,"""3""",79740,79800
7244,403104,112103,120,79380,3,"""3""",79800,79920
7244,112103,103001,180,79380,3,"""3""",79920,80100
7244,103001,8001,120,79380,3,"""3""",80100,80220
7244,8001,105001,60,79380,3,"""3""",80220,80280
7244,105001,34103,60,79380,3,"""3""",80280,80340
7244,34103,208102,120,79380,3,"""3""",80340,80460
7244,208102,201502,120,79380,3,"""3""",80460,80580
7244,201502,203904,120,79380,3,"""3""",80580,80700
7244,203904,204802,60,79380,3,"""3""",80700,80760
7244,204802,204702,60,79380,3,"""3""",80760,80820
7244,204702,202801,60,79380,3,"""3""",80820,80880
7244,202801,205201,60,79380,3,"""3""",80880,80940
7244,205201,205102,60,79380,3,"""3""",80940,81000
7244,205102,201401,60,79380,3,"""3""",81000,81060
7244,201401,203301,60,79380,3,"""3""",81060,81120
7244,203301,205701,120,79380,3,"""3""",81120,81240
7244,205701,200301,60,79380,3,"""3""",81240,81300
7244,200301,208700,180,79380,3,"""3""",81300,81480
7244,404400,408603,60,82980,3,"""3""",82980,83040
7244,408603,407801,60,82980,3,"""3""",83040,83100
7244,407801,400301,60,82980,3,"""3""",83100,83160
7244,400301,401202,0,82980,3,"""3""",83160,83160
7244,401202,400101,60,82980,3,"""3""",83160,83220
7244,400101,407302,60,82980,3,"""3""",83220,83280
7244,407302,408202,60,82980,3,"""3""",83280,83340
7244,408202,403104,60,82980,3,"""3""",83340,83400
7244,403104,112103,120,82980,3,"""3""",83400,83520
7244,112103,103001,180,82980,3,"""3""",83520,83700
7244,103001,8001,120,82980,3,"""3""",83700,83820
7244,8001,105001,60,82980,3,"""3""",83820,83880
7244,105001,34103,60,82980,3,"""3""",83880,83940
7244,34103,208102,120,82980,3,"""3""",83940,84060
7244,208102,201502,120,82980,3,"""3""",84060,84180
7244,201502,203904,120,82980,3,"""3""",84180,84300
7244,203904,204802,60,82980,3,"""3""",84300,84360
7244,204802,204702,60,82980,3,"""3""",84360,84420
7244,204702,202801,60,82980,3,"""3""",84420,84480
7244,202801,205201,60,82980,3,"""3""",84480,84540
7244,205201,205102,60,82980,3,"""3""",84540,84600
7244,205102,201401,60,82980,3,"""3""",84600,84660
7244,201401,203301,60,82980,3,"""3""",84660,84720
7244,203301,205701,120,82980,3,"""3""",84720,84840
7244,205701,200301,60,82980,3,"""3""",84840,84900
7244,200301,208700,180,82980,3,"""3""",84900,85080
7248,208700,200302,60,67020,3,"""4""",67020,67080
7248,200302,205702,60,67020,3,"""4""",67080,67140
7248,205702,203302,60,67020,3,"""4""",67140,67200
7248,203302,201402,60,67020,3,"""4""",67200,67260
7248,201402,205103,180,67020,3,"""4""",67260,67440
7248,205103,205202,60,67020,3,"""4""",67440,67500
7248,205202,202802,60,67020,3,"""4""",67500,67560
7248,202802,204700,60,67020,3,"""4""",67560,67620
7248,204700,204801,120,67020,3,"""4""",67620,67740
7248,204801,203900,120,67020,3,"""4""",67740,67860
7248,203900,201503,60,67020,3,"""4""",67860,67920
7248,201503,208103,120,67020,3,"""4""",67920,68040
7248,208103,34104,60,67020,3,"""4""",68040,68100
7248,34104,105002,60,67020,3,"""4""",68100,68160
7248,105002,8002,60,67020,3,"""4""",68160,68220
7248,8002,103005,120,67020,3,"""4""",68220,68340
7248,103005,112104,180,67020,3,"""4""",68340,68520
7248,112104,403101,120,67020,3,"""4""",68520,68640
7248,403101,408203,60,67020,3,"""4""",68640,68700
7248,408203,407303,60,67020,3,"""4""",68700,68760
7248,407303,400102,60,67020,3,"""4""",68760,68820
7248,400102,401203,60,67020,3,"""4""",68820,68880
7248,401203,400302,60,67020,3,"""4""",68880,68940
7248,400302,407802,60,67020,3,"""4""",68940,69000
7248,407802,408602,60,67020,3,"""4""",69000,69060
7248,408602,404400,60,67020,3,"""4""",69060,69120
7249,208700,200302,60,70500,3,"""4""",70500,70560
7249,200302,205702,60,70500,3,"""4""",70560,70620
7249,205702,203302,60,70500,3,"""4""",70620,70680
7249,203302,201402,60,70500,3,"""4""",70680,70740
7249,201402,205103,120,70500,3,"""4""",70740,70860
7249,205103,205202,60,70500,3,"""4""",70860,70920
7249,205202,202802,60,70500,3,"""4""",70920,70980
7249,202802,204700,60,70500,3,"""4""",70980,71040
7249,204700,204801,60,70500,3,"""4""",71040,71100
7249,204801,203900,120,70500,3,"""4""",71100,71220
7249,203900,201503,60,70500,3,"""4""",71220,71280
7249,201503,208103,60,70500,3,"""4""",71280,71340
7249,208103,34104,60,70500,3,"""4""",71340,71400
7249,34104,105002,60,70500,3,"""4""",71400,71460
7249,105002,8002,60,70500,3,"""4""",71460,71520
7249,8002,103005,120,70500,3,"""4""",71520,71640
7249,103005,112104,180,70500,3,"""4""",71640,71820
7249,112104,403101,120,70500,3,"""4""",71820,71940
7249,403101,408203,60,70500,3,"""4""",71940,72000
7249,408203,407303,60,70500,3,"""4""",72000,72060
7249,407303,400102,60,70500,3,"""4""",72060,72120
7249,400102,401203,60,70500,3,"""4""",72120,72180
7249,401203,400302,0,70500,3,"""4""",72180,72180
7249,400302,407802,60,70500,3,"""4""",72180,72240
7249,407802,408602,60,70500,3,"""4""",72240,72300
7249,408602,404400,60,70500,3,"""4""",72300,72360
7250,205300,202502,60,74220,3,"""44""",74220,74280
7250,202502,207501,60,74220,3,"""44""",74280,74340
7250,207501,207703,60,74220,3,"""44""",74340,74400
7250,207703,205104,60,74220,3,"""44""",74400,74460
7250,205104,205202,60,74220,3,"""44""",74460,74520
7250,205202,202802,60,74220,3,"""44""",74520,74580
7250,202802,204700,60,74220,3,"""44""",74580,74640
7250,204700,204801,60,74220,3,"""44""",74640,74700
7250,204801,203900,120,74220,3,"""44""",74700,74820
7250,203900,201503,60,74220,3,"""44""",74820,74880
7250,201503,208103,60,74220,3,"""44""",74880,74940
7250,208103,34104,60,74220,3,"""44""",74940,75000
7250,34104,105002,60,74220,3,"""44""",75000,75060
7250,105002,8002,60,74220,3,"""44""",75060,75120
7250,8002,103005,120,74220,3,"""44""",75120,75240
7250,103005,112104,180,74220,3,"""44""",75240,75420
7250,112104,403101,120,74220,3,"""44""",75420,75540
7250,403101,408203,60,74220,3,"""44""",75540,75600
7250,408203,407303,60,74220,3,"""44""",75600,75660
7250,407303,400102,60,74220,3,"""44""",75660,75720
7250,400102,401203,60,74220,3,"""44""",75720,75780
7250,401203,400302,0,74220,3,"""44""",75780,75780
7250,400302,407802,60,74220,3,"""44""",75780,75840
7250,407802,408602,60,74220,3,"""44""",75840,75900
7250,408602,404400,60,74220,3,"""44""",75900,75960
7250,205300,202502,60,77820,3,"""44""",77820,77880
7250,202502,207501,60,77820,3,"""44""",77880,77940
7250,207501,207703,60,77820,3,"""44""",77940,78000
7250,207703,205104,60,77820,3,"""44""",78000,78060
7250,205104,205202,60,77820,3,"""44""",78060,78120
7250,205202,202802,60,77820,3,"""44""",78120,78180
7250,202802,204700,60,77820,3,"""44""",78180,78240
7250,204700,204801,60,77820,3,"""44""",78240,78300
7250,204801,203900,120,77820,3,"""44""",78300,78420
7250,203900,201503,60,77820,3,"""44""",78420,78480
7250,201503,208103,60,77820,3,"""44""",78480,78540
7250,208103,34104,60,77820,3,"""44""",78540,78600
7250,34104,105002,60,77820,3,"""44""",78600,78660
7250,105002,8002,60,77820,3,"""44""",78660,78720
7250,8002,103005,120,77820,3,"""44""",78720,78840
7250,103005,112104,180,77820,3,"""44""",78840,79020
7250,112104,403101,120,77820,3,"""44""",79020,79140
7250,403101,408203,60,77820,3,"""44""",79140,79200
7250,408203,407303,60,77820,3,"""44""",79200,79260
7250,407303,400102,60,77820,3,"""44""",79260,79320
7250,400102,401203,60,77820,3,"""44""",79320,79380
7250,401203,400302,0,77820,3,"""44""",79380,79380
7250,400302,407802,60,77820,3,"""44""",79380,79440
7250,407802,408602,60,77820,3,"""44""",79440,79500
7250,408602,404400,60,77820,3,"""44""",79500,79560
7250,205300,202502,60,81420,3,"""44""",81420,81480
7250,202502,207501,60,81420,3,"""44""",81480,81540
7250,207501,207703,60,81420,3,"""44""",81540,81600
7250,207703,205104,60,81420,3,"""44""",81600,81660
7250,205104,205202,60,81420,3,"""44""",81660,81720
7250,205202,202802,60,81420,3,"""44""",81720,81780
7250,202802,204700,60,81420,3,"""44""",81780,81840
7250,204700,204801,60,81420,3,"""44""",81840,81900
7250,204801,203900,120,81420,3,"""44""",81900,82020
7250,203900,201503,60,81420,3,"""44""",82020,82080
7250,201503,208103,60,81420,3,"""44""",82080,82140
7250,208103,34104,60,81420,3,"""44""",82140,82200
7250,34104,105002,60,81420,3,"""44""",82200,82260
7250,105002,8002,60,81420,3,"""44""",82260,82320
7250,8002,103005,120,81420,3,"""44""",82320,82440
7250,103005,112104,180,81420,3,"""44""",82440,82620
7250,112104,403101,120,81420,3,"""44""",82620,82740
7250,403101,408203,60,81420,3,"""44""",82740,82800
7250,408203,407303,60,81420,3,"""44""",82800,82860
7250,407303,400102,60,81420,3,"""44""",82860,82920
7250,400102,401203,60,81420,3,"""44""",82920,82980
7250,401203,400302,0,81420,3,"""44""",82980,82980
7250,400302,407802,60,81420,3,"""44""",82980,83040
7250,407802,408602,60,81420,3,"""44""",83040,83100
7250,408602,404400,60,81420,3,"""44""",83100,83160
7250,205300,202502,60,85020,3,"""44""",85020,85080
7250,202502,207501,60,85020,3,"""44""",85080,85140
7250,207501,207703,60,85020,3,"""44""",85140,85200
7250,207703,205104,60,85020,3,"""44""",85200,85260
7250,205104,205202,60,85020,3,"""44""",85260,85320
7250,205202,202802,60,85020,3,"""44""",85320,85380
7250,202802,204700,60,85020,3,"""44""",85380,85440
7250,204700,204801,60,85020,3,"""44""",85440,85500
7250,204801,203900,120,85020,3,"""44""",85500,85620
7250,203900,201503,60,85020,3,"""44""",85620,85680
7250,201503,208103,60,85020,3,"""44""",85680,85740
7250,208103,34104,60,85020,3,"""44""",85740,85800
7250,34104,105002,60,85020,3,"""44""",85800,85860
7250,105002,8002,60,85020,3,"""44""",85860,85920
7250,8002,103005,120,85020,3,"""44""",85920,86040
7250,103005,112104,180,85020,3,"""44""",86040,86220
7250,112104,403101,120,85020,3,"""44""",86220,86340
7250,403101,408203,60,85020,3,"""44""",86340,86400
7250,408203,407303,60,85020,3,"""44""",86400,86460
7250,407303,400102,60,85020,3,"""44""",86460,86520
7250,400102,401203,60,85020,3,"""44""",86520,86580
7250,401203,400302,0,85020,3,"""44""",86580,86580
7250,400302,407802,60,85020,3,"""44""",86580,86640
7250,407802,408602,60,85020,3,"""44""",86640,86700
7250,408602,404400,60,85020,3,"""44""",86700,86760
7251,203900,201503,60,26340,3,"""15""",26340,26400
7251,201503,208103,120,26340,3,"""15""",26400,26520
7251,208103,34104,60,26340,3,"""15""",26520,26580
7251,34104,105002,60,26340,3,"""15""",26580,26640
7251,105002,8002,60,26340,3,"""15""",26640,26700
7251,8002,103005,120,26340,3,"""15""",26700,26820
7251,103005,112104,180,26340,3,"""15""",26820,27000
7251,112104,403101,120,26340,3,"""15""",27000,27120
7251,403101,408203,60,26340,3,"""15""",27120,27180
7251,408203,407303,60,26340,3,"""15""",27180,27240
7251,407303,400102,60,26340,3,"""15""",27240,27300
7251,400102,401203,60,26340,3,"""15""",27300,27360
7251,401203,400302,60,26340,3,"""15""",27360,27420
7251,400302,407802,60,26340,3,"""15""",27420,27480
7251,407802,408602,60,26340,3,"""15""",27480,27540
7251,408602,404400,60,26340,3,"""15""",27540,27600
7254,100,302,60,24540,7,"""21""",24540,24600
7254,302,502,60,24540,7,"""21""",24600,24660
7254,502,202,60,24540,7,"""21""",24660,24720
7254,202,602,60,24540,7,"""21""",24720,24780
7254,602,408703,60,24540,7,"""21""",24780,24840
7254,408703,404002,60,24540,7,"""21""",24840,24900
7254,404002,405502,60,24540,7,"""21""",24900,24960
7254,405502,409102,60,24540,7,"""21""",24960,25020
7254,409102,400902,60,24540,7,"""21""",25020,25080
7254,400902,404502,60,24540,7,"""21""",25080,25140
7254,404502,406401,60,24540,7,"""21""",25140,25200
7254,406401,405103,60,24540,7,"""21""",25200,25260
7254,405103,407602,60,24540,7,"""21""",25260,25320
7254,407602,409003,120,24540,7,"""21""",25320,25440
7254,409003,403803,60,24540,7,"""21""",25440,25500
7254,403803,101103,120,24540,7,"""21""",25500,25620
7254,101103,115100,60,24540,7,"""21""",25620,25680
7254,115100,109015,120,24540,7,"""21""",25680,25800
7254,109015,112104,120,24540,7,"""21""",25800,25920
7254,112104,403101,120,24540,7,"""21""",25920,26040
7254,403101,409401,60,24540,7,"""21""",26040,26100
7254,409401,400103,120,24540,7,"""21""",26100,26220
7254,400103,409501,60,24540,7,"""21""",26220,26280
7254,409501,409701,60,24540,7,"""21""",26280,26340
7254,409701,409801,60,24540,7,"""21""",26340,26400
7254,409801,407505,120,24540,7,"""21""",26400,26520
7254,407505,405002,60,24540,7,"""21""",26520,26580
7254,405002,8101,60,24540,7,"""21""",26580,26640
7254,8101,404803,60,24540,7,"""21""",26640,26700
7254,404803,403401,60,24540,7,"""21""",26700,26760
7254,403401,502401,60,24540,7,"""21""",26760,26820
7254,502401,401303,120,24540,7,"""21""",26820,26940
7254,401303,26503,60,24540,7,"""21""",26940,27000
7254,26503,33903,120,24540,7,"""21""",27000,27120
7254,33903,34001,60,24540,7,"""21""",27120,27180
7254,34001,410201,120,24540,7,"""21""",27180,27300
7254,100,302,60,25680,7,"""21""",25680,25740
7254,302,502,60,25680,7,"""21""",25740,25800
7254,502,202,60,25680,7,"""21""",25800,25860
7254,202,602,60,25680,7,"""21""",25860,25920
7254,602,408703,60,25680,7,"""21""",25920,25980
7254,408703,404002,60,25680,7,"""21""",25980,26040
7254,404002,405502,60,25680,7,"""21""",26040,26100
7254,405502,409102,60,25680,7,"""21""",26100,26160
7254,409102,400902,60,25680,7,"""21""",26160,26220
7254,400902,404502,60,25680,7,"""21""",26220,26280
7254,404502,406401,60,25680,7,"""21""",26280,26340
7254,406401,405103,60,25680,7,"""21""",26340,26400
7254,405103,407602,60,25680,7,"""21""",26400,26460
7254,407602,409003,120,25680,7,"""21""",26460,26580
7254,409003,403803,60,25680,7,"""21""",26580,26640
7254,403803,101103,120,25680,7,"""21""",26640,26760
7254,101103,115100,60,25680,7,"""21""",26760,26820
7254,115100,109015,120,25680,7,"""21""",26820,26940
7254,109015,112104,120,25680,7,"""21""",26940,27060
7254,112104,403101,120,25680,7,"""21""",27060,27180
7254,403101,409401,60,25680,7,"""21""",27180,27240
7254,409401,400103,120,25680,7,"""21""",27240,27360
7254,400103,409501,60,25680,7,"""21""",27360,27420
7254,409501,409701,60,25680,7,"""21""",27420,27480
7254,409701,409801,60,25680,7,"""21""",27480,27540
7254,409801,407505,120,25680,7,"""21""",27540,27660
7254,407505,405002,60,25680,7,"""21""",27660,27720
7254,405002,8101,60,25680,7,"""21""",27720,27780
7254,8101,404803,60,25680,7,"""21""",27780,27840
7254,404803,403401,60,25680,7,"""21""",27840,27900
7254,403401,502401,60,25680,7,"""21""",27900,27960
7254,502401,401303,120,25680,7,"""21""",27960,28080
7254,401303,26503,60,25680,7,"""21""",28080,28140
7254,26503,33903,120,25680,7,"""21""",28140,28260
7254,33903,34001,60,25680,7,"""21""",28260,28320
7254,34001,410201,120,25680,7,"""21""",28320,28440
7254,100,302,60,26940,7,"""21""",26940,27000
7254,302,502,60,26940,7,"""21""",27000,27060
7254,502,202,60,26940,7,"""21""",27060,27120
7254,202,602,60,26940,7,"""21""",27120,27180
7254,602,408703,60,26940,7,"""21""",27180,27240
7254,408703,404002,60,26940,7,"""21""",27240,27300
7254,404002,405502,60,26940,7,"""21""",27300,27360
7254,405502,409102,60,26940,7,"""21""",27360,27420
7254,409102,400902,60,26940,7,"""21""",27420,27480
7254,400902,404502,60,26940,7,"""21""",27480,27540
7254,404502,406401,60,26940,7,"""21""",27540,27600
7254,406401,405103,60,26940,7,"""21""",27600,27660
7254,405103,407602,60,26940,7,"""21""",27660,27720
7254,407602,409003,120,26940,7,"""21""",27720,27840
7254,409003,403803,60,26940,7,"""21""",27840,27900
7254,403803,101103,120,26940,7,"""21""",27900,28020
7254,101103,115100,60,26940,7,"""21""",28020,28080
7254,115100,109015,120,26940,7,"""21""",28080,28200
7254,109015,112104,120,26940,7,"""21""",28200,28320
7254,112104,403101,120,26940,7,"""21""",28320,28440
7254,403101,409401,60,26940,7,"""21""",28440,28500
7254,409401,400103,120,26940,7,"""21""",28500,28620
7254,400103,409501,60,26940,7,"""21""",28620,28680
7254,409501,409701,60,26940,7,"""21""",28680,28740
7254,409701,409801,60,26940,7,"""21""",28740,28800
7254,409801,407505,120,26940,7,"""21""",28800,28920
7254,407505,405002,60,26940,7,"""21""",28920,28980
7254,405002,8101,60,26940,7,"""21""",28980,29040
7254,8101,404803,60,26940,7,"""21""",29040,29100
7254,404803,403401,60,26940,7,"""21""",29100,29160
7254,403401,502401,60,26940,7,"""21""",29160,29220
7254,502401,401303,120,26940,7,"""21""",29220,29340
7254,401303,26503,60,26940,7,"""21""",29340,29400
7254,26503,33903,120,26940,7,"""21""",29400,29520
7254,33903,34001,60,26940,7,"""21""",29520,29580
7254,34001,410201,120,26940,7,"""21""",29580,29700
7254,100,302,60,28140,7,"""21""",28140,28200
7254,302,502,60,28140,7,"""21""",28200,28260
7254,502,202,60,28140,7,"""21""",28260,28320
7254,202,602,60,28140,7,"""21""",28320,28380
7254,602,408703,60,28140,7,"""21""",28380,28440
7254,408703,404002,60,28140,7,"""21""",28440,28500
7254,404002,405502,60,28140,7,"""21""",28500,28560
7254,405502,409102,60,28140,7,"""21""",28560,28620
7254,409102,400902,60,28140,7,"""21""",28620,28680
7254,400902,404502,60,28140,7,"""21""",28680,28740
7254,404502,406401,60,28140,7,"""21""",28740,28800
7254,406401,405103,60,28140,7,"""21""",28800,28860
7254,405103,407602,60,28140,7,"""21""",28860,28920
7254,407602,409003,120,28140,7,"""21""",28920,29040
7254,409003,403803,60,28140,7,"""21""",29040,29100
7254,403803,101103,120,28140,7,"""21""",29100,29220
7254,101103,115100,60,28140,7,"""21""",29220,29280
7254,115100,109015,120,28140,7,"""21""",29280,29400
7254,109015,112104,120,28140,7,"""21""",29400,29520
7254,112104,403101,120,28140,7,"""21""",29520,29640
7254,403101,409401,60,28140,7,"""21""",29640,29700
7254,409401,400103,120,28140,7,"""21""",29700,29820
7254,400103,409501,60,28140,7,"""21""",29820,29880
7254,409501,409701,60,28140,7,"""21""",29880,29940
7254,409701,409801,60,28140,7,"""21""",29940,30000
7254,409801,407505,120,28140,7,"""21""",30000,30120
7254,407505,405002,60,28140,7,"""21""",30120,30180
7254,405002,8101,60,28140,7,"""21""",30180,30240
7254,8101,404803,60,28140,7,"""21""",30240,30300
7254,404803,403401,60,28140,7,"""21""",30300,30360
7254,403401,502401,60,28140,7,"""21""",30360,30420
7254,502401,401303,120,28140,7,"""21""",30420,30540
7254,401303,26503,60,28140,7,"""21""",30540,30600
7254,26503,33903,120,28140,7,"""21""",30600,30720
7254,33903,34001,60,28140,7,"""21""",30720,30780
7254,34001,410201,120,28140,7,"""21""",30780,30900
7254,100,302,60,29340,7,"""21""",29340,29400
7254,302,502,60,29340,7,"""21""",29400,29460
7254,502,202,60,29340,7,"""21""",29460,29520
7254,202,602,60,29340,7,"""21""",29520,29580
7254,602,408703,60,29340,7,"""21""",29580,29640
7254,408703,404002,60,29340,7,"""21""",29640,29700
7254,404002,405502,60,29340,7,"""21""",29700,29760
7254,405502,409102,60,29340,7,"""21""",29760,29820
7254,409102,400902,60,29340,7,"""21""",29820,29880
7254,400902,404502,60,29340,7,"""21""",29880,29940
7254,404502,406401,60,29340,7,"""21""",29940,30000
7254,406401,405103,60,29340,7,"""21""",30000,30060
7254,405103,407602,60,29340,7,"""21""",30060,30120
7254,407602,409003,120,29340,7,"""21""",30120,30240
7254,409003,403803,60,29340,7,"""21""",30240,30300
7254,403803,101103,120,29340,7,"""21""",30300,30420
7254,101103,115100,60,29340,7,"""21""",30420,30480
7254,115100,109015,120,29340,7,"""21""",30480,30600
7254,109015,112104,120,29340,7,"""21""",30600,30720
7254,112104,403101,120,29340,7,"""21""",30720,30840
7254,403101,409401,60,29340,7,"""21""",30840,30900
7254,409401,400103,120,29340,7,"""21""",30900,31020
7254,400103,409501,60,29340,7,"""21""",31020,31080
7254,409501,409701,60,29340,7,"""21""",31080,31140
7254,409701,409801,60,29340,7,"""21""",31140,31200
7254,409801,407505,120,29340,7,"""21""",31200,31320
7254,407505,405002,60,29340,7,"""21""",31320,31380
7254,405002,8101,60,29340,7,"""21""",31380,31440
7254,8101,404803,60,29340,7,"""21""",31440,31500
7254,404803,403401,60,29340,7,"""21""",31500,31560
7254,403401,502401,60,29340,7,"""21""",31560,31620
7254,502401,401303,120,29340,7,"""21""",31620,31740
7254,401303,26503,60,29340,7,"""21""",31740,31800
7254,26503,33903,120,29340,7,"""21""",31800,31920
7254,33903,34001,60,29340,7,"""21""",31920,31980
7254,34001,410201,120,29340,7,"""21""",31980,32100
7254,100,302,60,30540,7,"""21""",30540,30600
7254,302,502,60,30540,7,"""21""",30600,30660
7254,502,202,60,30540,7,"""21""",30660,30720
7254,202,602,60,30540,7,"""21""",30720,30780
7254,602,408703,60,30540,7,"""21""",30780,30840
7254,408703,404002,60,30540,7,"""21""",30840,30900
7254,404002,405502,60,30540,7,"""21""",30900,30960
7254,405502,409102,60,30540,7,"""21""",30960,31020
7254,409102,400902,60,30540,7,"""21""",31020,31080
7254,400902,404502,60,30540,7,"""21""",31080,31140
7254,404502,406401,60,30540,7,"""21""",31140,31200
7254,406401,405103,60,30540,7,"""21""",31200,31260
7254,405103,407602,60,30540,7,"""21""",31260,31320
7254,407602,409003,120,30540,7,"""21""",31320,31440
7254,409003,403803,60,30540,7,"""21""",31440,31500
7254,403803,101103,120,30540,7,"""21""",31500,31620
7254,101103,115100,60,30540,7,"""21""",31620,31680
7254,115100,109015,120,30540,7,"""21""",31680,31800
7254,109015,112104,120,30540,7,"""21""",31800,31920
7254,112104,403101,120,30540,7,"""21""",31920,32040
7254,403101,409401,60,30540,7,"""21""",32040,32100
7254,409401,400103,120,30540,7,"""21""",32100,32220
7254,400103,409501,60,30540,7,"""21""",32220,32280
7254,409501,409701,60,30540,7,"""21""",32280,32340
7254,409701,409801,60,30540,7,"""21""",32340,32400
7254,409801,407505,120,30540,7,"""21""",32400,32520
7254,407505,405002,60,30540,7,"""21""",32520,32580
7254,405002,8101,60,30540,7,"""21""",32580,32640
7254,8101,404803,60,30540,7,"""21""",32640,32700
7254,404803,403401,60,30540,7,"""21""",32700,32760
7254,403401,502401,60,30540,7,"""21""",32760,32820
7254,502401,401303,120,30540,7,"""21""",32820,32940
7254,401303,26503,60,30540,7,"""21""",32940,33000
7254,26503,33903,120,30540,7,"""21""",33000,33120
7254,33903,34001,60,30540,7,"""21""",33120,33180
7254,34001,410201,120,30540,7,"""21""",33180,33300
7254,100,302,60,31740,7,"""21""",31740,31800
7254,302,502,60,31740,7,"""21""",31800,31860
7254,502,202,60,31740,7,"""21""",31860,31920
7254,202,602,60,31740,7,"""21""",31920,31980
7254,602,408703,60,31740,7,"""21""",31980,32040
7254,408703,404002,60,31740,7,"""21""",32040,32100
7254,404002,405502,60,31740,7,"""21""",32100,32160
7254,405502,409102,60,31740,7,"""21""",32160,32220
7254,409102,400902,60,31740,7,"""21""",32220,32280
7254,400902,404502,60,31740,7,"""21""",32280,32340
7254,404502,406401,60,31740,7,"""21""",32340,32400
7254,406401,405103,60,31740,7,"""21""",32400,32460
7254,405103,407602,60,31740,7,"""21""",32460,32520
7254,407602,409003,120,31740,7,"""21""",32520,32640
7254,409003,403803,60,31740,7,"""21""",32640,32700
7254,403803,101103,120,31740,7,"""21""",32700,32820
7254,101103,115100,60,31740,7,"""21""",32820,32880
7254,115100,109015,120,31740,7,"""21""",32880,33000
7254,109015,112104,120,31740,7,"""21""",33000,33120
7254,112104,403101,120,31740,7,"""21""",33120,33240
7254,403101,409401,60,31740,7,"""21""",33240,33300
7254,409401,400103,120,31740,7,"""21""",33300,33420
7254,400103,409501,60,31740,7,"""21""",33420,33480
7254,409501,409701,60,31740,7,"""21""",33480,33540
7254,409701,409801,60,31740,7,"""21""",33540,33600
7254,409801,407505,120,31740,7,"""21""",33600,33720
7254,407505,405002,60,31740,7,"""21""",33720,33780
7254,405002,8101,60,31740,7,"""21""",33780,33840
7254,8101,404803,60,31740,7,"""21""",33840,33900
7254,404803,403401,60,31740,7,"""21""",33900,33960
7254,403401,502401,60,31740,7,"""21""",33960,34020
7254,502401,401303,120,31740,7,"""21""",34020,34140
7254,401303,26503,60,31740,7,"""21""",34140,34200
7254,26503,33903,120,31740,7,"""21""",34200,34320
7254,33903,34001,60,31740,7,"""21""",34320,34380
7254,34001,410201,120,31740,7,"""21""",34380,34500
7254,100,302,60,32940,7,"""21""",32940,33000
7254,302,502,60,32940,7,"""21""",33000,33060
7254,502,202,60,32940,7,"""21""",33060,33120
7254,202,602,60,32940,7,"""21""",33120,33180
7254,602,408703,60,32940,7,"""21""",33180,33240
7254,408703,404002,60,32940,7,"""21""",33240,33300
7254,404002,405502,60,32940,7,"""21""",33300,33360
7254,405502,409102,60,32940,7,"""21""",33360,33420
7254,409102,400902,60,32940,7,"""21""",33420,33480
7254,400902,404502,60,32940,7,"""21""",33480,33540
7254,404502,406401,60,32940,7,"""21""",33540,33600
7254,406401,405103,60,32940,7,"""21""",33600,33660
7254,405103,407602,60,32940,7,"""21""",33660,33720
7254,407602,409003,120,32940,7,"""21""",33720,33840
7254,409003,403803,60,32940,7,"""21""",33840,33900
7254,403803,101103,120,32940,7,"""21""",33900,34020
7254,101103,115100,60,32940,7,"""21""",34020,34080
7254,115100,109015,120,32940,7,"""21""",34080,34200
7254,109015,112104,120,32940,7,"""21""",34200,34320
7254,112104,403101,120,32940,7,"""21""",34320,34440
7254,403101,409401,60,32940,7,"""21""",34440,34500
7254,409401,400103,120,32940,7,"""21""",34500,34620
7254,400103,409501,60,32940,7,"""21""",34620,34680
7254,409501,409701,60,32940,7,"""21""",34680,34740
7254,409701,409801,60,32940,7,"""21""",34740,34800
7254,409801,407505,120,32940,7,"""21""",34800,34920
7254,407505,405002,60,32940,7,"""21""",34920,34980
7254,405002,8101,60,32940,7,"""21""",34980,35040
7254,8101,404803,60,32940,7,"""21""",35040,35100
7254,404803,403401,60,32940,7,"""21""",35100,35160
7254,403401,502401,60,32940,7,"""21""",35160,35220
7254,502401,401303,120,32940,7,"""21""",35220,35340
7254,401303,26503,60,32940,7,"""21""",35340,35400
7254,26503,33903,120,32940,7,"""21""",35400,35520
7254,33903,34001,60,32940,7,"""21""",35520,35580
7254,34001,410201,120,32940,7,"""21""",35580,35700
7254,100,302,60,34140,7,"""21""",34140,34200
7254,302,502,60,34140,7,"""21""",34200,34260
7254,502,202,60,34140,7,"""21""",34260,34320
7254,202,602,60,34140,7,"""21""",34320,34380
7254,602,408703,60,34140,7,"""21""",34380,34440
7254,408703,404002,60,34140,7,"""21""",34440,34500
7254,404002,405502,60,34140,7,"""21""",34500,34560
7254,405502,409102,60,34140,7,"""21""",34560,34620
7254,409102,400902,60,34140,7,"""21""",34620,34680
7254,400902,404502,60,34140,7,"""21""",34680,34740
7254,404502,406401,60,34140,7,"""21""",34740,34800
7254,406401,405103,60,34140,7,"""21""",34800,34860
7254,405103,407602,60,34140,7,"""21""",34860,34920
7254,407602,409003,120,34140,7,"""21""",34920,35040
7254,409003,403803,60,34140,7,"""21""",35040,35100
7254,403803,101103,120,34140,7,"""21""",35100,35220
7254,101103,115100,60,34140,7,"""21""",35220,35280
7254,115100,109015,120,34140,7,"""21""",35280,35400
7254,109015,112104,120,34140,7,"""21""",35400,35520
7254,112104,403101,120,34140,7,"""21""",35520,35640
7254,403101,409401,60,34140,7,"""21""",35640,35700
7254,409401,400103,120,34140,7,"""21""",35700,35820
7254,400103,409501,60,34140,7,"""21""",35820,35880
7254,409501,409701,60,34140,7,"""21""",35880,35940
7254,409701,409801,60,34140,7,"""21""",35940,36000
7254,409801,407505,120,34140,7,"""21""",36000,36120
7254,407505,405002,60,34140,7,"""21""",36120,36180
7254,405002,8101,60,34140,7,"""21""",36180,36240
7254,8101,404803,60,34140,7,"""21""",36240,36300
7254,404803,403401,60,34140,7,"""21""",36300,36360
7254,403401,502401,60,34140,7,"""21""",36360,36420
7254,502401,401303,120,34140,7,"""21""",36420,36540
7254,401303,26503,60,34140,7,"""21""",36540,36600
7254,26503,33903,120,34140,7,"""21""",36600,36720
7254,33903,34001,60,34140,7,"""21""",36720,36780
7254,34001,410201,120,34140,7,"""21""",36780,36900
7254,100,302,60,35340,7,"""21""",35340,35400
7254,302,502,60,35340,7,"""21""",35400,35460
7254,502,202,60,35340,7,"""21""",35460,35520
7254,202,602,60,35340,7,"""21""",35520,35580
7254,602,408703,60,35340,7,"""21""",35580,35640
7254,408703,404002,60,35340,7,"""21""",35640,35700
7254,404002,405502,60,35340,7,"""21""",35700,35760
7254,405502,409102,60,35340,7,"""21""",35760,35820
7254,409102,400902,60,35340,7,"""21""",35820,35880
7254,400902,404502,60,35340,7,"""21""",35880,35940
7254,404502,406401,60,35340,7,"""21""",35940,36000
7254,406401,405103,60,35340,7,"""21""",36000,36060
7254,405103,407602,60,35340,7,"""21""",36060,36120
7254,407602,409003,120,35340,7,"""21""",36120,36240
7254,409003,403803,60,35340,7,"""21""",36240,36300
7254,403803,101103,120,35340,7,"""21""",36300,36420
7254,101103,115100,60,35340,7,"""21""",36420,36480
7254,115100,109015,120,35340,7,"""21""",36480,36600
7254,109015,112104,120,35340,7,"""21""",36600,36720
7254,112104,403101,120,35340,7,"""21""",36720,36840
7254,403101,409401,60,35340,7,"""21""",36840,36900
7254,409401,400103,120,35340,7,"""21""",36900,37020
7254,400103,409501,60,35340,7,"""21""",37020,37080
7254,409501,409701,60,35340,7,"""21""",37080,37140
7254,409701,409801,60,35340,7,"""21""",37140,37200
7254,409801,407505,120,35340,7,"""21""",37200,37320
7254,407505,405002,60,35340,7,"""21""",37320,37380
7254,405002,8101,60,35340,7,"""21""",37380,37440
7254,8101,404803,60,35340,7,"""21""",37440,37500
7254,404803,403401,60,35340,7,"""21""",37500,37560
7254,403401,502401,60,35340,7,"""21""",37560,37620
7254,502401,401303,120,35340,7,"""21""",37620,37740
7254,401303,26503,60,35340,7,"""21""",37740,37800
7254,26503,33903,120,35340,7,"""21""",37800,37920
7254,33903,34001,60,35340,7,"""21""",37920,37980
7254,34001,410201,120,35340,7,"""21""",37980,38100
7254,100,302,60,36540,7,"""21""",36540,36600
7254,302,502,60,36540,7,"""21""",36600,36660
7254,502,202,60,36540,7,"""21""",36660,36720
7254,202,602,60,36540,7,"""21""",36720,36780
7254,602,408703,60,36540,7,"""21""",36780,36840
7254,408703,404002,60,36540,7,"""21""",36840,36900
7254,404002,405502,60,36540,7,"""21""",36900,36960
7254,405502,409102,60,36540,7,"""21""",36960,37020
7254,409102,400902,60,36540,7,"""21""",37020,37080
7254,400902,404502,60,36540,7,"""21""",37080,37140
7254,404502,406401,60,36540,7,"""21""",37140,37200
7254,406401,405103,60,36540,7,"""21""",37200,37260
7254,405103,407602,60,36540,7,"""21""",37260,37320
7254,407602,409003,120,36540,7,"""21""",37320,37440
7254,409003,403803,60,36540,7,"""21""",37440,37500
7254,403803,101103,120,36540,7,"""21""",37500,37620
7254,101103,115100,60,36540,7,"""21""",37620,37680
7254,115100,109015,120,36540,7,"""21""",37680,37800
7254,109015,112104,120,36540,7,"""21""",37800,37920
7254,112104,403101,120,36540,7,"""21""",37920,38040
7254,403101,409401,60,36540,7,"""21""",38040,38100
7254,409401,400103,120,36540,7,"""21""",38100,38220
7254,400103,409501,60,36540,7,"""21""",38220,38280
7254,409501,409701,60,36540,7,"""21""",38280,38340
7254,409701,409801,60,36540,7,"""21""",38340,38400
7254,409801,407505,120,36540,7,"""21""",38400,38520
7254,407505,405002,60,36540,7,"""21""",38520,38580
7254,405002,8101,60,36540,7,"""21""",38580,38640
7254,8101,404803,60,36540,7,"""21""",38640,38700
7254,404803,403401,60,36540,7,"""21""",38700,38760
7254,403401,502401,60,36540,7,"""21""",38760,38820
7254,502401,401303,120,36540,7,"""21""",38820,38940
7254,401303,26503,60,36540,7,"""21""",38940,39000
7254,26503,33903,120,36540,7,"""21""",39000,39120
7254,33903,34001,60,36540,7,"""21""",39120,39180
7254,34001,410201,120,36540,7,"""21""",39180,39300
7254,100,302,60,37740,7,"""21""",37740,37800
7254,302,502,60,37740,7,"""21""",37800,37860
7254,502,202,60,37740,7,"""21""",37860,37920
7254,202,602,60,37740,7,"""21""",37920,37980
7254,602,408703,60,37740,7,"""21""",37980,38040
7254,408703,404002,60,37740,7,"""21""",38040,38100
7254,404002,405502,60,37740,7,"""21""",38100,38160
7254,405502,409102,60,37740,7,"""21""",38160,38220
7254,409102,400902,60,37740,7,"""21""",38220,38280
7254,400902,404502,60,37740,7,"""21""",38280,38340
7254,404502,406401,60,37740,7,"""21""",38340,38400
7254,406401,405103,60,37740,7,"""21""",38400,38460
7254,405103,407602,60,37740,7,"""21""",38460,38520
7254,407602,409003,120,37740,7,"""21""",38520,38640
7254,409003,403803,60,37740,7,"""21""",38640,38700
7254,403803,101103,120,37740,7,"""21""",38700,38820
7254,101103,115100,60,37740,7,"""21""",38820,38880
7254,115100,109015,120,37740,7,"""21""",38880,39000
7254,109015,112104,120,37740,7,"""21""",39000,39120
7254,112104,403101,120,37740,7,"""21""",39120,39240
7254,403101,409401,60,37740,7,"""21""",39240,39300
7254,409401,400103,120,37740,7,"""21""",39300,39420
7254,400103,409501,60,37740,7,"""21""",39420,39480
7254,409501,409701,60,37740,7,"""21""",39480,39540
7254,409701,409801,60,37740,7,"""21""",39540,39600
7254,409801,407505,120,37740,7,"""21""",39600,39720
7254,407505,405002,60,37740,7,"""21""",39720,39780
7254,405002,8101,60,37740,7,"""21""",39780,39840
7254,8101,404803,60,37740,7,"""21""",39840,39900
7254,404803,403401,60,37740,7,"""21""",39900,39960
7254,403401,502401,60,37740,7,"""21""",39960,40020
7254,502401,401303,120,37740,7,"""21""",40020,40140
7254,401303,26503,60,37740,7,"""21""",40140,40200
7254,26503,33903,120,37740,7,"""21""",40200,40320
7254,33903,34001,60,37740,7,"""21""",40320,40380
7254,34001,410201,120,37740,7,"""21""",40380,40500
7254,100,302,60,38940,7,"""21""",38940,39000
7254,302,502,60,38940,7,"""21""",39000,39060
7254,502,202,60,38940,7,"""21""",39060,39120
7254,202,602,60,38940,7,"""21""",39120,39180
7254,602,408703,60,38940,7,"""21""",39180,39240
7254,408703,404002,60,38940,7,"""21""",39240,39300
7254,404002,405502,60,38940,7,"""21""",39300,39360
7254,405502,409102,60,38940,7,"""21""",39360,39420
7254,409102,400902,60,38940,7,"""21""",39420,39480
7254,400902,404502,60,38940,7,"""21""",39480,39540
7254,404502,406401,60,38940,7,"""21""",39540,39600
7254,406401,405103,60,38940,7,"""21""",39600,39660
7254,405103,407602,60,38940,7,"""21""",39660,39720
7254,407602,409003,120,38940,7,"""21""",39720,39840
7254,409003,403803,60,38940,7,"""21""",39840,39900
7254,403803,101103,120,38940,7,"""21""",39900,40020
7254,101103,115100,60,38940,7,"""21""",40020,40080
7254,115100,109015,120,38940,7,"""21""",40080,40200
7254,109015,112104,120,38940,7,"""21""",40200,40320
7254,112104,403101,120,38940,7,"""21""",40320,40440
7254,403101,409401,60,38940,7,"""21""",40440,40500
7254,409401,400103,120,38940,7,"""21""",40500,40620
7254,400103,409501,60,38940,7,"""21""",40620,40680
7254,409501,409701,60,38940,7,"""21""",40680,40740
7254,409701,409801,60,38940,7,"""21""",40740,40800
7254,409801,407505,120,38940,7,"""21""",40800,40920
7254,407505,405002,60,38940,7,"""21""",40920,40980
7254,405002,8101,60,38940,7,"""21""",40980,41040
7254,8101,404803,60,38940,7,"""21""",41040,41100
7254,404803,403401,60,38940,7,"""21""",41100,41160
7254,403401,502401,60,38940,7,"""21""",41160,41220
7254,502401,401303,120,38940,7,"""21""",41220,41340
7254,401303,26503,60,38940,7,"""21""",41340,41400
7254,26503,33903,120,38940,7,"""21""",41400,41520
7254,33903,34001,60,38940,7,"""21""",41520,41580
7254,34001,410201,120,38940,7,"""21""",41580,41700
7254,100,302,60,40140,7,"""21""",40140,40200
7254,302,502,60,40140,7,"""21""",40200,40260
7254,502,202,60,40140,7,"""21""",40260,40320
7254,202,602,60,40140,7,"""21""",40320,40380
7254,602,408703,60,40140,7,"""21""",40380,40440
7254,408703,404002,60,40140,7,"""21""",40440,40500
7254,404002,405502,60,40140,7,"""21""",40500,40560
7254,405502,409102,60,40140,7,"""21""",40560,40620
7254,409102,400902,60,40140,7,"""21""",40620,40680
7254,400902,404502,60,40140,7,"""21""",40680,40740
7254,404502,406401,60,40140,7,"""21""",40740,40800
7254,406401,405103,60,40140,7,"""21""",40800,40860
7254,405103,407602,60,40140,7,"""21""",40860,40920
7254,407602,409003,120,40140,7,"""21""",40920,41040
7254,409003,403803,60,40140,7,"""21""",41040,41100
7254,403803,101103,120,40140,7,"""21""",41100,41220
7254,101103,115100,60,40140,7,"""21""",41220,41280
7254,115100,109015,120,40140,7,"""21""",41280,41400
7254,109015,112104,120,40140,7,"""21""",41400,41520
7254,112104,403101,120,40140,7,"""21""",41520,41640
7254,403101,409401,60,40140,7,"""21""",41640,41700
7254,409401,400103,120,40140,7,"""21""",41700,41820
7254,400103,409501,60,40140,7,"""21""",41820,41880
7254,409501,409701,60,40140,7,"""21""",41880,41940
7254,409701,409801,60,40140,7,"""21""",41940,42000
7254,409801,407505,120,40140,7,"""21""",42000,42120
7254,407505,405002,60,40140,7,"""21""",42120,42180
7254,405002,8101,60,40140,7,"""21""",42180,42240
7254,8101,404803,60,40140,7,"""21""",42240,42300
7254,404803,403401,60,40140,7,"""21""",42300,42360
7254,403401,502401,60,40140,7,"""21""",42360,42420
7254,502401,401303,120,40140,7,"""21""",42420,42540
7254,401303,26503,60,40140,7,"""21""",42540,42600
7254,26503,33903,120,40140,7,"""21""",42600,42720
7254,33903,34001,60,40140,7,"""21""",42720,42780
7254,34001,410201,120,40140,7,"""21""",42780,42900
7254,100,302,60,41340,7,"""21""",41340,41400
7254,302,502,60,41340,7,"""21""",41400,41460
7254,502,202,60,41340,7,"""21""",41460,41520
7254,202,602,60,41340,7,"""21""",41520,41580
7254,602,408703,60,41340,7,"""21""",41580,41640
7254,408703,404002,60,41340,7,"""21""",41640,41700
7254,404002,405502,60,41340,7,"""21""",41700,41760
7254,405502,409102,60,41340,7,"""21""",41760,41820
7254,409102,400902,60,41340,7,"""21""",41820,41880
7254,400902,404502,60,41340,7,"""21""",41880,41940
7254,404502,406401,60,41340,7,"""21""",41940,42000
7254,406401,405103,60,41340,7,"""21""",42000,42060
7254,405103,407602,60,41340,7,"""21""",42060,42120
7254,407602,409003,120,41340,7,"""21""",42120,42240
7254,409003,403803,60,41340,7,"""21""",42240,42300
7254,403803,101103,120,41340,7,"""21""",42300,42420
7254,101103,115100,60,41340,7,"""21""",42420,42480
7254,115100,109015,120,41340,7,"""21""",42480,42600
7254,109015,112104,120,41340,7,"""21""",42600,42720
7254,112104,403101,120,41340,7,"""21""",42720,42840
7254,403101,409401,60,41340,7,"""21""",42840,42900
7254,409401,400103,120,41340,7,"""21""",42900,43020
7254,400103,409501,60,41340,7,"""21""",43020,43080
7254,409501,409701,60,41340,7,"""21""",43080,43140
7254,409701,409801,60,41340,7,"""21""",43140,43200
7254,409801,407505,120,41340,7,"""21""",43200,43320
7254,407505,405002,60,41340,7,"""21""",43320,43380
7254,405002,8101,60,41340,7,"""21""",43380,43440
7254,8101,404803,60,41340,7,"""21""",43440,43500
7254,404803,403401,60,41340,7,"""21""",43500,43560
7254,403401,502401,60,41340,7,"""21""",43560,43620
7254,502401,401303,120,41340,7,"""21""",43620,43740
7254,401303,26503,60,41340,7,"""21""",43740,43800
7254,26503,33903,120,41340,7,"""21""",43800,43920
7254,33903,34001,60,41340,7,"""21""",43920,43980
7254,34001,410201,120,41340,7,"""21""",43980,44100
7254,100,302,60,42540,7,"""21""",42540,42600
7254,302,502,60,42540,7,"""21""",42600,42660
7254,502,202,60,42540,7,"""21""",42660,42720
7254,202,602,60,42540,7,"""21""",42720,42780
7254,602,408703,60,42540,7,"""21""",42780,42840
7254,408703,404002,60,42540,7,"""21""",42840,42900
7254,404002,405502,60,42540,7,"""21""",42900,42960
7254,405502,409102,60,42540,7,"""21""",42960,43020
7254,409102,400902,60,42540,7,"""21""",43020,43080
7254,400902,404502,60,42540,7,"""21""",43080,43140
7254,404502,406401,60,42540,7,"""21""",43140,43200
7254,406401,405103,60,42540,7,"""21""",43200,43260
7254,405103,407602,60,42540,7,"""21""",43260,43320
7254,407602,409003,120,42540,7,"""21""",43320,43440
7254,409003,403803,60,42540,7,"""21""",43440,43500
7254,403803,101103,120,42540,7,"""21""",43500,43620
7254,101103,115100,60,42540,7,"""21""",43620,43680
7254,115100,109015,120,42540,7,"""21""",43680,43800
7254,109015,112104,120,42540,7,"""21""",43800,43920
7254,112104,403101,120,42540,7,"""21""",43920,44040
7254,403101,409401,60,42540,7,"""21""",44040,44100
7254,409401,400103,120,42540,7,"""21""",44100,44220
7254,400103,409501,60,42540,7,"""21""",44220,44280
7254,409501,409701,60,42540,7,"""21""",44280,44340
7254,409701,409801,60,42540,7,"""21""",44340,44400
7254,409801,407505,120,42540,7,"""21""",44400,44520
7254,407505,405002,60,42540,7,"""21""",44520,44580
7254,405002,8101,60,42540,7,"""21""",44580,44640
7254,8101,404803,60,42540,7,"""21""",44640,44700
7254,404803,403401,60,42540,7,"""21""",44700,44760
7254,403401,502401,60,42540,7,"""21""",44760,44820
7254,502401,401303,120,42540,7,"""21""",44820,44940
7254,401303,26503,60,42540,7,"""21""",44940,45000
7254,26503,33903,120,42540,7,"""21""",45000,45120
7254,33903,34001,60,42540,7,"""21""",45120,45180
7254,34001,410201,120,42540,7,"""21""",45180,45300
7254,100,302,60,43740,7,"""21""",43740,43800
7254,302,502,60,43740,7,"""21""",43800,43860
7254,502,202,60,43740,7,"""21""",43860,43920
7254,202,602,60,43740,7,"""21""",43920,43980
7254,602,408703,60,43740,7,"""21""",43980,44040
7254,408703,404002,60,43740,7,"""21""",44040,44100
7254,404002,405502,60,43740,7,"""21""",44100,44160
7254,405502,409102,60,43740,7,"""21""",44160,44220
7254,409102,400902,60,43740,7,"""21""",44220,44280
7254,400902,404502,60,43740,7,"""21""",44280,44340
7254,404502,406401,60,43740,7,"""21""",44340,44400
7254,406401,405103,60,43740,7,"""21""",44400,44460
7254,405103,407602,60,43740,7,"""21""",44460,44520
7254,407602,409003,120,43740,7,"""21""",44520,44640
7254,409003,403803,60,43740,7,"""21""",44640,44700
7254,403803,101103,120,43740,7,"""21""",44700,44820
7254,101103,115100,60,43740,7,"""21""",44820,44880
7254,115100,109015,120,43740,7,"""21""",44880,45000
7254,109015,112104,120,43740,7,"""21""",45000,45120
7254,112104,403101,120,43740,7,"""21""",45120,45240
7254,403101,409401,60,43740,7,"""21""",45240,45300
7254,409401,400103,120,43740,7,"""21""",45300,45420
7254,400103,409501,60,43740,7,"""21""",45420,45480
7254,409501,409701,60,43740,7,"""21""",45480,45540
7254,409701,409801,60,43740,7,"""21""",45540,45600
7254,409801,407505,120,43740,7,"""21""",45600,45720
7254,407505,405002,60,43740,7,"""21""",45720,45780
7254,405002,8101,60,43740,7,"""21""",45780,45840
7254,8101,404803,60,43740,7,"""21""",45840,45900
7254,404803,403401,60,43740,7,"""21""",45900,45960
7254,403401,502401,60,43740,7,"""21""",45960,46020
7254,502401,401303,120,43740,7,"""21""",46020,46140
7254,401303,26503,60,43740,7,"""21""",46140,46200
7254,26503,33903,120,43740,7,"""21""",46200,46320
7254,33903,34001,60,43740,7,"""21""",46320,46380
7254,34001,410201,120,43740,7,"""21""",46380,46500
7254,100,302,60,44940,7,"""21""",44940,45000
7254,302,502,60,44940,7,"""21""",45000,45060
7254,502,202,60,44940,7,"""21""",45060,45120
7254,202,602,60,44940,7,"""21""",45120,45180
7254,602,408703,60,44940,7,"""21""",45180,45240
7254,408703,404002,60,44940,7,"""21""",45240,45300
7254,404002,405502,60,44940,7,"""21""",45300,45360
7254,405502,409102,60,44940,7,"""21""",45360,45420
7254,409102,400902,60,44940,7,"""21""",45420,45480
7254,400902,404502,60,44940,7,"""21""",45480,45540
7254,404502,406401,60,44940,7,"""21""",45540,45600
7254,406401,405103,60,44940,7,"""21""",45600,45660
7254,405103,407602,60,44940,7,"""21""",45660,45720
7254,407602,409003,120,44940,7,"""21""",45720,45840
7254,409003,403803,60,44940,7,"""21""",45840,45900
7254,403803,101103,120,44940,7,"""21""",45900,46020
7254,101103,115100,60,44940,7,"""21""",46020,46080
7254,115100,109015,120,44940,7,"""21""",46080,46200
7254,109015,112104,120,44940,7,"""21""",46200,46320
7254,112104,403101,120,44940,7,"""21""",46320,46440
7254,403101,409401,60,44940,7,"""21""",46440,46500
7254,409401,400103,120,44940,7,"""21""",46500,46620
7254,400103,409501,60,44940,7,"""21""",46620,46680
7254,409501,409701,60,44940,7,"""21""",46680,46740
7254,409701,409801,60,44940,7,"""21""",46740,46800
7254,409801,407505,120,44940,7,"""21""",46800,46920
7254,407505,405002,60,44940,7,"""21""",46920,46980
7254,405002,8101,60,44940,7,"""21""",46980,47040
7254,8101,404803,60,44940,7,"""21""",47040,47100
7254,404803,403401,60,44940,7,"""21""",47100,47160
7254,403401,502401,60,44940,7,"""21""",47160,47220
7254,502401,401303,120,44940,7,"""21""",47220,47340
7254,401303,26503,60,44940,7,"""21""",47340,47400
7254,26503,33903,120,44940,7,"""21""",47400,47520
7254,33903,34001,60,44940,7,"""21""",47520,47580
7254,34001,410201,120,44940,7,"""21""",47580,47700
7254,100,302,60,46140,7,"""21""",46140,46200
7254,302,502,60,46140,7,"""21""",46200,46260
7254,502,202,60,46140,7,"""21""",46260,46320
7254,202,602,60,46140,7,"""21""",46320,46380
7254,602,408703,60,46140,7,"""21""",46380,46440
7254,408703,404002,60,46140,7,"""21""",46440,46500
7254,404002,405502,60,46140,7,"""21""",46500,46560
7254,405502,409102,60,46140,7,"""21""",46560,46620
7254,409102,400902,60,46140,7,"""21""",46620,46680
7254,400902,404502,60,46140,7,"""21""",46680,46740
7254,404502,406401,60,46140,7,"""21""",46740,46800
7254,406401,405103,60,46140,7,"""21""",46800,46860
7254,405103,407602,60,46140,7,"""21""",46860,46920
7254,407602,409003,120,46140,7,"""21""",46920,47040
7254,409003,403803,60,46140,7,"""21""",47040,47100
7254,403803,101103,120,46140,7,"""21""",47100,47220
7254,101103,115100,60,46140,7,"""21""",47220,47280
7254,115100,109015,120,46140,7,"""21""",47280,47400
7254,109015,112104,120,46140,7,"""21""",47400,47520
7254,112104,403101,120,46140,7,"""21""",47520,47640
7254,403101,409401,60,46140,7,"""21""",47640,47700
7254,409401,400103,120,46140,7,"""21""",47700,47820
7254,400103,409501,60,46140,7,"""21""",47820,47880
7254,409501,409701,60,46140,7,"""21""",47880,47940
7254,409701,409801,60,46140,7,"""21""",47940,48000
7254,409801,407505,120,46140,7,"""21""",48000,48120
7254,407505,405002,60,46140,7,"""21""",48120,48180
7254,405002,8101,60,46140,7,"""21""",48180,48240
7254,8101,404803,60,46140,7,"""21""",48240,48300
7254,404803,403401,60,46140,7,"""21""",48300,48360
7254,403401,502401,60,46140,7,"""21""",48360,48420
7254,502401,401303,120,46140,7,"""21""",48420,48540
7254,401303,26503,60,46140,7,"""21""",48540,48600
7254,26503,33903,120,46140,7,"""21""",48600,48720
7254,33903,34001,60,46140,7,"""21""",48720,48780
7254,34001,410201,120,46140,7,"""21""",48780,48900
7254,100,302,60,47340,7,"""21""",47340,47400
7254,302,502,60,47340,7,"""21""",47400,47460
7254,502,202,60,47340,7,"""21""",47460,47520
7254,202,602,60,47340,7,"""21""",47520,47580
7254,602,408703,60,47340,7,"""21""",47580,47640
7254,408703,404002,60,47340,7,"""21""",47640,47700
7254,404002,405502,60,47340,7,"""21""",47700,47760
7254,405502,409102,60,47340,7,"""21""",47760,47820
7254,409102,400902,60,47340,7,"""21""",47820,47880
7254,400902,404502,60,47340,7,"""21""",47880,47940
7254,404502,406401,60,47340,7,"""21""",47940,48000
7254,406401,405103,60,47340,7,"""21""",48000,48060
7254,405103,407602,60,47340,7,"""21""",48060,48120
7254,407602,409003,120,47340,7,"""21""",48120,48240
7254,409003,403803,60,47340,7,"""21""",48240,48300
7254,403803,101103,120,47340,7,"""21""",48300,48420
7254,101103,115100,60,47340,7,"""21""",48420,48480
7254,115100,109015,120,47340,7,"""21""",48480,48600
7254,109015,112104,120,47340,7,"""21""",48600,48720
7254,112104,403101,120,47340,7,"""21""",48720,48840
7254,403101,409401,60,47340,7,"""21""",48840,48900
7254,409401,400103,120,47340,7,"""21""",48900,49020
7254,400103,409501,60,47340,7,"""21""",49020,49080
7254,409501,409701,60,47340,7,"""21""",49080,49140
7254,409701,409801,60,47340,7,"""21""",49140,49200
7254,409801,407505,120,47340,7,"""21""",49200,49320
7254,407505,405002,60,47340,7,"""21""",49320,49380
7254,405002,8101,60,47340,7,"""21""",49380,49440
7254,8101,404803,60,47340,7,"""21""",49440,49500
7254,404803,403401,60,47340,7,"""21""",49500,49560
7254,403401,502401,60,47340,7,"""21""",49560,49620
7254,502401,401303,120,47340,7,"""21""",49620,49740
7254,401303,26503,60,47340,7,"""21""",49740,49800
7254,26503,33903,120,47340,7,"""21""",49800,49920
7254,33903,34001,60,47340,7,"""21""",49920,49980
7254,34001,410201,120,47340,7,"""21""",49980,50100
7254,100,302,60,48540,7,"""21""",48540,48600
7254,302,502,60,48540,7,"""21""",48600,48660
7254,502,202,60,48540,7,"""21""",48660,48720
7254,202,602,60,48540,7,"""21""",48720,48780
7254,602,408703,60,48540,7,"""21""",48780,48840
7254,408703,404002,60,48540,7,"""21""",48840,48900
7254,404002,405502,60,48540,7,"""21""",48900,48960
7254,405502,409102,60,48540,7,"""21""",48960,49020
7254,409102,400902,60,48540,7,"""21""",49020,49080
7254,400902,404502,60,48540,7,"""21""",49080,49140
7254,404502,406401,60,48540,7,"""21""",49140,49200
7254,406401,405103,60,48540,7,"""21""",49200,49260
7254,405103,407602,60,48540,7,"""21""",49260,49320
7254,407602,409003,120,48540,7,"""21""",49320,49440
7254,409003,403803,60,48540,7,"""21""",49440,49500
7254,403803,101103,120,48540,7,"""21""",49500,49620
7254,101103,115100,60,48540,7,"""21""",49620,49680
7254,115100,109015,120,48540,7,"""21""",49680,49800
7254,109015,112104,120,48540,7,"""21""",49800,49920
7254,112104,403101,120,48540,7,"""21""",49920,50040
7254,403101,409401,60,48540,7,"""21""",50040,50100
7254,409401,400103,120,48540,7,"""21""",50100,50220
7254,400103,409501,60,48540,7,"""21""",50220,50280
7254,409501,409701,60,48540,7,"""21""",50280,50340
7254,409701,409801,60,48540,7,"""21""",50340,50400
7254,409801,407505,120,48540,7,"""21""",50400,50520
7254,407505,405002,60,48540,7,"""21""",50520,50580
7254,405002,8101,60,48540,7,"""21""",50580,50640
7254,8101,404803,60,48540,7,"""21""",50640,50700
7254,404803,403401,60,48540,7,"""21""",50700,50760
7254,403401,502401,60,48540,7,"""21""",50760,50820
7254,502401,401303,120,48540,7,"""21""",50820,50940
7254,401303,26503,60,48540,7,"""21""",50940,51000
7254,26503,33903,120,48540,7,"""21""",51000,51120
7254,33903,34001,60,48540,7,"""21""",51120,51180
7254,34001,410201,120,48540,7,"""21""",51180,51300
7254,100,302,60,49740,7,"""21""",49740,49800
7254,302,502,60,49740,7,"""21""",49800,49860
7254,502,202,60,49740,7,"""21""",49860,49920
7254,202,602,60,49740,7,"""21""",49920,49980
7254,602,408703,60,49740,7,"""21""",49980,50040
7254,408703,404002,60,49740,7,"""21""",50040,50100
7254,404002,405502,60,49740,7,"""21""",50100,50160
7254,405502,409102,60,49740,7,"""21""",50160,50220
7254,409102,400902,60,49740,7,"""21""",50220,50280
7254,400902,404502,60,49740,7,"""21""",50280,50340
7254,404502,406401,60,49740,7,"""21""",50340,50400
7254,406401,405103,60,49740,7,"""21""",50400,50460
7254,405103,407602,60,49740,7,"""21""",50460,50520
7254,407602,409003,120,49740,7,"""21""",50520,50640
7254,409003,403803,60,49740,7,"""21""",50640,50700
7254,403803,101103,120,49740,7,"""21""",50700,50820
7254,101103,115100,60,49740,7,"""21""",50820,50880
7254,115100,109015,120,49740,7,"""21""",50880,51000
7254,109015,112104,120,49740,7,"""21""",51000,51120
7254,112104,403101,120,49740,7,"""21""",51120,51240
7254,403101,409401,60,49740,7,"""21""",51240,51300
7254,409401,400103,120,49740,7,"""21""",51300,51420
7254,400103,409501,60,49740,7,"""21""",51420,51480
7254,409501,409701,60,49740,7,"""21""",51480,51540
7254,409701,409801,60,49740,7,"""21""",51540,51600
7254,409801,407505,120,49740,7,"""21""",51600,51720
7254,407505,405002,60,49740,7,"""21""",51720,51780
7254,405002,8101,60,49740,7,"""21""",51780,51840
7254,8101,404803,60,49740,7,"""21""",51840,51900
7254,404803,403401,60,49740,7,"""21""",51900,51960
7254,403401,502401,60,49740,7,"""21""",51960,52020
7254,502401,401303,120,49740,7,"""21""",52020,52140
7254,401303,26503,60,49740,7,"""21""",52140,52200
7254,26503,33903,120,49740,7,"""21""",52200,52320
7254,33903,34001,60,49740,7,"""21""",52320,52380
7254,34001,410201,120,49740,7,"""21""",52380,52500
7254,100,302,60,50940,7,"""21""",50940,51000
7254,302,502,60,50940,7,"""21""",51000,51060
7254,502,202,60,50940,7,"""21""",51060,51120
7254,202,602,60,50940,7,"""21""",51120,51180
7254,602,408703,60,50940,7,"""21""",51180,51240
7254,408703,404002,60,50940,7,"""21""",51240,51300
7254,404002,405502,60,50940,7,"""21""",51300,51360
7254,405502,409102,60,50940,7,"""21""",51360,51420
7254,409102,400902,60,50940,7,"""21""",51420,51480
7254,400902,404502,60,50940,7,"""21""",51480,51540
7254,404502,406401,60,50940,7,"""21""",51540,51600
7254,406401,405103,60,50940,7,"""21""",51600,51660
7254,405103,407602,60,50940,7,"""21""",51660,51720
7254,407602,409003,120,50940,7,"""21""",51720,51840
7254,409003,403803,60,50940,7,"""21""",51840,51900
7254,403803,101103,120,50940,7,"""21""",51900,52020
7254,101103,115100,60,50940,7,"""21""",52020,52080
7254,115100,109015,120,50940,7,"""21""",52080,52200
7254,109015,112104,120,50940,7,"""21""",52200,52320
7254,112104,403101,120,50940,7,"""21""",52320,52440
7254,403101,409401,60,50940,7,"""21""",52440,52500
7254,409401,400103,120,50940,7,"""21""",52500,52620
7254,400103,409501,60,50940,7,"""21""",52620,52680
7254,409501,409701,60,50940,7,"""21""",52680,52740
7254,409701,409801,60,50940,7,"""21""",52740,52800
7254,409801,407505,120,50940,7,"""21""",52800,52920
7254,407505,405002,60,50940,7,"""21""",52920,52980
7254,405002,8101,60,50940,7,"""21""",52980,53040
7254,8101,404803,60,50940,7,"""21""",53040,53100
7254,404803,403401,60,50940,7,"""21""",53100,53160
7254,403401,502401,60,50940,7,"""21""",53160,53220
7254,502401,401303,120,50940,7,"""21""",53220,53340
7254,401303,26503,60,50940,7,"""21""",53340,53400
7254,26503,33903,120,50940,7,"""21""",53400,53520
7254,33903,34001,60,50940,7,"""21""",53520,53580
7254,34001,410201,120,50940,7,"""21""",53580,53700
7254,100,302,60,52140,7,"""21""",52140,52200
7254,302,502,60,52140,7,"""21""",52200,52260
7254,502,202,60,52140,7,"""21""",52260,52320
7254,202,602,60,52140,7,"""21""",52320,52380
7254,602,408703,60,52140,7,"""21""",52380,52440
7254,408703,404002,60,52140,7,"""21""",52440,52500
7254,404002,405502,60,52140,7,"""21""",52500,52560
7254,405502,409102,60,52140,7,"""21""",52560,52620
7254,409102,400902,60,52140,7,"""21""",52620,52680
7254,400902,404502,60,52140,7,"""21""",52680,52740
7254,404502,406401,60,52140,7,"""21""",52740,52800
7254,406401,405103,60,52140,7,"""21""",52800,52860
7254,405103,407602,60,52140,7,"""21""",52860,52920
7254,407602,409003,120,52140,7,"""21""",52920,53040
7254,409003,403803,60,52140,7,"""21""",53040,53100
7254,403803,101103,120,52140,7,"""21""",53100,53220
7254,101103,115100,60,52140,7,"""21""",53220,53280
7254,115100,109015,120,52140,7,"""21""",53280,53400
7254,109015,112104,120,52140,7,"""21""",53400,53520
7254,112104,403101,120,52140,7,"""21""",53520,53640
7254,403101,409401,60,52140,7,"""21""",53640,53700
7254,409401,400103,120,52140,7,"""21""",53700,53820
7254,400103,409501,60,52140,7,"""21""",53820,53880
7254,409501,409701,60,52140,7,"""21""",53880,53940
7254,409701,409801,60,52140,7,"""21""",53940,54000
7254,409801,407505,120,52140,7,"""21""",54000,54120
7254,407505,405002,60,52140,7,"""21""",54120,54180
7254,405002,8101,60,52140,7,"""21""",54180,54240
7254,8101,404803,60,52140,7,"""21""",54240,54300
7254,404803,403401,60,52140,7,"""21""",54300,54360
7254,403401,502401,60,52140,7,"""21""",54360,54420
7254,502401,401303,120,52140,7,"""21""",54420,54540
7254,401303,26503,60,52140,7,"""21""",54540,54600
7254,26503,33903,120,52140,7,"""21""",54600,54720
7254,33903,34001,60,52140,7,"""21""",54720,54780
7254,34001,410201,120,52140,7,"""21""",54780,54900
7254,100,302,60,53340,7,"""21""",53340,53400
7254,302,502,60,53340,7,"""21""",53400,53460
7254,502,202,60,53340,7,"""21""",53460,53520
7254,202,602,60,53340,7,"""21""",53520,53580
7254,602,408703,60,53340,7,"""21""",53580,53640
7254,408703,404002,60,53340,7,"""21""",53640,53700
7254,404002,405502,60,53340,7,"""21""",53700,53760
7254,405502,409102,60,53340,7,"""21""",53760,53820
7254,409102,400902,60,53340,7,"""21""",53820,53880
7254,400902,404502,60,53340,7,"""21""",53880,53940
7254,404502,406401,60,53340,7,"""21""",53940,54000
7254,406401,405103,60,53340,7,"""21""",54000,54060
7254,405103,407602,60,53340,7,"""21""",54060,54120
7254,407602,409003,120,53340,7,"""21""",54120,54240
7254,409003,403803,60,53340,7,"""21""",54240,54300
7254,403803,101103,120,53340,7,"""21""",54300,54420
7254,101103,115100,60,53340,7,"""21""",54420,54480
7254,115100,109015,120,53340,7,"""21""",54480,54600
7254,109015,112104,120,53340,7,"""21""",54600,54720
7254,112104,403101,120,53340,7,"""21""",54720,54840
7254,403101,409401,60,53340,7,"""21""",54840,54900
7254,409401,400103,120,53340,7,"""21""",54900,55020
7254,400103,409501,60,53340,7,"""21""",55020,55080
7254,409501,409701,60,53340,7,"""21""",55080,55140
7254,409701,409801,60,53340,7,"""21""",55140,55200
7254,409801,407505,120,53340,7,"""21""",55200,55320
7254,407505,405002,60,53340,7,"""21""",55320,55380
7254,405002,8101,60,53340,7,"""21""",55380,55440
7254,8101,404803,60,53340,7,"""21""",55440,55500
7254,404803,403401,60,53340,7,"""21""",55500,55560
7254,403401,502401,60,53340,7,"""21""",55560,55620
7254,502401,401303,120,53340,7,"""21""",55620,55740
7254,401303,26503,60,53340,7,"""21""",55740,55800
7254,26503,33903,120,53340,7,"""21""",55800,55920
7254,33903,34001,60,53340,7,"""21""",55920,55980
7254,34001,410201,120,53340,7,"""21""",55980,56100
7254,100,302,60,54540,7,"""21""",54540,54600
7254,302,502,60,54540,7,"""21""",54600,54660
7254,502,202,60,54540,7,"""21""",54660,54720
7254,202,602,60,54540,7,"""21""",54720,54780
7254,602,408703,60,54540,7,"""21""",54780,54840
7254,408703,404002,60,54540,7,"""21""",54840,54900
7254,404002,405502,60,54540,7,"""21""",54900,54960
7254,405502,409102,60,54540,7,"""21""",54960,55020
7254,409102,400902,60,54540,7,"""21""",55020,55080
7254,400902,404502,60,54540,7,"""21""",55080,55140
7254,404502,406401,60,54540,7,"""21""",55140,55200
7254,406401,405103,60,54540,7,"""21""",55200,55260
7254,405103,407602,60,54540,7,"""21""",55260,55320
7254,407602,409003,120,54540,7,"""21""",55320,55440
7254,409003,403803,60,54540,7,"""21""",55440,55500
7254,403803,101103,120,54540,7,"""21""",55500,55620
7254,101103,115100,60,54540,7,"""21""",55620,55680
7254,115100,109015,120,54540,7,"""21""",55680,55800
7254,109015,112104,120,54540,7,"""21""",55800,55920
7254,112104,403101,120,54540,7,"""21""",55920,56040
7254,403101,409401,60,54540,7,"""21""",56040,56100
7254,409401,400103,120,54540,7,"""21""",56100,56220
7254,400103,409501,60,54540,7,"""21""",56220,56280
7254,409501,409701,60,54540,7,"""21""",56280,56340
7254,409701,409801,60,54540,7,"""21""",56340,56400
7254,409801,407505,120,54540,7,"""21""",56400,56520
7254,407505,405002,60,54540,7,"""21""",56520,56580
7254,405002,8101,60,54540,7,"""21""",56580,56640
7254,8101,404803,60,54540,7,"""21""",56640,56700
7254,404803,403401,60,54540,7,"""21""",56700,56760
7254,403401,502401,60,54540,7,"""21""",56760,56820
7254,502401,401303,120,54540,7,"""21""",56820,56940
7254,401303,26503,60,54540,7,"""21""",56940,57000
7254,26503,33903,120,54540,7,"""21""",57000,57120
7254,33903,34001,60,54540,7,"""21""",57120,57180
7254,34001,410201,120,54540,7,"""21""",57180,57300
7254,100,302,60,55740,7,"""21""",55740,55800
7254,302,502,60,55740,7,"""21""",55800,55860
7254,502,202,60,55740,7,"""21""",55860,55920
7254,202,602,60,55740,7,"""21""",55920,55980
7254,602,408703,60,55740,7,"""21""",55980,56040
7254,408703,404002,60,55740,7,"""21""",56040,56100
7254,404002,405502,60,55740,7,"""21""",56100,56160
7254,405502,409102,60,55740,7,"""21""",56160,56220
7254,409102,400902,60,55740,7,"""21""",56220,56280
7254,400902,404502,60,55740,7,"""21""",56280,56340
7254,404502,406401,60,55740,7,"""21""",56340,56400
7254,406401,405103,60,55740,7,"""21""",56400,56460
7254,405103,407602,60,55740,7,"""21""",56460,56520
7254,407602,409003,120,55740,7,"""21""",56520,56640
7254,409003,403803,60,55740,7,"""21""",56640,56700
7254,403803,101103,120,55740,7,"""21""",56700,56820
7254,101103,115100,60,55740,7,"""21""",56820,56880
7254,115100,109015,120,55740,7,"""21""",56880,57000
7254,109015,112104,120,55740,7,"""21""",57000,57120
7254,112104,403101,120,55740,7,"""21""",57120,57240
7254,403101,409401,60,55740,7,"""21""",57240,57300
7254,409401,400103,120,55740,7,"""21""",57300,57420
7254,400103,409501,60,55740,7,"""21""",57420,57480
7254,409501,409701,60,55740,7,"""21""",57480,57540
7254,409701,409801,60,55740,7,"""21""",57540,57600
7254,409801,407505,120,55740,7,"""21""",57600,57720
7254,407505,405002,60,55740,7,"""21""",57720,57780
7254,405002,8101,60,55740,7,"""21""",57780,57840
7254,8101,404803,60,55740,7,"""21""",57840,57900
7254,404803,403401,60,55740,7,"""21""",57900,57960
7254,403401,502401,60,55740,7,"""21""",57960,58020
7254,502401,401303,120,55740,7,"""21""",58020,58140
7254,401303,26503,60,55740,7,"""21""",58140,58200
7254,26503,33903,120,55740,7,"""21""",58200,58320
7254,33903,34001,60,55740,7,"""21""",58320,58380
7254,34001,410201,120,55740,7,"""21""",58380,58500
7254,100,302,60,56940,7,"""21""",56940,57000
7254,302,502,60,56940,7,"""21""",57000,57060
7254,502,202,60,56940,7,"""21""",57060,57120
7254,202,602,60,56940,7,"""21""",57120,57180
7254,602,408703,60,56940,7,"""21""",57180,57240
7254,408703,404002,60,56940,7,"""21""",57240,57300
7254,404002,405502,60,56940,7,"""21""",57300,57360
7254,405502,409102,60,56940,7,"""21""",57360,57420
7254,409102,400902,60,56940,7,"""21""",57420,57480
7254,400902,404502,60,56940,7,"""21""",57480,57540
7254,404502,406401,60,56940,7,"""21""",57540,57600
7254,406401,405103,60,56940,7,"""21""",57600,57660
7254,405103,407602,60,56940,7,"""21""",57660,57720
7254,407602,409003,120,56940,7,"""21""",57720,57840
7254,409003,403803,60,56940,7,"""21""",57840,57900
7254,403803,101103,120,56940,7,"""21""",57900,58020
7254,101103,115100,60,56940,7,"""21""",58020,58080
7254,115100,109015,120,56940,7,"""21""",58080,58200
7254,109015,112104,120,56940,7,"""21""",58200,58320
7254,112104,403101,120,56940,7,"""21""",58320,58440
7254,403101,409401,60,56940,7,"""21""",58440,58500
7254,409401,400103,120,56940,7,"""21""",58500,58620
7254,400103,409501,60,56940,7,"""21""",58620,58680
7254,409501,409701,60,56940,7,"""21""",58680,58740
7254,409701,409801,60,56940,7,"""21""",58740,58800
7254,409801,407505,120,56940,7,"""21""",58800,58920
7254,407505,405002,60,56940,7,"""21""",58920,58980
7254,405002,8101,60,56940,7,"""21""",58980,59040
7254,8101,404803,60,56940,7,"""21""",59040,59100
7254,404803,403401,60,56940,7,"""21""",59100,59160
7254,403401,502401,60,56940,7,"""21""",59160,59220
7254,502401,401303,120,56940,7,"""21""",59220,59340
7254,401303,26503,60,56940,7,"""21""",59340,59400
7254,26503,33903,120,56940,7,"""21""",59400,59520
7254,33903,34001,60,56940,7,"""21""",59520,59580
7254,34001,410201,120,56940,7,"""21""",59580,59700
7254,100,302,60,58140,7,"""21""",58140,58200
7254,302,502,60,58140,7,"""21""",58200,58260
7254,502,202,60,58140,7,"""21""",58260,58320
7254,202,602,60,58140,7,"""21""",58320,58380
7254,602,408703,60,58140,7,"""21""",58380,58440
7254,408703,404002,60,58140,7,"""21""",58440,58500
7254,404002,405502,60,58140,7,"""21""",58500,58560
7254,405502,409102,60,58140,7,"""21""",58560,58620
7254,409102,400902,60,58140,7,"""21""",58620,58680
7254,400902,404502,60,58140,7,"""21""",58680,58740
7254,404502,406401,60,58140,7,"""21""",58740,58800
7254,406401,405103,60,58140,7,"""21""",58800,58860
7254,405103,407602,60,58140,7,"""21""",58860,58920
7254,407602,409003,120,58140,7,"""21""",58920,59040
7254,409003,403803,60,58140,7,"""21""",59040,59100
7254,403803,101103,120,58140,7,"""21""",59100,59220
7254,101103,115100,60,58140,7,"""21""",59220,59280
7254,115100,109015,120,58140,7,"""21""",59280,59400
7254,109015,112104,120,58140,7,"""21""",59400,59520
7254,112104,403101,120,58140,7,"""21""",59520,59640
7254,403101,409401,60,58140,7,"""21""",59640,59700
7254,409401,400103,120,58140,7,"""21""",59700,59820
7254,400103,409501,60,58140,7,"""21""",59820,59880
7254,409501,409701,60,58140,7,"""21""",59880,59940
7254,409701,409801,60,58140,7,"""21""",59940,60000
7254,409801,407505,120,58140,7,"""21""",60000,60120
7254,407505,405002,60,58140,7,"""21""",60120,60180
7254,405002,8101,60,58140,7,"""21""",60180,60240
7254,8101,404803,60,58140,7,"""21""",60240,60300
7254,404803,403401,60,58140,7,"""21""",60300,60360
7254,403401,502401,60,58140,7,"""21""",60360,60420
7254,502401,401303,120,58140,7,"""21""",60420,60540
7254,401303,26503,60,58140,7,"""21""",60540,60600
7254,26503,33903,120,58140,7,"""21""",60600,60720
7254,33903,34001,60,58140,7,"""21""",60720,60780
7254,34001,410201,120,58140,7,"""21""",60780,60900
7254,100,302,60,59340,7,"""21""",59340,59400
7254,302,502,60,59340,7,"""21""",59400,59460
7254,502,202,60,59340,7,"""21""",59460,59520
7254,202,602,60,59340,7,"""21""",59520,59580
7254,602,408703,60,59340,7,"""21""",59580,59640
7254,408703,404002,60,59340,7,"""21""",59640,59700
7254,404002,405502,60,59340,7,"""21""",59700,59760
7254,405502,409102,60,59340,7,"""21""",59760,59820
7254,409102,400902,60,59340,7,"""21""",59820,59880
7254,400902,404502,60,59340,7,"""21""",59880,59940
7254,404502,406401,60,59340,7,"""21""",59940,60000
7254,406401,405103,60,59340,7,"""21""",60000,60060
7254,405103,407602,60,59340,7,"""21""",60060,60120
7254,407602,409003,120,59340,7,"""21""",60120,60240
7254,409003,403803,60,59340,7,"""21""",60240,60300
7254,403803,101103,120,59340,7,"""21""",60300,60420
7254,101103,115100,60,59340,7,"""21""",60420,60480
7254,115100,109015,120,59340,7,"""21""",60480,60600
7254,109015,112104,120,59340,7,"""21""",60600,60720
7254,112104,403101,120,59340,7,"""21""",60720,60840
7254,403101,409401,60,59340,7,"""21""",60840,60900
7254,409401,400103,120,59340,7,"""21""",60900,61020
7254,400103,409501,60,59340,7,"""21""",61020,61080
7254,409501,409701,60,59340,7,"""21""",61080,61140
7254,409701,409801,60,59340,7,"""21""",61140,61200
7254,409801,407505,120,59340,7,"""21""",61200,61320
7254,407505,405002,60,59340,7,"""21""",61320,61380
7254,405002,8101,60,59340,7,"""21""",61380,61440
7254,8101,404803,60,59340,7,"""21""",61440,61500
7254,404803,403401,60,59340,7,"""21""",61500,61560
7254,403401,502401,60,59340,7,"""21""",61560,61620
7254,502401,401303,120,59340,7,"""21""",61620,61740
7254,401303,26503,60,59340,7,"""21""",61740,61800
7254,26503,33903,120,59340,7,"""21""",61800,61920
7254,33903,34001,60,59340,7,"""21""",61920,61980
7254,34001,410201,120,59340,7,"""21""",61980,62100
7254,100,302,60,60540,7,"""21""",60540,60600
7254,302,502,60,60540,7,"""21""",60600,60660
7254,502,202,60,60540,7,"""21""",60660,60720
7254,202,602,60,60540,7,"""21""",60720,60780
7254,602,408703,60,60540,7,"""21""",60780,60840
7254,408703,404002,60,60540,7,"""21""",60840,60900
7254,404002,405502,60,60540,7,"""21""",60900,60960
7254,405502,409102,60,60540,7,"""21""",60960,61020
7254,409102,400902,60,60540,7,"""21""",61020,61080
7254,400902,404502,60,60540,7,"""21""",61080,61140
7254,404502,406401,60,60540,7,"""21""",61140,61200
7254,406401,405103,60,60540,7,"""21""",61200,61260
7254,405103,407602,60,60540,7,"""21""",61260,61320
7254,407602,409003,120,60540,7,"""21""",61320,61440
7254,409003,403803,60,60540,7,"""21""",61440,61500
7254,403803,101103,120,60540,7,"""21""",61500,61620
7254,101103,115100,60,60540,7,"""21""",61620,61680
7254,115100,109015,120,60540,7,"""21""",61680,61800
7254,109015,112104,120,60540,7,"""21""",61800,61920
7254,112104,403101,120,60540,7,"""21""",61920,62040
7254,403101,409401,60,60540,7,"""21""",62040,62100
7254,409401,400103,120,60540,7,"""21""",62100,62220
7254,400103,409501,60,60540,7,"""21""",62220,62280
7254,409501,409701,60,60540,7,"""21""",62280,62340
7254,409701,409801,60,60540,7,"""21""",62340,62400
7254,409801,407505,120,60540,7,"""21""",62400,62520
7254,407505,405002,60,60540,7,"""21""",62520,62580
7254,405002,8101,60,60540,7,"""21""",62580,62640
7254,8101,404803,60,60540,7,"""21""",62640,62700
7254,404803,403401,60,60540,7,"""21""",62700,62760
7254,403401,502401,60,60540,7,"""21""",62760,62820
7254,502401,401303,120,60540,7,"""21""",62820,62940
7254,401303,26503,60,60540,7,"""21""",62940,63000
7254,26503,33903,120,60540,7,"""21""",63000,63120
7254,33903,34001,60,60540,7,"""21""",63120,63180
7254,34001,410201,120,60540,7,"""21""",63180,63300
7254,100,302,60,61740,7,"""21""",61740,61800
7254,302,502,60,61740,7,"""21""",61800,61860
7254,502,202,60,61740,7,"""21""",61860,61920
7254,202,602,60,61740,7,"""21""",61920,61980
7254,602,408703,60,61740,7,"""21""",61980,62040
7254,408703,404002,60,61740,7,"""21""",62040,62100
7254,404002,405502,60,61740,7,"""21""",62100,62160
7254,405502,409102,60,61740,7,"""21""",62160,62220
7254,409102,400902,60,61740,7,"""21""",62220,62280
7254,400902,404502,60,61740,7,"""21""",62280,62340
7254,404502,406401,60,61740,7,"""21""",62340,62400
7254,406401,405103,60,61740,7,"""21""",62400,62460
7254,405103,407602,60,61740,7,"""21""",62460,62520
7254,407602,409003,120,61740,7,"""21""",62520,62640
7254,409003,403803,60,61740,7,"""21""",62640,62700
7254,403803,101103,120,61740,7,"""21""",62700,62820
7254,101103,115100,60,61740,7,"""21""",62820,62880
7254,115100,109015,120,61740,7,"""21""",62880,63000
7254,109015,112104,120,61740,7,"""21""",63000,63120
7254,112104,403101,120,61740,7,"""21""",63120,63240
7254,403101,409401,60,61740,7,"""21""",63240,63300
7254,409401,400103,120,61740,7,"""21""",63300,63420
7254,400103,409501,60,61740,7,"""21""",63420,63480
7254,409501,409701,60,61740,7,"""21""",63480,63540
7254,409701,409801,60,61740,7,"""21""",63540,63600
7254,409801,407505,120,61740,7,"""21""",63600,63720
7254,407505,405002,60,61740,7,"""21""",63720,63780
7254,405002,8101,60,61740,7,"""21""",63780,63840
7254,8101,404803,60,61740,7,"""21""",63840,63900
7254,404803,403401,60,61740,7,"""21""",63900,63960
7254,403401,502401,60,61740,7,"""21""",63960,64020
7254,502401,401303,120,61740,7,"""21""",64020,64140
7254,401303,26503,60,61740,7,"""21""",64140,64200
7254,26503,33903,120,61740,7,"""21""",64200,64320
7254,33903,34001,60,61740,7,"""21""",64320,64380
7254,34001,410201,120,61740,7,"""21""",64380,64500
7254,100,302,60,62940,7,"""21""",62940,63000
7254,302,502,60,62940,7,"""21""",63000,63060
7254,502,202,60,62940,7,"""21""",63060,63120
7254,202,602,60,62940,7,"""21""",63120,63180
7254,602,408703,60,62940,7,"""21""",63180,63240
7254,408703,404002,60,62940,7,"""21""",63240,63300
7254,404002,405502,60,62940,7,"""21""",63300,63360
7254,405502,409102,60,62940,7,"""21""",63360,63420
7254,409102,400902,60,62940,7,"""21""",63420,63480
7254,400902,404502,60,62940,7,"""21""",63480,63540
7254,404502,406401,60,62940,7,"""21""",63540,63600
7254,406401,405103,60,62940,7,"""21""",63600,63660
7254,405103,407602,60,62940,7,"""21""",63660,63720
7254,407602,409003,120,62940,7,"""21""",63720,63840
7254,409003,403803,60,62940,7,"""21""",63840,63900
7254,403803,101103,120,62940,7,"""21""",63900,64020
7254,101103,115100,60,62940,7,"""21""",64020,64080
7254,115100,109015,120,62940,7,"""21""",64080,64200
7254,109015,112104,120,62940,7,"""21""",64200,64320
7254,112104,403101,120,62940,7,"""21""",64320,64440
7254,403101,409401,60,62940,7,"""21""",64440,64500
7254,409401,400103,120,62940,7,"""21""",64500,64620
7254,400103,409501,60,62940,7,"""21""",64620,64680
7254,409501,409701,60,62940,7,"""21""",64680,64740
7254,409701,409801,60,62940,7,"""21""",64740,64800
7254,409801,407505,120,62940,7,"""21""",64800,64920
7254,407505,405002,60,62940,7,"""21""",64920,64980
7254,405002,8101,60,62940,7,"""21""",64980,65040
7254,8101,404803,60,62940,7,"""21""",65040,65100
7254,404803,403401,60,62940,7,"""21""",65100,65160
7254,403401,502401,60,62940,7,"""21""",65160,65220
7254,502401,401303,120,62940,7,"""21""",65220,65340
7254,401303,26503,60,62940,7,"""21""",65340,65400
7254,26503,33903,120,62940,7,"""21""",65400,65520
7254,33903,34001,60,62940,7,"""21""",65520,65580
7254,34001,410201,120,62940,7,"""21""",65580,65700
7254,100,302,60,64140,7,"""21""",64140,64200
7254,302,502,60,64140,7,"""21""",64200,64260
7254,502,202,60,64140,7,"""21""",64260,64320
7254,202,602,60,64140,7,"""21""",64320,64380
7254,602,408703,60,64140,7,"""21""",64380,64440
7254,408703,404002,60,64140,7,"""21""",64440,64500
7254,404002,405502,60,64140,7,"""21""",64500,64560
7254,405502,409102,60,64140,7,"""21""",64560,64620
7254,409102,400902,60,64140,7,"""21""",64620,64680
7254,400902,404502,60,64140,7,"""21""",64680,64740
7254,404502,406401,60,64140,7,"""21""",64740,64800
7254,406401,405103,60,64140,7,"""21""",64800,64860
7254,405103,407602,60,64140,7,"""21""",64860,64920
7254,407602,409003,120,64140,7,"""21""",64920,65040
7254,409003,403803,60,64140,7,"""21""",65040,65100
7254,403803,101103,120,64140,7,"""21""",65100,65220
7254,101103,115100,60,64140,7,"""21""",65220,65280
7254,115100,109015,120,64140,7,"""21""",65280,65400
7254,109015,112104,120,64140,7,"""21""",65400,65520
7254,112104,403101,120,64140,7,"""21""",65520,65640
7254,403101,409401,60,64140,7,"""21""",65640,65700
7254,409401,400103,120,64140,7,"""21""",65700,65820
7254,400103,409501,60,64140,7,"""21""",65820,65880
7254,409501,409701,60,64140,7,"""21""",65880,65940
7254,409701,409801,60,64140,7,"""21""",65940,66000
7254,409801,407505,120,64140,7,"""21""",66000,66120
7254,407505,405002,60,64140,7,"""21""",66120,66180
7254,405002,8101,60,64140,7,"""21""",66180,66240
7254,8101,404803,60,64140,7,"""21""",66240,66300
7254,404803,403401,60,64140,7,"""21""",66300,66360
7254,403401,502401,60,64140,7,"""21""",66360,66420
7254,502401,401303,120,64140,7,"""21""",66420,66540
7254,401303,26503,60,64140,7,"""21""",66540,66600
7254,26503,33903,120,64140,7,"""21""",66600,66720
7254,33903,34001,60,64140,7,"""21""",66720,66780
7254,34001,410201,120,64140,7,"""21""",66780,66900
7254,100,302,60,65340,7,"""21""",65340,65400
7254,302,502,60,65340,7,"""21""",65400,65460
7254,502,202,60,65340,7,"""21""",65460,65520
7254,202,602,60,65340,7,"""21""",65520,65580
7254,602,408703,60,65340,7,"""21""",65580,65640
7254,408703,404002,60,65340,7,"""21""",65640,65700
7254,404002,405502,60,65340,7,"""21""",65700,65760
7254,405502,409102,60,65340,7,"""21""",65760,65820
7254,409102,400902,60,65340,7,"""21""",65820,65880
7254,400902,404502,60,65340,7,"""21""",65880,65940
7254,404502,406401,60,65340,7,"""21""",65940,66000
7254,406401,405103,60,65340,7,"""21""",66000,66060
7254,405103,407602,60,65340,7,"""21""",66060,66120
7254,407602,409003,120,65340,7,"""21""",66120,66240
7254,409003,403803,60,65340,7,"""21""",66240,66300
7254,403803,101103,120,65340,7,"""21""",66300,66420
7254,101103,115100,60,65340,7,"""21""",66420,66480
7254,115100,109015,120,65340,7,"""21""",66480,66600
7254,109015,112104,120,65340,7,"""21""",66600,66720
7254,112104,403101,120,65340,7,"""21""",66720,66840
7254,403101,409401,60,65340,7,"""21""",66840,66900
7254,409401,400103,120,65340,7,"""21""",66900,67020
7254,400103,409501,60,65340,7,"""21""",67020,67080
7254,409501,409701,60,65340,7,"""21""",67080,67140
7254,409701,409801,60,65340,7,"""21""",67140,67200
7254,409801,407505,120,65340,7,"""21""",67200,67320
7254,407505,405002,60,65340,7,"""21""",67320,67380
7254,405002,8101,60,65340,7,"""21""",67380,67440
7254,8101,404803,60,65340,7,"""21""",67440,67500
7254,404803,403401,60,65340,7,"""21""",67500,67560
7254,403401,502401,60,65340,7,"""21""",67560,67620
7254,502401,401303,120,65340,7,"""21""",67620,67740
7254,401303,26503,60,65340,7,"""21""",67740,67800
7254,26503,33903,120,65340,7,"""21""",67800,67920
7254,33903,34001,60,65340,7,"""21""",67920,67980
7254,34001,410201,120,65340,7,"""21""",67980,68100
7254,100,302,60,66540,7,"""21""",66540,66600
7254,302,502,60,66540,7,"""21""",66600,66660
7254,502,202,60,66540,7,"""21""",66660,66720
7254,202,602,60,66540,7,"""21""",66720,66780
7254,602,408703,60,66540,7,"""21""",66780,66840
7254,408703,404002,60,66540,7,"""21""",66840,66900
7254,404002,405502,60,66540,7,"""21""",66900,66960
7254,405502,409102,60,66540,7,"""21""",66960,67020
7254,409102,400902,60,66540,7,"""21""",67020,67080
7254,400902,404502,60,66540,7,"""21""",67080,67140
7254,404502,406401,60,66540,7,"""21""",67140,67200
7254,406401,405103,60,66540,7,"""21""",67200,67260
7254,405103,407602,60,66540,7,"""21""",67260,67320
7254,407602,409003,120,66540,7,"""21""",67320,67440
7254,409003,403803,60,66540,7,"""21""",67440,67500
7254,403803,101103,120,66540,7,"""21""",67500,67620
7254,101103,115100,60,66540,7,"""21""",67620,67680
7254,115100,109015,120,66540,7,"""21""",67680,67800
7254,109015,112104,120,66540,7,"""21""",67800,67920
7254,112104,403101,120,66540,7,"""21""",67920,68040
7254,403101,409401,60,66540,7,"""21""",68040,68100
7254,409401,400103,120,66540,7,"""21""",68100,68220
7254,400103,409501,60,66540,7,"""21""",68220,68280
7254,409501,409701,60,66540,7,"""21""",68280,68340
7254,409701,409801,60,66540,7,"""21""",68340,68400
7254,409801,407505,120,66540,7,"""21""",68400,68520
7254,407505,405002,60,66540,7,"""21""",68520,68580
7254,405002,8101,60,66540,7,"""21""",68580,68640
7254,8101,404803,60,66540,7,"""21""",68640,68700
7254,404803,403401,60,66540,7,"""21""",68700,68760
7254,403401,502401,60,66540,7,"""21""",68760,68820
7254,502401,401303,120,66540,7,"""21""",68820,68940
7254,401303,26503,60,66540,7,"""21""",68940,69000
7254,26503,33903,120,66540,7,"""21""",69000,69120
7254,33903,34001,60,66540,7,"""21""",69120,69180
7254,34001,410201,120,66540,7,"""21""",69180,69300
7254,100,302,60,67740,7,"""21""",67740,67800
7254,302,502,60,67740,7,"""21""",67800,67860
7254,502,202,60,67740,7,"""21""",67860,67920
7254,202,602,60,67740,7,"""21""",67920,67980
7254,602,408703,60,67740,7,"""21""",67980,68040
7254,408703,404002,60,67740,7,"""21""",68040,68100
7254,404002,405502,60,67740,7,"""21""",68100,68160
7254,405502,409102,60,67740,7,"""21""",68160,68220
7254,409102,400902,60,67740,7,"""21""",68220,68280
7254,400902,404502,60,67740,7,"""21""",68280,68340
7254,404502,406401,60,67740,7,"""21""",68340,68400
7254,406401,405103,60,67740,7,"""21""",68400,68460
7254,405103,407602,60,67740,7,"""21""",68460,68520
7254,407602,409003,120,67740,7,"""21""",68520,68640
7254,409003,403803,60,67740,7,"""21""",68640,68700
7254,403803,101103,120,67740,7,"""21""",68700,68820
7254,101103,115100,60,67740,7,"""21""",68820,68880
7254,115100,109015,120,67740,7,"""21""",68880,69000
7254,109015,112104,120,67740,7,"""21""",69000,69120
7254,112104,403101,120,67740,7,"""21""",69120,69240
7254,403101,409401,60,67740,7,"""21""",69240,69300
7254,409401,400103,120,67740,7,"""21""",69300,69420
7254,400103,409501,60,67740,7,"""21""",69420,69480
7254,409501,409701,60,67740,7,"""21""",69480,69540
7254,409701,409801,60,67740,7,"""21""",69540,69600
7254,409801,407505,120,67740,7,"""21""",69600,69720
7254,407505,405002,60,67740,7,"""21""",69720,69780
7254,405002,8101,60,67740,7,"""21""",69780,69840
7254,8101,404803,60,67740,7,"""21""",69840,69900
7254,404803,403401,60,67740,7,"""21""",69900,69960
7254,403401,502401,60,67740,7,"""21""",69960,70020
7254,502401,401303,120,67740,7,"""21""",70020,70140
7254,401303,26503,60,67740,7,"""21""",70140,70200
7254,26503,33903,120,67740,7,"""21""",70200,70320
7254,33903,34001,60,67740,7,"""21""",70320,70380
7254,34001,410201,120,67740,7,"""21""",70380,70500
7254,100,302,60,68940,7,"""21""",68940,69000
7254,302,502,60,68940,7,"""21""",69000,69060
7254,502,202,60,68940,7,"""21""",69060,69120
7254,202,602,60,68940,7,"""21""",69120,69180
7254,602,408703,60,68940,7,"""21""",69180,69240
7254,408703,404002,60,68940,7,"""21""",69240,69300
7254,404002,405502,60,68940,7,"""21""",69300,69360
7254,405502,409102,60,68940,7,"""21""",69360,69420
7254,409102,400902,60,68940,7,"""21""",69420,69480
7254,400902,404502,60,68940,7,"""21""",69480,69540
7254,404502,406401,60,68940,7,"""21""",69540,69600
7254,406401,405103,60,68940,7,"""21""",69600,69660
7254,405103,407602,60,68940,7,"""21""",69660,69720
7254,407602,409003,120,68940,7,"""21""",69720,69840
7254,409003,403803,60,68940,7,"""21""",69840,69900
7254,403803,101103,120,68940,7,"""21""",69900,70020
7254,101103,115100,60,68940,7,"""21""",70020,70080
7254,115100,109015,120,68940,7,"""21""",70080,70200
7254,109015,112104,120,68940,7,"""21""",70200,70320
7254,112104,403101,120,68940,7,"""21""",70320,70440
7254,403101,409401,60,68940,7,"""21""",70440,70500
7254,409401,400103,120,68940,7,"""21""",70500,70620
7254,400103,409501,60,68940,7,"""21""",70620,70680
7254,409501,409701,60,68940,7,"""21""",70680,70740
7254,409701,409801,60,68940,7,"""21""",70740,70800
7254,409801,407505,120,68940,7,"""21""",70800,70920
7254,407505,405002,60,68940,7,"""21""",70920,70980
7254,405002,8101,60,68940,7,"""21""",70980,71040
7254,8101,404803,60,68940,7,"""21""",71040,71100
7254,404803,403401,60,68940,7,"""21""",71100,71160
7254,403401,502401,60,68940,7,"""21""",71160,71220
7254,502401,401303,120,68940,7,"""21""",71220,71340
7254,401303,26503,60,68940,7,"""21""",71340,71400
7254,26503,33903,120,68940,7,"""21""",71400,71520
7254,33903,34001,60,68940,7,"""21""",71520,71580
7254,34001,410201,120,68940,7,"""21""",71580,71700
7254,100,302,60,69660,7,"""21""",69660,69720
7254,302,502,60,69660,7,"""21""",69720,69780
7254,502,202,60,69660,7,"""21""",69780,69840
7254,202,602,60,69660,7,"""21""",69840,69900
7254,602,408703,60,69660,7,"""21""",69900,69960
7254,408703,404002,60,69660,7,"""21""",69960,70020
7254,404002,405502,60,69660,7,"""21""",70020,70080
7254,405502,409102,60,69660,7,"""21""",70080,70140
7254,409102,400902,60,69660,7,"""21""",70140,70200
7254,400902,404502,60,69660,7,"""21""",70200,70260
7254,404502,406401,60,69660,7,"""21""",70260,70320
7254,406401,405103,60,69660,7,"""21""",70320,70380
7254,405103,407602,60,69660,7,"""21""",70380,70440
7254,407602,409003,120,69660,7,"""21""",70440,70560
7254,409003,403803,60,69660,7,"""21""",70560,70620
7254,403803,101103,120,69660,7,"""21""",70620,70740
7254,101103,115100,60,69660,7,"""21""",70740,70800
7254,115100,109015,120,69660,7,"""21""",70800,70920
7254,109015,112104,120,69660,7,"""21""",70920,71040
7254,112104,403101,120,69660,7,"""21""",71040,71160
7254,403101,409401,60,69660,7,"""21""",71160,71220
7254,409401,400103,120,69660,7,"""21""",71220,71340
7254,400103,409501,60,69660,7,"""21""",71340,71400
7254,409501,409701,60,69660,7,"""21""",71400,71460
7254,409701,409801,60,69660,7,"""21""",71460,71520
7254,409801,407505,120,69660,7,"""21""",71520,71640
7254,407505,405002,60,69660,7,"""21""",71640,71700
7254,405002,8101,60,69660,7,"""21""",71700,71760
7254,8101,404803,60,69660,7,"""21""",71760,71820
7254,404803,403401,60,69660,7,"""21""",71820,71880
7254,403401,502401,60,69660,7,"""21""",71880,71940
7254,502401,401303,120,69660,7,"""21""",71940,72060
7254,401303,26503,60,69660,7,"""21""",72060,72120
7254,26503,33903,120,69660,7,"""21""",72120,72240
7254,33903,34001,60,69660,7,"""21""",72240,72300
7254,34001,410201,120,69660,7,"""21""",72300,72420
7255,100,302,60,71460,7,"""21""",71460,71520
7255,302,502,60,71460,7,"""21""",71520,71580
7255,502,202,60,71460,7,"""21""",71580,71640
7255,202,602,60,71460,7,"""21""",71640,71700
7255,602,408703,60,71460,7,"""21""",71700,71760
7255,408703,404002,60,71460,7,"""21""",71760,71820
7255,404002,405502,60,71460,7,"""21""",71820,71880
7255,405502,409102,60,71460,7,"""21""",71880,71940
7255,409102,400902,60,71460,7,"""21""",71940,72000
7255,400902,404502,60,71460,7,"""21""",72000,72060
7255,404502,406401,60,71460,7,"""21""",72060,72120
7255,406401,405103,60,71460,7,"""21""",72120,72180
7255,405103,407602,60,71460,7,"""21""",72180,72240
7255,407602,409003,60,71460,7,"""21""",72240,72300
7255,409003,403803,60,71460,7,"""21""",72300,72360
7255,403803,101103,120,71460,7,"""21""",72360,72480
7255,101103,115100,60,71460,7,"""21""",72480,72540
7255,115100,109015,60,71460,7,"""21""",72540,72600
7255,109015,112104,120,71460,7,"""21""",72600,72720
7255,112104,403101,120,71460,7,"""21""",72720,72840
7255,403101,409401,60,71460,7,"""21""",72840,72900
7255,409401,400103,120,71460,7,"""21""",72900,73020
7255,400103,409501,60,71460,7,"""21""",73020,73080
7255,409501,409701,60,71460,7,"""21""",73080,73140
7255,409701,409801,60,71460,7,"""21""",73140,73200
7255,409801,407505,120,71460,7,"""21""",73200,73320
7255,407505,405002,60,71460,7,"""21""",73320,73380
7255,405002,8101,60,71460,7,"""21""",73380,73440
7255,8101,404803,60,71460,7,"""21""",73440,73500
7255,404803,403401,60,71460,7,"""21""",73500,73560
7255,403401,502401,60,71460,7,"""21""",73560,73620
7255,502401,401303,120,71460,7,"""21""",73620,73740
7255,401303,26503,60,71460,7,"""21""",73740,73800
7255,26503,33903,120,71460,7,"""21""",73800,73920
7255,33903,34001,60,71460,7,"""21""",73920,73980
7255,34001,410201,120,71460,7,"""21""",73980,74100
7255,100,302,60,73260,7,"""21""",73260,73320
7255,302,502,60,73260,7,"""21""",73320,73380
7255,502,202,60,73260,7,"""21""",73380,73440
7255,202,602,60,73260,7,"""21""",73440,73500
7255,602,408703,60,73260,7,"""21""",73500,73560
7255,408703,404002,60,73260,7,"""21""",73560,73620
7255,404002,405502,60,73260,7,"""21""",73620,73680
7255,405502,409102,60,73260,7,"""21""",73680,73740
7255,409102,400902,60,73260,7,"""21""",73740,73800
7255,400902,404502,60,73260,7,"""21""",73800,73860
7255,404502,406401,60,73260,7,"""21""",73860,73920
7255,406401,405103,60,73260,7,"""21""",73920,73980
7255,405103,407602,60,73260,7,"""21""",73980,74040
7255,407602,409003,60,73260,7,"""21""",74040,74100
7255,409003,403803,60,73260,7,"""21""",74100,74160
7255,403803,101103,120,73260,7,"""21""",74160,74280
7255,101103,115100,60,73260,7,"""21""",74280,74340
7255,115100,109015,60,73260,7,"""21""",74340,74400
7255,109015,112104,120,73260,7,"""21""",74400,74520
7255,112104,403101,120,73260,7,"""21""",74520,74640
7255,403101,409401,60,73260,7,"""21""",74640,74700
7255,409401,400103,120,73260,7,"""21""",74700,74820
7255,400103,409501,60,73260,7,"""21""",74820,74880
7255,409501,409701,60,73260,7,"""21""",74880,74940
7255,409701,409801,60,73260,7,"""21""",74940,75000
7255,409801,407505,120,73260,7,"""21""",75000,75120
7255,407505,405002,60,73260,7,"""21""",75120,75180
7255,405002,8101,60,73260,7,"""21""",75180,75240
7255,8101,404803,60,73260,7,"""21""",75240,75300
7255,404803,403401,60,73260,7,"""21""",75300,75360
7255,403401,502401,60,73260,7,"""21""",75360,75420
7255,502401,401303,120,73260,7,"""21""",75420,75540
7255,401303,26503,60,73260,7,"""21""",75540,75600
7255,26503,33903,120,73260,7,"""21""",75600,75720
7255,33903,34001,60,73260,7,"""21""",75720,75780
7255,34001,410201,120,73260,7,"""21""",75780,75900
7255,100,302,60,75060,7,"""21""",75060,75120
7255,302,502,60,75060,7,"""21""",75120,75180
7255,502,202,60,75060,7,"""21""",75180,75240
7255,202,602,60,75060,7,"""21""",75240,75300
7255,602,408703,60,75060,7,"""21""",75300,75360
7255,408703,404002,60,75060,7,"""21""",75360,75420
7255,404002,405502,60,75060,7,"""21""",75420,75480
7255,405502,409102,60,75060,7,"""21""",75480,75540
7255,409102,400902,60,75060,7,"""21""",75540,75600
7255,400902,404502,60,75060,7,"""21""",75600,75660
7255,404502,406401,60,75060,7,"""21""",75660,75720
7255,406401,405103,60,75060,7,"""21""",75720,75780
7255,405103,407602,60,75060,7,"""21""",75780,75840
7255,407602,409003,60,75060,7,"""21""",75840,75900
7255,409003,403803,60,75060,7,"""21""",75900,75960
7255,403803,101103,120,75060,7,"""21""",75960,76080
7255,101103,115100,60,75060,7,"""21""",76080,76140
7255,115100,109015,60,75060,7,"""21""",76140,76200
7255,109015,112104,120,75060,7,"""21""",76200,76320
7255,112104,403101,120,75060,7,"""21""",76320,76440
7255,403101,409401,60,75060,7,"""21""",76440,76500
7255,409401,400103,120,75060,7,"""21""",76500,76620
7255,400103,409501,60,75060,7,"""21""",76620,76680
7255,409501,409701,60,75060,7,"""21""",76680,76740
7255,409701,409801,60,75060,7,"""21""",76740,76800
7255,409801,407505,120,75060,7,"""21""",76800,76920
7255,407505,405002,60,75060,7,"""21""",76920,76980
7255,405002,8101,60,75060,7,"""21""",76980,77040
7255,8101,404803,60,75060,7,"""21""",77040,77100
7255,404803,403401,60,75060,7,"""21""",77100,77160
7255,403401,502401,60,75060,7,"""21""",77160,77220
7255,502401,401303,120,75060,7,"""21""",77220,77340
7255,401303,26503,60,75060,7,"""21""",77340,77400
7255,26503,33903,120,75060,7,"""21""",77400,77520
7255,33903,34001,60,75060,7,"""21""",77520,77580
7255,34001,410201,120,75060,7,"""21""",77580,77700
7255,100,302,60,76860,7,"""21""",76860,76920
7255,302,502,60,76860,7,"""21""",76920,76980
7255,502,202,60,76860,7,"""21""",76980,77040
7255,202,602,60,76860,7,"""21""",77040,77100
7255,602,408703,60,76860,7,"""21""",77100,77160
7255,408703,404002,60,76860,7,"""21""",77160,77220
7255,404002,405502,60,76860,7,"""21""",77220,77280
7255,405502,409102,60,76860,7,"""21""",77280,77340
7255,409102,400902,60,76860,7,"""21""",77340,77400
7255,400902,404502,60,76860,7,"""21""",77400,77460
7255,404502,406401,60,76860,7,"""21""",77460,77520
7255,406401,405103,60,76860,7,"""21""",77520,77580
7255,405103,407602,60,76860,7,"""21""",77580,77640
7255,407602,409003,60,76860,7,"""21""",77640,77700
7255,409003,403803,60,76860,7,"""21""",77700,77760
7255,403803,101103,120,76860,7,"""21""",77760,77880
7255,101103,115100,60,76860,7,"""21""",77880,77940
7255,115100,109015,60,76860,7,"""21""",77940,78000
7255,109015,112104,120,76860,7,"""21""",78000,78120
7255,112104,403101,120,76860,7,"""21""",78120,78240
7255,403101,409401,60,76860,7,"""21""",78240,78300
7255,409401,400103,120,76860,7,"""21""",78300,78420
7255,400103,409501,60,76860,7,"""21""",78420,78480
7255,409501,409701,60,76860,7,"""21""",78480,78540
7255,409701,409801,60,76860,7,"""21""",78540,78600
7255,409801,407505,120,76860,7,"""21""",78600,78720
7255,407505,405002,60,76860,7,"""21""",78720,78780
7255,405002,8101,60,76860,7,"""21""",78780,78840
7255,8101,404803,60,76860,7,"""21""",78840,78900
7255,404803,403401,60,76860,7,"""21""",78900,78960
7255,403401,502401,60,76860,7,"""21""",78960,79020
7255,502401,401303,120,76860,7,"""21""",79020,79140
7255,401303,26503,60,76860,7,"""21""",79140,79200
7255,26503,33903,120,76860,7,"""21""",79200,79320
7255,33903,34001,60,76860,7,"""21""",79320,79380
7255,34001,410201,120,76860,7,"""21""",79380,79500
7255,100,302,60,78660,7,"""21""",78660,78720
7255,302,502,60,78660,7,"""21""",78720,78780
7255,502,202,60,78660,7,"""21""",78780,78840
7255,202,602,60,78660,7,"""21""",78840,78900
7255,602,408703,60,78660,7,"""21""",78900,78960
7255,408703,404002,60,78660,7,"""21""",78960,79020
7255,404002,405502,60,78660,7,"""21""",79020,79080
7255,405502,409102,60,78660,7,"""21""",79080,79140
7255,409102,400902,60,78660,7,"""21""",79140,79200
7255,400902,404502,60,78660,7,"""21""",79200,79260
7255,404502,406401,60,78660,7,"""21""",79260,79320
7255,406401,405103,60,78660,7,"""21""",79320,79380
7255,405103,407602,60,78660,7,"""21""",79380,79440
7255,407602,409003,60,78660,7,"""21""",79440,79500
7255,409003,403803,60,78660,7,"""21""",79500,79560
7255,403803,101103,120,78660,7,"""21""",79560,79680
7255,101103,115100,60,78660,7,"""21""",79680,79740
7255,115100,109015,60,78660,7,"""21""",79740,79800
7255,109015,112104,120,78660,7,"""21""",79800,79920
7255,112104,403101,120,78660,7,"""21""",79920,80040
7255,403101,409401,60,78660,7,"""21""",80040,80100
7255,409401,400103,120,78660,7,"""21""",80100,80220
7255,400103,409501,60,78660,7,"""21""",80220,80280
7255,409501,409701,60,78660,7,"""21""",80280,80340
7255,409701,409801,60,78660,7,"""21""",80340,80400
7255,409801,407505,120,78660,7,"""21""",80400,80520
7255,407505,405002,60,78660,7,"""21""",80520,80580
7255,405002,8101,60,78660,7,"""21""",80580,80640
7255,8101,404803,60,78660,7,"""21""",80640,80700
7255,404803,403401,60,78660,7,"""21""",80700,80760
7255,403401,502401,60,78660,7,"""21""",80760,80820
7255,502401,401303,120,78660,7,"""21""",80820,80940
7255,401303,26503,60,78660,7,"""21""",80940,81000
7255,26503,33903,120,78660,7,"""21""",81000,81120
7255,33903,34001,60,78660,7,"""21""",81120,81180
7255,34001,410201,120,78660,7,"""21""",81180,81300
7255,100,302,60,80460,7,"""21""",80460,80520
7255,302,502,60,80460,7,"""21""",80520,80580
7255,502,202,60,80460,7,"""21""",80580,80640
7255,202,602,60,80460,7,"""21""",80640,80700
7255,602,408703,60,80460,7,"""21""",80700,80760
7255,408703,404002,60,80460,7,"""21""",80760,80820
7255,404002,405502,60,80460,7,"""21""",80820,80880
7255,405502,409102,60,80460,7,"""21""",80880,80940
7255,409102,400902,60,80460,7,"""21""",80940,81000
7255,400902,404502,60,80460,7,"""21""",81000,81060
7255,404502,406401,60,80460,7,"""21""",81060,81120
7255,406401,405103,60,80460,7,"""21""",81120,81180
7255,405103,407602,60,80460,7,"""21""",81180,81240
7255,407602,409003,60,80460,7,"""21""",81240,81300
7255,409003,403803,60,80460,7,"""21""",81300,81360
7255,403803,101103,120,80460,7,"""21""",81360,81480
7255,101103,115100,60,80460,7,"""21""",81480,81540
7255,115100,109015,60,80460,7,"""21""",81540,81600
7255,109015,112104,120,80460,7,"""21""",81600,81720
7255,112104,403101,120,80460,7,"""21""",81720,81840
7255,403101,409401,60,80460,7,"""21""",81840,81900
7255,409401,400103,120,80460,7,"""21""",81900,82020
7255,400103,409501,60,80460,7,"""21""",82020,82080
7255,409501,409701,60,80460,7,"""21""",82080,82140
7255,409701,409801,60,80460,7,"""21""",82140,82200
7255,409801,407505,120,80460,7,"""21""",82200,82320
7255,407505,405002,60,80460,7,"""21""",82320,82380
7255,405002,8101,60,80460,7,"""21""",82380,82440
7255,8101,404803,60,80460,7,"""21""",82440,82500
7255,404803,403401,60,80460,7,"""21""",82500,82560
7255,403401,502401,60,80460,7,"""21""",82560,82620
7255,502401,401303,120,80460,7,"""21""",82620,82740
7255,401303,26503,60,80460,7,"""21""",82740,82800
7255,26503,33903,120,80460,7,"""21""",82800,82920
7255,33903,34001,60,80460,7,"""21""",82920,82980
7255,34001,410201,120,80460,7,"""21""",82980,83100
7255,100,302,60,82260,7,"""21""",82260,82320
7255,302,502,60,82260,7,"""21""",82320,82380
7255,502,202,60,82260,7,"""21""",82380,82440
7255,202,602,60,82260,7,"""21""",82440,82500
7255,602,408703,60,82260,7,"""21""",82500,82560
7255,408703,404002,60,82260,7,"""21""",82560,82620
7255,404002,405502,60,82260,7,"""21""",82620,82680
7255,405502,409102,60,82260,7,"""21""",82680,82740
7255,409102,400902,60,82260,7,"""21""",82740,82800
7255,400902,404502,60,82260,7,"""21""",82800,82860
7255,404502,406401,60,82260,7,"""21""",82860,82920
7255,406401,405103,60,82260,7,"""21""",82920,82980
7255,405103,407602,60,82260,7,"""21""",82980,83040
7255,407602,409003,60,82260,7,"""21""",83040,83100
7255,409003,403803,60,82260,7,"""21""",83100,83160
7255,403803,101103,120,82260,7,"""21""",83160,83280
7255,101103,115100,60,82260,7,"""21""",83280,83340
7255,115100,109015,60,82260,7,"""21""",83340,83400
7255,109015,112104,120,82260,7,"""21""",83400,83520
7255,112104,403101,120,82260,7,"""21""",83520,83640
7255,403101,409401,60,82260,7,"""21""",83640,83700
7255,409401,400103,120,82260,7,"""21""",83700,83820
7255,400103,409501,60,82260,7,"""21""",83820,83880
7255,409501,409701,60,82260,7,"""21""",83880,83940
7255,409701,409801,60,82260,7,"""21""",83940,84000
7255,409801,407505,120,82260,7,"""21""",84000,84120
7255,407505,405002,60,82260,7,"""21""",84120,84180
7255,405002,8101,60,82260,7,"""21""",84180,84240
7255,8101,404803,60,82260,7,"""21""",84240,84300
7255,404803,403401,60,82260,7,"""21""",84300,84360
7255,403401,502401,60,82260,7,"""21""",84360,84420
7255,502401,401303,120,82260,7,"""21""",84420,84540
7255,401303,26503,60,82260,7,"""21""",84540,84600
7255,26503,33903,120,82260,7,"""21""",84600,84720
7255,33903,34001,60,82260,7,"""21""",84720,84780
7255,34001,410201,120,82260,7,"""21""",84780,84900
7255,100,302,60,84060,7,"""21""",84060,84120
7255,302,502,60,84060,7,"""21""",84120,84180
7255,502,202,60,84060,7,"""21""",84180,84240
7255,202,602,60,84060,7,"""21""",84240,84300
7255,602,408703,60,84060,7,"""21""",84300,84360
7255,408703,404002,60,84060,7,"""21""",84360,84420
7255,404002,405502,60,84060,7,"""21""",84420,84480
7255,405502,409102,60,84060,7,"""21""",84480,84540
7255,409102,400902,60,84060,7,"""21""",84540,84600
7255,400902,404502,60,84060,7,"""21""",84600,84660
7255,404502,406401,60,84060,7,"""21""",84660,84720
7255,406401,405103,60,84060,7,"""21""",84720,84780
7255,405103,407602,60,84060,7,"""21""",84780,84840
7255,407602,409003,60,84060,7,"""21""",84840,84900
7255,409003,403803,60,84060,7,"""21""",84900,84960
7255,403803,101103,120,84060,7,"""21""",84960,85080
7255,101103,115100,60,84060,7,"""21""",85080,85140
7255,115100,109015,60,84060,7,"""21""",85140,85200
7255,109015,112104,120,84060,7,"""21""",85200,85320
7255,112104,403101,120,84060,7,"""21""",85320,85440
7255,403101,409401,60,84060,7,"""21""",85440,85500
7255,409401,400103,120,84060,7,"""21""",85500,85620
7255,400103,409501,60,84060,7,"""21""",85620,85680
7255,409501,409701,60,84060,7,"""21""",85680,85740
7255,409701,409801,60,84060,7,"""21""",85740,85800
7255,409801,407505,120,84060,7,"""21""",85800,85920
7255,407505,405002,60,84060,7,"""21""",85920,85980
7255,405002,8101,60,84060,7,"""21""",85980,86040
7255,8101,404803,60,84060,7,"""21""",86040,86100
7255,404803,403401,60,84060,7,"""21""",86100,86160
7255,403401,502401,60,84060,7,"""21""",86160,86220
7255,502401,401303,120,84060,7,"""21""",86220,86340
7255,401303,26503,60,84060,7,"""21""",86340,86400
7255,26503,33903,120,84060,7,"""21""",86400,86520
7255,33903,34001,60,84060,7,"""21""",86520,86580
7255,34001,410201,120,84060,7,"""21""",86580,86700
7256,100,302,60,20940,7,"""21""",20940,21000
7256,302,502,60,20940,7,"""21""",21000,21060
7256,502,202,60,20940,7,"""21""",21060,21120
7256,202,602,60,20940,7,"""21""",21120,21180
7256,602,408703,60,20940,7,"""21""",21180,21240
7256,408703,404002,60,20940,7,"""21""",21240,21300
7256,404002,405502,60,20940,7,"""21""",21300,21360
7256,405502,409102,60,20940,7,"""21""",21360,21420
7256,409102,400902,60,20940,7,"""21""",21420,21480
7256,400902,404502,60,20940,7,"""21""",21480,21540
7256,404502,406401,60,20940,7,"""21""",21540,21600
7256,406401,405103,60,20940,7,"""21""",21600,21660
7256,405103,407602,60,20940,7,"""21""",21660,21720
7256,407602,409003,120,20940,7,"""21""",21720,21840
7256,409003,403803,60,20940,7,"""21""",21840,21900
7256,403803,101103,120,20940,7,"""21""",21900,22020
7256,101103,115100,60,20940,7,"""21""",22020,22080
7256,115100,109015,120,20940,7,"""21""",22080,22200
7256,109015,112104,120,20940,7,"""21""",22200,22320
7256,112104,403101,120,20940,7,"""21""",22320,22440
7256,403101,409401,60,20940,7,"""21""",22440,22500
7256,409401,400103,60,20940,7,"""21""",22500,22560
7256,400103,409501,60,20940,7,"""21""",22560,22620
7256,409501,409701,60,20940,7,"""21""",22620,22680
7256,409701,409801,60,20940,7,"""21""",22680,22740
7256,409801,407505,120,20940,7,"""21""",22740,22860
7256,407505,405002,60,20940,7,"""21""",22860,22920
7256,405002,8101,60,20940,7,"""21""",22920,22980
7256,8101,404803,60,20940,7,"""21""",22980,23040
7256,404803,403401,60,20940,7,"""21""",23040,23100
7256,403401,502401,60,20940,7,"""21""",23100,23160
7256,502401,401303,120,20940,7,"""21""",23160,23280
7256,401303,26503,60,20940,7,"""21""",23280,23340
7256,26503,33903,120,20940,7,"""21""",23340,23460
7256,33903,34001,60,20940,7,"""21""",23460,23520
7256,34001,410201,120,20940,7,"""21""",23520,23640
7256,100,302,60,22140,7,"""21""",22140,22200
7256,302,502,60,22140,7,"""21""",22200,22260
7256,502,202,60,22140,7,"""21""",22260,22320
7256,202,602,60,22140,7,"""21""",22320,22380
7256,602,408703,60,22140,7,"""21""",22380,22440
7256,408703,404002,60,22140,7,"""21""",22440,22500
7256,404002,405502,60,22140,7,"""21""",22500,22560
7256,405502,409102,60,22140,7,"""21""",22560,22620
7256,409102,400902,60,22140,7,"""21""",22620,22680
7256,400902,404502,60,22140,7,"""21""",22680,22740
7256,404502,406401,60,22140,7,"""21""",22740,22800
7256,406401,405103,60,22140,7,"""21""",22800,22860
7256,405103,407602,60,22140,7,"""21""",22860,22920
7256,407602,409003,120,22140,7,"""21""",22920,23040
7256,409003,403803,60,22140,7,"""21""",23040,23100
7256,403803,101103,120,22140,7,"""21""",23100,23220
7256,101103,115100,60,22140,7,"""21""",23220,23280
7256,115100,109015,120,22140,7,"""21""",23280,23400
7256,109015,112104,120,22140,7,"""21""",23400,23520
7256,112104,403101,120,22140,7,"""21""",23520,23640
7256,403101,409401,60,22140,7,"""21""",23640,23700
7256,409401,400103,60,22140,7,"""21""",23700,23760
7256,400103,409501,60,22140,7,"""21""",23760,23820
7256,409501,409701,60,22140,7,"""21""",23820,23880
7256,409701,409801,60,22140,7,"""21""",23880,23940
7256,409801,407505,120,22140,7,"""21""",23940,24060
7256,407505,405002,60,22140,7,"""21""",24060,24120
7256,405002,8101,60,22140,7,"""21""",24120,24180
7256,8101,404803,60,22140,7,"""21""",24180,24240
7256,404803,403401,60,22140,7,"""21""",24240,24300
7256,403401,502401,60,22140,7,"""21""",24300,24360
7256,502401,401303,120,22140,7,"""21""",24360,24480
7256,401303,26503,60,22140,7,"""21""",24480,24540
7256,26503,33903,120,22140,7,"""21""",24540,24660
7256,33903,34001,60,22140,7,"""21""",24660,24720
7256,34001,410201,120,22140,7,"""21""",24720,24840
7256,100,302,60,23340,7,"""21""",23340,23400
7256,302,502,60,23340,7,"""21""",23400,23460
7256,502,202,60,23340,7,"""21""",23460,23520
7256,202,602,60,23340,7,"""21""",23520,23580
7256,602,408703,60,23340,7,"""21""",23580,23640
7256,408703,404002,60,23340,7,"""21""",23640,23700
7256,404002,405502,60,23340,7,"""21""",23700,23760
7256,405502,409102,60,23340,7,"""21""",23760,23820
7256,409102,400902,60,23340,7,"""21""",23820,23880
7256,400902,404502,60,23340,7,"""21""",23880,23940
7256,404502,406401,60,23340,7,"""21""",23940,24000
7256,406401,405103,60,23340,7,"""21""",24000,24060
7256,405103,407602,60,23340,7,"""21""",24060,24120
7256,407602,409003,120,23340,7,"""21""",24120,24240
7256,409003,403803,60,23340,7,"""21""",24240,24300
7256,403803,101103,120,23340,7,"""21""",24300,24420
7256,101103,115100,60,23340,7,"""21""",24420,24480
7256,115100,109015,120,23340,7,"""21""",24480,24600
7256,109015,112104,120,23340,7,"""21""",24600,24720
7256,112104,403101,120,23340,7,"""21""",24720,24840
7256,403101,409401,60,23340,7,"""21""",24840,24900
7256,409401,400103,60,23340,7,"""21""",24900,24960
7256,400103,409501,60,23340,7,"""21""",24960,25020
7256,409501,409701,60,23340,7,"""21""",25020,25080
7256,409701,409801,60,23340,7,"""21""",25080,25140
7256,409801,407505,120,23340,7,"""21""",25140,25260
7256,407505,405002,60,23340,7,"""21""",25260,25320
7256,405002,8101,60,23340,7,"""21""",25320,25380
7256,8101,404803,60,23340,7,"""21""",25380,25440
7256,404803,403401,60,23340,7,"""21""",25440,25500
7256,403401,502401,60,23340,7,"""21""",25500,25560
7256,502401,401303,120,23340,7,"""21""",25560,25680
7256,401303,26503,60,23340,7,"""21""",25680,25740
7256,26503,33903,120,23340,7,"""21""",25740,25860
7256,33903,34001,60,23340,7,"""21""",25860,25920
7256,34001,410201,120,23340,7,"""21""",25920,26040
7257,100,302,60,19800,7,"""21""",19800,19860
7257,302,502,60,19800,7,"""21""",19860,19920
7257,502,202,60,19800,7,"""21""",19920,19980
7257,202,602,60,19800,7,"""21""",19980,20040
7257,602,408703,60,19800,7,"""21""",20040,20100
7257,408703,404002,60,19800,7,"""21""",20100,20160
7257,404002,405502,60,19800,7,"""21""",20160,20220
7257,405502,409102,60,19800,7,"""21""",20220,20280
7257,409102,400902,60,19800,7,"""21""",20280,20340
7257,400902,404502,60,19800,7,"""21""",20340,20400
7257,404502,406401,60,19800,7,"""21""",20400,20460
7257,406401,405103,60,19800,7,"""21""",20460,20520
7257,405103,407602,60,19800,7,"""21""",20520,20580
7257,407602,409003,60,19800,7,"""21""",20580,20640
7257,409003,403803,60,19800,7,"""21""",20640,20700
7257,403803,101103,120,19800,7,"""21""",20700,20820
7257,101103,115100,60,19800,7,"""21""",20820,20880
7257,115100,109015,120,19800,7,"""21""",20880,21000
7257,109015,112104,120,19800,7,"""21""",21000,21120
7257,112104,403101,60,19800,7,"""21""",21120,21180
7257,403101,409401,60,19800,7,"""21""",21180,21240
7257,409401,400103,60,19800,7,"""21""",21240,21300
7257,400103,409501,60,19800,7,"""21""",21300,21360
7257,409501,409701,60,19800,7,"""21""",21360,21420
7257,409701,409801,60,19800,7,"""21""",21420,21480
7257,409801,407505,120,19800,7,"""21""",21480,21600
7257,407505,405002,60,19800,7,"""21""",21600,21660
7257,405002,8101,60,19800,7,"""21""",21660,21720
7257,8101,404803,60,19800,7,"""21""",21720,21780
7257,404803,403401,60,19800,7,"""21""",21780,21840
7257,403401,502401,60,19800,7,"""21""",21840,21900
7257,502401,401303,120,19800,7,"""21""",21900,22020
7257,401303,26503,60,19800,7,"""21""",22020,22080
7257,26503,33903,120,19800,7,"""21""",22080,22200
7257,33903,34001,60,19800,7,"""21""",22200,22260
7257,34001,410201,120,19800,7,"""21""",22260,22380
7258,410201,34002,120,20460,7,"""22""",20460,20580
7258,34002,33902,60,20460,7,"""22""",20580,20640
7258,33902,26502,120,20460,7,"""22""",20640,20760
7258,26502,401302,60,20460,7,"""22""",20760,20820
7258,401302,502402,60,20460,7,"""22""",20820,20880
7258,502402,403402,60,20460,7,"""22""",20880,20940
7258,403402,404801,60,20460,7,"""22""",20940,21000
7258,404801,8102,60,20460,7,"""22""",21000,21060
7258,8102,405001,60,20460,7,"""22""",21060,21120
7258,405001,407504,120,20460,7,"""22""",21120,21240
7258,407504,409802,60,20460,7,"""22""",21240,21300
7258,409802,409702,60,20460,7,"""22""",21300,21360
7258,409702,409502,60,20460,7,"""22""",21360,21420
7258,409502,400104,60,20460,7,"""22""",21420,21480
7258,400104,409402,60,20460,7,"""22""",21480,21540
7258,409402,403104,120,20460,7,"""22""",21540,21660
7258,403104,112102,120,20460,7,"""22""",21660,21780
7258,112102,101101,120,20460,7,"""22""",21780,21900
7258,101101,403801,120,20460,7,"""22""",21900,22020
7258,403801,409002,60,20460,7,"""22""",22020,22080
7258,409002,407601,60,20460,7,"""22""",22080,22140
7258,407601,405106,120,20460,7,"""22""",22140,22260
7258,405106,404501,60,20460,7,"""22""",22260,22320
7258,404501,400901,60,20460,7,"""22""",22320,22380
7258,400901,409101,60,20460,7,"""22""",22380,22440
7258,409101,405501,60,20460,7,"""22""",22440,22500
7258,405501,404001,60,20460,7,"""22""",22500,22560
7258,404001,408704,120,20460,7,"""22""",22560,22680
7258,408704,601,0,20460,7,"""22""",22680,22680
7258,601,201,60,20460,7,"""22""",22680,22740
7258,201,501,60,20460,7,"""22""",22740,22800
7258,501,304,60,20460,7,"""22""",22800,22860
7258,304,100,120,20460,7,"""22""",22860,22980
7258,410201,34002,120,21660,7,"""22""",21660,21780
7258,34002,33902,60,21660,7,"""22""",21780,21840
7258,33902,26502,120,21660,7,"""22""",21840,21960
7258,26502,401302,60,21660,7,"""22""",21960,22020
7258,401302,502402,60,21660,7,"""22""",22020,22080
7258,502402,403402,60,21660,7,"""22""",22080,22140
7258,403402,404801,60,21660,7,"""22""",22140,22200
7258,404801,8102,60,21660,7,"""22""",22200,22260
7258,8102,405001,60,21660,7,"""22""",22260,22320
7258,405001,407504,120,21660,7,"""22""",22320,22440
7258,407504,409802,60,21660,7,"""22""",22440,22500
7258,409802,409702,60,21660,7,"""22""",22500,22560
7258,409702,409502,60,21660,7,"""22""",22560,22620
7258,409502,400104,60,21660,7,"""22""",22620,22680
7258,400104,409402,60,21660,7,"""22""",22680,22740
7258,409402,403104,120,21660,7,"""22""",22740,22860
7258,403104,112102,120,21660,7,"""22""",22860,22980
7258,112102,101101,120,21660,7,"""22""",22980,23100
7258,101101,403801,120,21660,7,"""22""",23100,23220
7258,403801,409002,60,21660,7,"""22""",23220,23280
7258,409002,407601,60,21660,7,"""22""",23280,23340
7258,407601,405106,120,21660,7,"""22""",23340,23460
7258,405106,404501,60,21660,7,"""22""",23460,23520
7258,404501,400901,60,21660,7,"""22""",23520,23580
7258,400901,409101,60,21660,7,"""22""",23580,23640
7258,409101,405501,60,21660,7,"""22""",23640,23700
7258,405501,404001,60,21660,7,"""22""",23700,23760
7258,404001,408704,120,21660,7,"""22""",23760,23880
7258,408704,601,0,21660,7,"""22""",23880,23880
7258,601,201,60,21660,7,"""22""",23880,23940
7258,201,501,60,21660,7,"""22""",23940,24000
7258,501,304,60,21660,7,"""22""",24000,24060
7258,304,100,120,21660,7,"""22""",24060,24180
7258,410201,34002,120,22860,7,"""22""",22860,22980
7258,34002,33902,60,22860,7,"""22""",22980,23040
7258,33902,26502,120,22860,7,"""22""",23040,23160
7258,26502,401302,60,22860,7,"""22""",23160,23220
7258,401302,502402,60,22860,7,"""22""",23220,23280
7258,502402,403402,60,22860,7,"""22""",23280,23340
7258,403402,404801,60,22860,7,"""22""",23340,23400
7258,404801,8102,60,22860,7,"""22""",23400,23460
7258,8102,405001,60,22860,7,"""22""",23460,23520
7258,405001,407504,120,22860,7,"""22""",23520,23640
7258,407504,409802,60,22860,7,"""22""",23640,23700
7258,409802,409702,60,22860,7,"""22""",23700,23760
7258,409702,409502,60,22860,7,"""22""",23760,23820
7258,409502,400104,60,22860,7,"""22""",23820,23880
7258,400104,409402,60,22860,7,"""22""",23880,23940
7258,409402,403104,120,22860,7,"""22""",23940,24060
7258,403104,112102,120,22860,7,"""22""",24060,24180
7258,112102,101101,120,22860,7,"""22""",24180,24300
7258,101101,403801,120,22860,7,"""22""",24300,24420
7258,403801,409002,60,22860,7,"""22""",24420,24480
7258,409002,407601,60,22860,7,"""22""",24480,24540
7258,407601,405106,120,22860,7,"""22""",24540,24660
7258,405106,404501,60,22860,7,"""22""",24660,24720
7258,404501,400901,60,22860,7,"""22""",24720,24780
7258,400901,409101,60,22860,7,"""22""",24780,24840
7258,409101,405501,60,22860,7,"""22""",24840,24900
7258,405501,404001,60,22860,7,"""22""",24900,24960
7258,404001,408704,120,22860,7,"""22""",24960,25080
7258,408704,601,0,22860,7,"""22""",25080,25080
7258,601,201,60,22860,7,"""22""",25080,25140
7258,201,501,60,22860,7,"""22""",25140,25200
7258,501,304,60,22860,7,"""22""",25200,25260
7258,304,100,120,22860,7,"""22""",25260,25380
7258,410201,34002,120,24060,7,"""22""",24060,24180
7258,34002,33902,60,24060,7,"""22""",24180,24240
7258,33902,26502,120,24060,7,"""22""",24240,24360
7258,26502,401302,60,24060,7,"""22""",24360,24420
7258,401302,502402,60,24060,7,"""22""",24420,24480
7258,502402,403402,60,24060,7,"""22""",24480,24540
7258,403402,404801,60,24060,7,"""22""",24540,24600
7258,404801,8102,60,24060,7,"""22""",24600,24660
7258,8102,405001,60,24060,7,"""22""",24660,24720
7258,405001,407504,120,24060,7,"""22""",24720,24840
7258,407504,409802,60,24060,7,"""22""",24840,24900
7258,409802,409702,60,24060,7,"""22""",24900,24960
7258,409702,409502,60,24060,7,"""22""",24960,25020
7258,409502,400104,60,24060,7,"""22""",25020,25080
7258,400104,409402,60,24060,7,"""22""",25080,25140
7258,409402,403104,120,24060,7,"""22""",25140,25260
7258,403104,112102,120,24060,7,"""22""",25260,25380
7258,112102,101101,120,24060,7,"""22""",25380,25500
7258,101101,403801,120,24060,7,"""22""",25500,25620
7258,403801,409002,60,24060,7,"""22""",25620,25680
7258,409002,407601,60,24060,7,"""22""",25680,25740
7258,407601,405106,120,24060,7,"""22""",25740,25860
7258,405106,404501,60,24060,7,"""22""",25860,25920
7258,404501,400901,60,24060,7,"""22""",25920,25980
7258,400901,409101,60,24060,7,"""22""",25980,26040
7258,409101,405501,60,24060,7,"""22""",26040,26100
7258,405501,404001,60,24060,7,"""22""",26100,26160
7258,404001,408704,120,24060,7,"""22""",26160,26280
7258,408704,601,0,24060,7,"""22""",26280,26280
7258,601,201,60,24060,7,"""22""",26280,26340
7258,201,501,60,24060,7,"""22""",26340,26400
7258,501,304,60,24060,7,"""22""",26400,26460
7258,304,100,120,24060,7,"""22""",26460,26580
7258,410201,34002,120,25260,7,"""22""",25260,25380
7258,34002,33902,60,25260,7,"""22""",25380,25440
7258,33902,26502,120,25260,7,"""22""",25440,25560
7258,26502,401302,60,25260,7,"""22""",25560,25620
7258,401302,502402,60,25260,7,"""22""",25620,25680
7258,502402,403402,60,25260,7,"""22""",25680,25740
7258,403402,404801,60,25260,7,"""22""",25740,25800
7258,404801,8102,60,25260,7,"""22""",25800,25860
7258,8102,405001,60,25260,7,"""22""",25860,25920
7258,405001,407504,120,25260,7,"""22""",25920,26040
7258,407504,409802,60,25260,7,"""22""",26040,26100
7258,409802,409702,60,25260,7,"""22""",26100,26160
7258,409702,409502,60,25260,7,"""22""",26160,26220
7258,409502,400104,60,25260,7,"""22""",26220,26280
7258,400104,409402,60,25260,7,"""22""",26280,26340
7258,409402,403104,120,25260,7,"""22""",26340,26460
7258,403104,112102,120,25260,7,"""22""",26460,26580
7258,112102,101101,120,25260,7,"""22""",26580,26700
7258,101101,403801,120,25260,7,"""22""",26700,26820
7258,403801,409002,60,25260,7,"""22""",26820,26880
7258,409002,407601,60,25260,7,"""22""",26880,26940
7258,407601,405106,120,25260,7,"""22""",26940,27060
7258,405106,404501,60,25260,7,"""22""",27060,27120
7258,404501,400901,60,25260,7,"""22""",27120,27180
7258,400901,409101,60,25260,7,"""22""",27180,27240
7258,409101,405501,60,25260,7,"""22""",27240,27300
7258,405501,404001,60,25260,7,"""22""",27300,27360
7258,404001,408704,120,25260,7,"""22""",27360,27480
7258,408704,601,0,25260,7,"""22""",27480,27480
7258,601,201,60,25260,7,"""22""",27480,27540
7258,201,501,60,25260,7,"""22""",27540,27600
7258,501,304,60,25260,7,"""22""",27600,27660
7258,304,100,120,25260,7,"""22""",27660,27780
7258,410201,34002,120,26460,7,"""22""",26460,26580
7258,34002,33902,60,26460,7,"""22""",26580,26640
7258,33902,26502,120,26460,7,"""22""",26640,26760
7258,26502,401302,60,26460,7,"""22""",26760,26820
7258,401302,502402,60,26460,7,"""22""",26820,26880
7258,502402,403402,60,26460,7,"""22""",26880,26940
7258,403402,404801,60,26460,7,"""22""",26940,27000
7258,404801,8102,60,26460,7,"""22""",27000,27060
7258,8102,405001,60,26460,7,"""22""",27060,27120
7258,405001,407504,120,26460,7,"""22""",27120,27240
7258,407504,409802,60,26460,7,"""22""",27240,27300
7258,409802,409702,60,26460,7,"""22""",27300,27360
7258,409702,409502,60,26460,7,"""22""",27360,27420
7258,409502,400104,60,26460,7,"""22""",27420,27480
7258,400104,409402,60,26460,7,"""22""",27480,27540
7258,409402,403104,120,26460,7,"""22""",27540,27660
7258,403104,112102,120,26460,7,"""22""",27660,27780
7258,112102,101101,120,26460,7,"""22""",27780,27900
7258,101101,403801,120,26460,7,"""22""",27900,28020
7258,403801,409002,60,26460,7,"""22""",28020,28080
7258,409002,407601,60,26460,7,"""22""",28080,28140
7258,407601,405106,120,26460,7,"""22""",28140,28260
7258,405106,404501,60,26460,7,"""22""",28260,28320
7258,404501,400901,60,26460,7,"""22""",28320,28380
7258,400901,409101,60,26460,7,"""22""",28380,28440
7258,409101,405501,60,26460,7,"""22""",28440,28500
7258,405501,404001,60,26460,7,"""22""",28500,28560
7258,404001,408704,120,26460,7,"""22""",28560,28680
7258,408704,601,0,26460,7,"""22""",28680,28680
7258,601,201,60,26460,7,"""22""",28680,28740
7258,201,501,60,26460,7,"""22""",28740,28800
7258,501,304,60,26460,7,"""22""",28800,28860
7258,304,100,120,26460,7,"""22""",28860,28980
7258,410201,34002,120,27660,7,"""22""",27660,27780
7258,34002,33902,60,27660,7,"""22""",27780,27840
7258,33902,26502,120,27660,7,"""22""",27840,27960
7258,26502,401302,60,27660,7,"""22""",27960,28020
7258,401302,502402,60,27660,7,"""22""",28020,28080
7258,502402,403402,60,27660,7,"""22""",28080,28140
7258,403402,404801,60,27660,7,"""22""",28140,28200
7258,404801,8102,60,27660,7,"""22""",28200,28260
7258,8102,405001,60,27660,7,"""22""",28260,28320
7258,405001,407504,120,27660,7,"""22""",28320,28440
7258,407504,409802,60,27660,7,"""22""",28440,28500
7258,409802,409702,60,27660,7,"""22""",28500,28560
7258,409702,409502,60,27660,7,"""22""",28560,28620
7258,409502,400104,60,27660,7,"""22""",28620,28680
7258,400104,409402,60,27660,7,"""22""",28680,28740
7258,409402,403104,120,27660,7,"""22""",28740,28860
7258,403104,112102,120,27660,7,"""22""",28860,28980
7258,112102,101101,120,27660,7,"""22""",28980,29100
7258,101101,403801,120,27660,7,"""22""",29100,29220
7258,403801,409002,60,27660,7,"""22""",29220,29280
7258,409002,407601,60,27660,7,"""22""",29280,29340
7258,407601,405106,120,27660,7,"""22""",29340,29460
7258,405106,404501,60,27660,7,"""22""",29460,29520
7258,404501,400901,60,27660,7,"""22""",29520,29580
7258,400901,409101,60,27660,7,"""22""",29580,29640
7258,409101,405501,60,27660,7,"""22""",29640,29700
7258,405501,404001,60,27660,7,"""22""",29700,29760
7258,404001,408704,120,27660,7,"""22""",29760,29880
7258,408704,601,0,27660,7,"""22""",29880,29880
7258,601,201,60,27660,7,"""22""",29880,29940
7258,201,501,60,27660,7,"""22""",29940,30000
7258,501,304,60,27660,7,"""22""",30000,30060
7258,304,100,120,27660,7,"""22""",30060,30180
7258,410201,34002,120,28860,7,"""22""",28860,28980
7258,34002,33902,60,28860,7,"""22""",28980,29040
7258,33902,26502,120,28860,7,"""22""",29040,29160
7258,26502,401302,60,28860,7,"""22""",29160,29220
7258,401302,502402,60,28860,7,"""22""",29220,29280
7258,502402,403402,60,28860,7,"""22""",29280,29340
7258,403402,404801,60,28860,7,"""22""",29340,29400
7258,404801,8102,60,28860,7,"""22""",29400,29460
7258,8102,405001,60,28860,7,"""22""",29460,29520
7258,405001,407504,120,28860,7,"""22""",29520,29640
7258,407504,409802,60,28860,7,"""22""",29640,29700
7258,409802,409702,60,28860,7,"""22""",29700,29760
7258,409702,409502,60,28860,7,"""22""",29760,29820
7258,409502,400104,60,28860,7,"""22""",29820,29880
7258,400104,409402,60,28860,7,"""22""",29880,29940
7258,409402,403104,120,28860,7,"""22""",29940,30060
7258,403104,112102,120,28860,7,"""22""",30060,30180
7258,112102,101101,120,28860,7,"""22""",30180,30300
7258,101101,403801,120,28860,7,"""22""",30300,30420
7258,403801,409002,60,28860,7,"""22""",30420,30480
7258,409002,407601,60,28860,7,"""22""",30480,30540
7258,407601,405106,120,28860,7,"""22""",30540,30660
7258,405106,404501,60,28860,7,"""22""",30660,30720
7258,404501,400901,60,28860,7,"""22""",30720,30780
7258,400901,409101,60,28860,7,"""22""",30780,30840
7258,409101,405501,60,28860,7,"""22""",30840,30900
7258,405501,404001,60,28860,7,"""22""",30900,30960
7258,404001,408704,120,28860,7,"""22""",30960,31080
7258,408704,601,0,28860,7,"""22""",31080,31080
7258,601,201,60,28860,7,"""22""",31080,31140
7258,201,501,60,28860,7,"""22""",31140,31200
7258,501,304,60,28860,7,"""22""",31200,31260
7258,304,100,120,28860,7,"""22""",31260,31380
7258,410201,34002,120,30060,7,"""22""",30060,30180
7258,34002,33902,60,30060,7,"""22""",30180,30240
7258,33902,26502,120,30060,7,"""22""",30240,30360
7258,26502,401302,60,30060,7,"""22""",30360,30420
7258,401302,502402,60,30060,7,"""22""",30420,30480
7258,502402,403402,60,30060,7,"""22""",30480,30540
7258,403402,404801,60,30060,7,"""22""",30540,30600
7258,404801,8102,60,30060,7,"""22""",30600,30660
7258,8102,405001,60,30060,7,"""22""",30660,30720
7258,405001,407504,120,30060,7,"""22""",30720,30840
7258,407504,409802,60,30060,7,"""22""",30840,30900
7258,409802,409702,60,30060,7,"""22""",30900,30960
7258,409702,409502,60,30060,7,"""22""",30960,31020
7258,409502,400104,60,30060,7,"""22""",31020,31080
7258,400104,409402,60,30060,7,"""22""",31080,31140
7258,409402,403104,120,30060,7,"""22""",31140,31260
7258,403104,112102,120,30060,7,"""22""",31260,31380
7258,112102,101101,120,30060,7,"""22""",31380,31500
7258,101101,403801,120,30060,7,"""22""",31500,31620
7258,403801,409002,60,30060,7,"""22""",31620,31680
7258,409002,407601,60,30060,7,"""22""",31680,31740
7258,407601,405106,120,30060,7,"""22""",31740,31860
7258,405106,404501,60,30060,7,"""22""",31860,31920
7258,404501,400901,60,30060,7,"""22""",31920,31980
7258,400901,409101,60,30060,7,"""22""",31980,32040
7258,409101,405501,60,30060,7,"""22""",32040,32100
7258,405501,404001,60,30060,7,"""22""",32100,32160
7258,404001,408704,120,30060,7,"""22""",32160,32280
7258,408704,601,0,30060,7,"""22""",32280,32280
7258,601,201,60,30060,7,"""22""",32280,32340
7258,201,501,60,30060,7,"""22""",32340,32400
7258,501,304,60,30060,7,"""22""",32400,32460
7258,304,100,120,30060,7,"""22""",32460,32580
7258,410201,34002,120,31260,7,"""22""",31260,31380
7258,34002,33902,60,31260,7,"""22""",31380,31440
7258,33902,26502,120,31260,7,"""22""",31440,31560
7258,26502,401302,60,31260,7,"""22""",31560,31620
7258,401302,502402,60,31260,7,"""22""",31620,31680
7258,502402,403402,60,31260,7,"""22""",31680,31740
7258,403402,404801,60,31260,7,"""22""",31740,31800
7258,404801,8102,60,31260,7,"""22""",31800,31860
7258,8102,405001,60,31260,7,"""22""",31860,31920
7258,405001,407504,120,31260,7,"""22""",31920,32040
7258,407504,409802,60,31260,7,"""22""",32040,32100
7258,409802,409702,60,31260,7,"""22""",32100,32160
7258,409702,409502,60,31260,7,"""22""",32160,32220
7258,409502,400104,60,31260,7,"""22""",32220,32280
7258,400104,409402,60,31260,7,"""22""",32280,32340
7258,409402,403104,120,31260,7,"""22""",32340,32460
7258,403104,112102,120,31260,7,"""22""",32460,32580
7258,112102,101101,120,31260,7,"""22""",32580,32700
7258,101101,403801,120,31260,7,"""22""",32700,32820
7258,403801,409002,60,31260,7,"""22""",32820,32880
7258,409002,407601,60,31260,7,"""22""",32880,32940
7258,407601,405106,120,31260,7,"""22""",32940,33060
7258,405106,404501,60,31260,7,"""22""",33060,33120
7258,404501,400901,60,31260,7,"""22""",33120,33180
7258,400901,409101,60,31260,7,"""22""",33180,33240
7258,409101,405501,60,31260,7,"""22""",33240,33300
7258,405501,404001,60,31260,7,"""22""",33300,33360
7258,404001,408704,120,31260,7,"""22""",33360,33480
7258,408704,601,0,31260,7,"""22""",33480,33480
7258,601,201,60,31260,7,"""22""",33480,33540
7258,201,501,60,31260,7,"""22""",33540,33600
7258,501,304,60,31260,7,"""22""",33600,33660
7258,304,100,120,31260,7,"""22""",33660,33780
7258,410201,34002,120,32460,7,"""22""",32460,32580
7258,34002,33902,60,32460,7,"""22""",32580,32640
7258,33902,26502,120,32460,7,"""22""",32640,32760
7258,26502,401302,60,32460,7,"""22""",32760,32820
7258,401302,502402,60,32460,7,"""22""",32820,32880
7258,502402,403402,60,32460,7,"""22""",32880,32940
7258,403402,404801,60,32460,7,"""22""",32940,33000
7258,404801,8102,60,32460,7,"""22""",33000,33060
7258,8102,405001,60,32460,7,"""22""",33060,33120
7258,405001,407504,120,32460,7,"""22""",33120,33240
7258,407504,409802,60,32460,7,"""22""",33240,33300
7258,409802,409702,60,32460,7,"""22""",33300,33360
7258,409702,409502,60,32460,7,"""22""",33360,33420
7258,409502,400104,60,32460,7,"""22""",33420,33480
7258,400104,409402,60,32460,7,"""22""",33480,33540
7258,409402,403104,120,32460,7,"""22""",33540,33660
7258,403104,112102,120,32460,7,"""22""",33660,33780
7258,112102,101101,120,32460,7,"""22""",33780,33900
7258,101101,403801,120,32460,7,"""22""",33900,34020
7258,403801,409002,60,32460,7,"""22""",34020,34080
7258,409002,407601,60,32460,7,"""22""",34080,34140
7258,407601,405106,120,32460,7,"""22""",34140,34260
7258,405106,404501,60,32460,7,"""22""",34260,34320
7258,404501,400901,60,32460,7,"""22""",34320,34380
7258,400901,409101,60,32460,7,"""22""",34380,34440
7258,409101,405501,60,32460,7,"""22""",34440,34500
7258,405501,404001,60,32460,7,"""22""",34500,34560
7258,404001,408704,120,32460,7,"""22""",34560,34680
7258,408704,601,0,32460,7,"""22""",34680,34680
7258,601,201,60,32460,7,"""22""",34680,34740
7258,201,501,60,32460,7,"""22""",34740,34800
7258,501,304,60,32460,7,"""22""",34800,34860
7258,304,100,120,32460,7,"""22""",34860,34980
7258,410201,34002,120,33660,7,"""22""",33660,33780
7258,34002,33902,60,33660,7,"""22""",33780,33840
7258,33902,26502,120,33660,7,"""22""",33840,33960
7258,26502,401302,60,33660,7,"""22""",33960,34020
7258,401302,502402,60,33660,7,"""22""",34020,34080
7258,502402,403402,60,33660,7,"""22""",34080,34140
7258,403402,404801,60,33660,7,"""22""",34140,34200
7258,404801,8102,60,33660,7,"""22""",34200,34260
7258,8102,405001,60,33660,7,"""22""",34260,34320
7258,405001,407504,120,33660,7,"""22""",34320,34440
7258,407504,409802,60,33660,7,"""22""",34440,34500
7258,409802,409702,60,33660,7,"""22""",34500,34560
7258,409702,409502,60,33660,7,"""22""",34560,34620
7258,409502,400104,60,33660,7,"""22""",34620,34680
7258,400104,409402,60,33660,7,"""22""",34680,34740
7258,409402,403104,120,33660,7,"""22""",34740,34860
7258,403104,112102,120,33660,7,"""22""",34860,34980
7258,112102,101101,120,33660,7,"""22""",34980,35100
7258,101101,403801,120,33660,7,"""22""",35100,35220
7258,403801,409002,60,33660,7,"""22""",35220,35280
7258,409002,407601,60,33660,7,"""22""",35280,35340
7258,407601,405106,120,33660,7,"""22""",35340,35460
7258,405106,404501,60,33660,7,"""22""",35460,35520
7258,404501,400901,60,33660,7,"""22""",35520,35580
7258,400901,409101,60,33660,7,"""22""",35580,35640
7258,409101,405501,60,33660,7,"""22""",35640,35700
7258,405501,404001,60,33660,7,"""22""",35700,35760
7258,404001,408704,120,33660,7,"""22""",35760,35880
7258,408704,601,0,33660,7,"""22""",35880,35880
7258,601,201,60,33660,7,"""22""",35880,35940
7258,201,501,60,33660,7,"""22""",35940,36000
7258,501,304,60,33660,7,"""22""",36000,36060
7258,304,100,120,33660,7,"""22""",36060,36180
7258,410201,34002,120,34860,7,"""22""",34860,34980
7258,34002,33902,60,34860,7,"""22""",34980,35040
7258,33902,26502,120,34860,7,"""22""",35040,35160
7258,26502,401302,60,34860,7,"""22""",35160,35220
7258,401302,502402,60,34860,7,"""22""",35220,35280
7258,502402,403402,60,34860,7,"""22""",35280,35340
7258,403402,404801,60,34860,7,"""22""",35340,35400
7258,404801,8102,60,34860,7,"""22""",35400,35460
7258,8102,405001,60,34860,7,"""22""",35460,35520
7258,405001,407504,120,34860,7,"""22""",35520,35640
7258,407504,409802,60,34860,7,"""22""",35640,35700
7258,409802,409702,60,34860,7,"""22""",35700,35760
7258,409702,409502,60,34860,7,"""22""",35760,35820
7258,409502,400104,60,34860,7,"""22""",35820,35880
7258,400104,409402,60,34860,7,"""22""",35880,35940
7258,409402,403104,120,34860,7,"""22""",35940,36060
7258,403104,112102,120,34860,7,"""22""",36060,36180
7258,112102,101101,120,34860,7,"""22""",36180,36300
7258,101101,403801,120,34860,7,"""22""",36300,36420
7258,403801,409002,60,34860,7,"""22""",36420,36480
7258,409002,407601,60,34860,7,"""22""",36480,36540
7258,407601,405106,120,34860,7,"""22""",36540,36660
7258,405106,404501,60,34860,7,"""22""",36660,36720
7258,404501,400901,60,34860,7,"""22""",36720,36780
7258,400901,409101,60,34860,7,"""22""",36780,36840
7258,409101,405501,60,34860,7,"""22""",36840,36900
7258,405501,404001,60,34860,7,"""22""",36900,36960
7258,404001,408704,120,34860,7,"""22""",36960,37080
7258,408704,601,0,34860,7,"""22""",37080,37080
7258,601,201,60,34860,7,"""22""",37080,37140
7258,201,501,60,34860,7,"""22""",37140,37200
7258,501,304,60,34860,7,"""22""",37200,37260
7258,304,100,120,34860,7,"""22""",37260,37380
7258,410201,34002,120,36060,7,"""22""",36060,36180
7258,34002,33902,60,36060,7,"""22""",36180,36240
7258,33902,26502,120,36060,7,"""22""",36240,36360
7258,26502,401302,60,36060,7,"""22""",36360,36420
7258,401302,502402,60,36060,7,"""22""",36420,36480
7258,502402,403402,60,36060,7,"""22""",36480,36540
7258,403402,404801,60,36060,7,"""22""",36540,36600
7258,404801,8102,60,36060,7,"""22""",36600,36660
7258,8102,405001,60,36060,7,"""22""",36660,36720
7258,405001,407504,120,36060,7,"""22""",36720,36840
7258,407504,409802,60,36060,7,"""22""",36840,36900
7258,409802,409702,60,36060,7,"""22""",36900,36960
7258,409702,409502,60,36060,7,"""22""",36960,37020
7258,409502,400104,60,36060,7,"""22""",37020,37080
7258,400104,409402,60,36060,7,"""22""",37080,37140
7258,409402,403104,120,36060,7,"""22""",37140,37260
7258,403104,112102,120,36060,7,"""22""",37260,37380
7258,112102,101101,120,36060,7,"""22""",37380,37500
7258,101101,403801,120,36060,7,"""22""",37500,37620
7258,403801,409002,60,36060,7,"""22""",37620,37680
7258,409002,407601,60,36060,7,"""22""",37680,37740
7258,407601,405106,120,36060,7,"""22""",37740,37860
7258,405106,404501,60,36060,7,"""22""",37860,37920
7258,404501,400901,60,36060,7,"""22""",37920,37980
7258,400901,409101,60,36060,7,"""22""",37980,38040
7258,409101,405501,60,36060,7,"""22""",38040,38100
7258,405501,404001,60,36060,7,"""22""",38100,38160
7258,404001,408704,120,36060,7,"""22""",38160,38280
7258,408704,601,0,36060,7,"""22""",38280,38280
7258,601,201,60,36060,7,"""22""",38280,38340
7258,201,501,60,36060,7,"""22""",38340,38400
7258,501,304,60,36060,7,"""22""",38400,38460
7258,304,100,120,36060,7,"""22""",38460,38580
7258,410201,34002,120,37260,7,"""22""",37260,37380
7258,34002,33902,60,37260,7,"""22""",37380,37440
7258,33902,26502,120,37260,7,"""22""",37440,37560
7258,26502,401302,60,37260,7,"""22""",37560,37620
7258,401302,502402,60,37260,7,"""22""",37620,37680
7258,502402,403402,60,37260,7,"""22""",37680,37740
7258,403402,404801,60,37260,7,"""22""",37740,37800
7258,404801,8102,60,37260,7,"""22""",37800,37860
7258,8102,405001,60,37260,7,"""22""",37860,37920
7258,405001,407504,120,37260,7,"""22""",37920,38040
7258,407504,409802,60,37260,7,"""22""",38040,38100
7258,409802,409702,60,37260,7,"""22""",38100,38160
7258,409702,409502,60,37260,7,"""22""",38160,38220
7258,409502,400104,60,37260,7,"""22""",38220,38280
7258,400104,409402,60,37260,7,"""22""",38280,38340
7258,409402,403104,120,37260,7,"""22""",38340,38460
7258,403104,112102,120,37260,7,"""22""",38460,38580
7258,112102,101101,120,37260,7,"""22""",38580,38700
7258,101101,403801,120,37260,7,"""22""",38700,38820
7258,403801,409002,60,37260,7,"""22""",38820,38880
7258,409002,407601,60,37260,7,"""22""",38880,38940
7258,407601,405106,120,37260,7,"""22""",38940,39060
7258,405106,404501,60,37260,7,"""22""",39060,39120
7258,404501,400901,60,37260,7,"""22""",39120,39180
7258,400901,409101,60,37260,7,"""22""",39180,39240
7258,409101,405501,60,37260,7,"""22""",39240,39300
7258,405501,404001,60,37260,7,"""22""",39300,39360
7258,404001,408704,120,37260,7,"""22""",39360,39480
7258,408704,601,0,37260,7,"""22""",39480,39480
7258,601,201,60,37260,7,"""22""",39480,39540
7258,201,501,60,37260,7,"""22""",39540,39600
7258,501,304,60,37260,7,"""22""",39600,39660
7258,304,100,120,37260,7,"""22""",39660,39780
7258,410201,34002,120,38460,7,"""22""",38460,38580
7258,34002,33902,60,38460,7,"""22""",38580,38640
7258,33902,26502,120,38460,7,"""22""",38640,38760
7258,26502,401302,60,38460,7,"""22""",38760,38820
7258,401302,502402,60,38460,7,"""22""",38820,38880
7258,502402,403402,60,38460,7,"""22""",38880,38940
7258,403402,404801,60,38460,7,"""22""",38940,39000
7258,404801,8102,60,38460,7,"""22""",39000,39060
7258,8102,405001,60,38460,7,"""22""",39060,39120
7258,405001,407504,120,38460,7,"""22""",39120,39240
7258,407504,409802,60,38460,7,"""22""",39240,39300
7258,409802,409702,60,38460,7,"""22""",39300,39360
7258,409702,409502,60,38460,7,"""22""",39360,39420
7258,409502,400104,60,38460,7,"""22""",39420,39480
7258,400104,409402,60,38460,7,"""22""",39480,39540
7258,409402,403104,120,38460,7,"""22""",39540,39660
7258,403104,112102,120,38460,7,"""22""",39660,39780
7258,112102,101101,120,38460,7,"""22""",39780,39900
7258,101101,403801,120,38460,7,"""22""",39900,40020
7258,403801,409002,60,38460,7,"""22""",40020,40080
7258,409002,407601,60,38460,7,"""22""",40080,40140
7258,407601,405106,120,38460,7,"""22""",40140,40260
7258,405106,404501,60,38460,7,"""22""",40260,40320
7258,404501,400901,60,38460,7,"""22""",40320,40380
7258,400901,409101,60,38460,7,"""22""",40380,40440
7258,409101,405501,60,38460,7,"""22""",40440,40500
7258,405501,404001,60,38460,7,"""22""",40500,40560
7258,404001,408704,120,38460,7,"""22""",40560,40680
7258,408704,601,0,38460,7,"""22""",40680,40680
7258,601,201,60,38460,7,"""22""",40680,40740
7258,201,501,60,38460,7,"""22""",40740,40800
7258,501,304,60,38460,7,"""22""",40800,40860
7258,304,100,120,38460,7,"""22""",40860,40980
7258,410201,34002,120,39660,7,"""22""",39660,39780
7258,34002,33902,60,39660,7,"""22""",39780,39840
7258,33902,26502,120,39660,7,"""22""",39840,39960
7258,26502,401302,60,39660,7,"""22""",39960,40020
7258,401302,502402,60,39660,7,"""22""",40020,40080
7258,502402,403402,60,39660,7,"""22""",40080,40140
7258,403402,404801,60,39660,7,"""22""",40140,40200
7258,404801,8102,60,39660,7,"""22""",40200,40260
7258,8102,405001,60,39660,7,"""22""",40260,40320
7258,405001,407504,120,39660,7,"""22""",40320,40440
7258,407504,409802,60,39660,7,"""22""",40440,40500
7258,409802,409702,60,39660,7,"""22""",40500,40560
7258,409702,409502,60,39660,7,"""22""",40560,40620
7258,409502,400104,60,39660,7,"""22""",40620,40680
7258,400104,409402,60,39660,7,"""22""",40680,40740
7258,409402,403104,120,39660,7,"""22""",40740,40860
7258,403104,112102,120,39660,7,"""22""",40860,40980
7258,112102,101101,120,39660,7,"""22""",40980,41100
7258,101101,403801,120,39660,7,"""22""",41100,41220
7258,403801,409002,60,39660,7,"""22""",41220,41280
7258,409002,407601,60,39660,7,"""22""",41280,41340
7258,407601,405106,120,39660,7,"""22""",41340,41460
7258,405106,404501,60,39660,7,"""22""",41460,41520
7258,404501,400901,60,39660,7,"""22""",41520,41580
7258,400901,409101,60,39660,7,"""22""",41580,41640
7258,409101,405501,60,39660,7,"""22""",41640,41700
7258,405501,404001,60,39660,7,"""22""",41700,41760
7258,404001,408704,120,39660,7,"""22""",41760,41880
7258,408704,601,0,39660,7,"""22""",41880,41880
7258,601,201,60,39660,7,"""22""",41880,41940
7258,201,501,60,39660,7,"""22""",41940,42000
7258,501,304,60,39660,7,"""22""",42000,42060
7258,304,100,120,39660,7,"""22""",42060,42180
7258,410201,34002,120,40860,7,"""22""",40860,40980
7258,34002,33902,60,40860,7,"""22""",40980,41040
7258,33902,26502,120,40860,7,"""22""",41040,41160
7258,26502,401302,60,40860,7,"""22""",41160,41220
7258,401302,502402,60,40860,7,"""22""",41220,41280
7258,502402,403402,60,40860,7,"""22""",41280,41340
7258,403402,404801,60,40860,7,"""22""",41340,41400
7258,404801,8102,60,40860,7,"""22""",41400,41460
7258,8102,405001,60,40860,7,"""22""",41460,41520
7258,405001,407504,120,40860,7,"""22""",41520,41640
7258,407504,409802,60,40860,7,"""22""",41640,41700
7258,409802,409702,60,40860,7,"""22""",41700,41760
7258,409702,409502,60,40860,7,"""22""",41760,41820
7258,409502,400104,60,40860,7,"""22""",41820,41880
7258,400104,409402,60,40860,7,"""22""",41880,41940
7258,409402,403104,120,40860,7,"""22""",41940,42060
7258,403104,112102,120,40860,7,"""22""",42060,42180
7258,112102,101101,120,40860,7,"""22""",42180,42300
7258,101101,403801,120,40860,7,"""22""",42300,42420
7258,403801,409002,60,40860,7,"""22""",42420,42480
7258,409002,407601,60,40860,7,"""22""",42480,42540
7258,407601,405106,120,40860,7,"""22""",42540,42660
7258,405106,404501,60,40860,7,"""22""",42660,42720
7258,404501,400901,60,40860,7,"""22""",42720,42780
7258,400901,409101,60,40860,7,"""22""",42780,42840
7258,409101,405501,60,40860,7,"""22""",42840,42900
7258,405501,404001,60,40860,7,"""22""",42900,42960
7258,404001,408704,120,40860,7,"""22""",42960,43080
7258,408704,601,0,40860,7,"""22""",43080,43080
7258,601,201,60,40860,7,"""22""",43080,43140
7258,201,501,60,40860,7,"""22""",43140,43200
7258,501,304,60,40860,7,"""22""",43200,43260
7258,304,100,120,40860,7,"""22""",43260,43380
7258,410201,34002,120,42060,7,"""22""",42060,42180
7258,34002,33902,60,42060,7,"""22""",42180,42240
7258,33902,26502,120,42060,7,"""22""",42240,42360
7258,26502,401302,60,42060,7,"""22""",42360,42420
7258,401302,502402,60,42060,7,"""22""",42420,42480
7258,502402,403402,60,42060,7,"""22""",42480,42540
7258,403402,404801,60,42060,7,"""22""",42540,42600
7258,404801,8102,60,42060,7,"""22""",42600,42660
7258,8102,405001,60,42060,7,"""22""",42660,42720
7258,405001,407504,120,42060,7,"""22""",42720,42840
7258,407504,409802,60,42060,7,"""22""",42840,42900
7258,409802,409702,60,42060,7,"""22""",42900,42960
7258,409702,409502,60,42060,7,"""22""",42960,43020
7258,409502,400104,60,42060,7,"""22""",43020,43080
7258,400104,409402,60,42060,7,"""22""",43080,43140
7258,409402,403104,120,42060,7,"""22""",43140,43260
7258,403104,112102,120,42060,7,"""22""",43260,43380
7258,112102,101101,120,42060,7,"""22""",43380,43500
7258,101101,403801,120,42060,7,"""22""",43500,43620
7258,403801,409002,60,42060,7,"""22""",43620,43680
7258,409002,407601,60,42060,7,"""22""",43680,43740
7258,407601,405106,120,42060,7,"""22""",43740,43860
7258,405106,404501,60,42060,7,"""22""",43860,43920
7258,404501,400901,60,42060,7,"""22""",43920,43980
7258,400901,409101,60,42060,7,"""22""",43980,44040
7258,409101,405501,60,42060,7,"""22""",44040,44100
7258,405501,404001,60,42060,7,"""22""",44100,44160
7258,404001,408704,120,42060,7,"""22""",44160,44280
7258,408704,601,0,42060,7,"""22""",44280,44280
7258,601,201,60,42060,7,"""22""",44280,44340
7258,201,501,60,42060,7,"""22""",44340,44400
7258,501,304,60,42060,7,"""22""",44400,44460
7258,304,100,120,42060,7,"""22""",44460,44580
7258,410201,34002,120,43260,7,"""22""",43260,43380
7258,34002,33902,60,43260,7,"""22""",43380,43440
7258,33902,26502,120,43260,7,"""22""",43440,43560
7258,26502,401302,60,43260,7,"""22""",43560,43620
7258,401302,502402,60,43260,7,"""22""",43620,43680
7258,502402,403402,60,43260,7,"""22""",43680,43740
7258,403402,404801,60,43260,7,"""22""",43740,43800
7258,404801,8102,60,43260,7,"""22""",43800,43860
7258,8102,405001,60,43260,7,"""22""",43860,43920
7258,405001,407504,120,43260,7,"""22""",43920,44040
7258,407504,409802,60,43260,7,"""22""",44040,44100
7258,409802,409702,60,43260,7,"""22""",44100,44160
7258,409702,409502,60,43260,7,"""22""",44160,44220
7258,409502,400104,60,43260,7,"""22""",44220,44280
7258,400104,409402,60,43260,7,"""22""",44280,44340
7258,409402,403104,120,43260,7,"""22""",44340,44460
7258,403104,112102,120,43260,7,"""22""",44460,44580
7258,112102,101101,120,43260,7,"""22""",44580,44700
7258,101101,403801,120,43260,7,"""22""",44700,44820
7258,403801,409002,60,43260,7,"""22""",44820,44880
7258,409002,407601,60,43260,7,"""22""",44880,44940
7258,407601,405106,120,43260,7,"""22""",44940,45060
7258,405106,404501,60,43260,7,"""22""",45060,45120
7258,404501,400901,60,43260,7,"""22""",45120,45180
7258,400901,409101,60,43260,7,"""22""",45180,45240
7258,409101,405501,60,43260,7,"""22""",45240,45300
7258,405501,404001,60,43260,7,"""22""",45300,45360
7258,404001,408704,120,43260,7,"""22""",45360,45480
7258,408704,601,0,43260,7,"""22""",45480,45480
7258,601,201,60,43260,7,"""22""",45480,45540
7258,201,501,60,43260,7,"""22""",45540,45600
7258,501,304,60,43260,7,"""22""",45600,45660
7258,304,100,120,43260,7,"""22""",45660,45780
7258,410201,34002,120,44460,7,"""22""",44460,44580
7258,34002,33902,60,44460,7,"""22""",44580,44640
7258,33902,26502,120,44460,7,"""22""",44640,44760
7258,26502,401302,60,44460,7,"""22""",44760,44820
7258,401302,502402,60,44460,7,"""22""",44820,44880
7258,502402,403402,60,44460,7,"""22""",44880,44940
7258,403402,404801,60,44460,7,"""22""",44940,45000
7258,404801,8102,60,44460,7,"""22""",45000,45060
7258,8102,405001,60,44460,7,"""22""",45060,45120
7258,405001,407504,120,44460,7,"""22""",45120,45240
7258,407504,409802,60,44460,7,"""22""",45240,45300
7258,409802,409702,60,44460,7,"""22""",45300,45360
7258,409702,409502,60,44460,7,"""22""",45360,45420
7258,409502,400104,60,44460,7,"""22""",45420,45480
7258,400104,409402,60,44460,7,"""22""",45480,45540
7258,409402,403104,120,44460,7,"""22""",45540,45660
7258,403104,112102,120,44460,7,"""22""",45660,45780
7258,112102,101101,120,44460,7,"""22""",45780,45900
7258,101101,403801,120,44460,7,"""22""",45900,46020
7258,403801,409002,60,44460,7,"""22""",46020,46080
7258,409002,407601,60,44460,7,"""22""",46080,46140
7258,407601,405106,120,44460,7,"""22""",46140,46260
7258,405106,404501,60,44460,7,"""22""",46260,46320
7258,404501,400901,60,44460,7,"""22""",46320,46380
7258,400901,409101,60,44460,7,"""22""",46380,46440
7258,409101,405501,60,44460,7,"""22""",46440,46500
7258,405501,404001,60,44460,7,"""22""",46500,46560
7258,404001,408704,120,44460,7,"""22""",46560,46680
7258,408704,601,0,44460,7,"""22""",46680,46680
7258,601,201,60,44460,7,"""22""",46680,46740
7258,201,501,60,44460,7,"""22""",46740,46800
7258,501,304,60,44460,7,"""22""",46800,46860
7258,304,100,120,44460,7,"""22""",46860,46980
7258,410201,34002,120,45660,7,"""22""",45660,45780
7258,34002,33902,60,45660,7,"""22""",45780,45840
7258,33902,26502,120,45660,7,"""22""",45840,45960
7258,26502,401302,60,45660,7,"""22""",45960,46020
7258,401302,502402,60,45660,7,"""22""",46020,46080
7258,502402,403402,60,45660,7,"""22""",46080,46140
7258,403402,404801,60,45660,7,"""22""",46140,46200
7258,404801,8102,60,45660,7,"""22""",46200,46260
7258,8102,405001,60,45660,7,"""22""",46260,46320
7258,405001,407504,120,45660,7,"""22""",46320,46440
7258,407504,409802,60,45660,7,"""22""",46440,46500
7258,409802,409702,60,45660,7,"""22""",46500,46560
7258,409702,409502,60,45660,7,"""22""",46560,46620
7258,409502,400104,60,45660,7,"""22""",46620,46680
7258,400104,409402,60,45660,7,"""22""",46680,46740
7258,409402,403104,120,45660,7,"""22""",46740,46860
7258,403104,112102,120,45660,7,"""22""",46860,46980
7258,112102,101101,120,45660,7,"""22""",46980,47100
7258,101101,403801,120,45660,7,"""22""",47100,47220
7258,403801,409002,60,45660,7,"""22""",47220,47280
7258,409002,407601,60,45660,7,"""22""",47280,47340
7258,407601,405106,120,45660,7,"""22""",47340,47460
7258,405106,404501,60,45660,7,"""22""",47460,47520
7258,404501,400901,60,45660,7,"""22""",47520,47580
7258,400901,409101,60,45660,7,"""22""",47580,47640
7258,409101,405501,60,45660,7,"""22""",47640,47700
7258,405501,404001,60,45660,7,"""22""",47700,47760
7258,404001,408704,120,45660,7,"""22""",47760,47880
7258,408704,601,0,45660,7,"""22""",47880,47880
7258,601,201,60,45660,7,"""22""",47880,47940
7258,201,501,60,45660,7,"""22""",47940,48000
7258,501,304,60,45660,7,"""22""",48000,48060
7258,304,100,120,45660,7,"""22""",48060,48180
7258,410201,34002,120,46860,7,"""22""",46860,46980
7258,34002,33902,60,46860,7,"""22""",46980,47040
7258,33902,26502,120,46860,7,"""22""",47040,47160
7258,26502,401302,60,46860,7,"""22""",47160,47220
7258,401302,502402,60,46860,7,"""22""",47220,47280
7258,502402,403402,60,46860,7,"""22""",47280,47340
7258,403402,404801,60,46860,7,"""22""",47340,47400
7258,404801,8102,60,46860,7,"""22""",47400,47460
7258,8102,405001,60,46860,7,"""22""",47460,47520
7258,405001,407504,120,46860,7,"""22""",47520,47640
7258,407504,409802,60,46860,7,"""22""",47640,47700
7258,409802,409702,60,46860,7,"""22""",47700,47760
7258,409702,409502,60,46860,7,"""22""",47760,47820
7258,409502,400104,60,46860,7,"""22""",47820,47880
7258,400104,409402,60,46860,7,"""22""",47880,47940
7258,409402,403104,120,46860,7,"""22""",47940,48060
7258,403104,112102,120,46860,7,"""22""",48060,48180
7258,112102,101101,120,46860,7,"""22""",48180,48300
7258,101101,403801,120,46860,7,"""22""",48300,48420
7258,403801,409002,60,46860,7,"""22""",48420,48480
7258,409002,407601,60,46860,7,"""22""",48480,48540
7258,407601,405106,120,46860,7,"""22""",48540,48660
7258,405106,404501,60,46860,7,"""22""",48660,48720
7258,404501,400901,60,46860,7,"""22""",48720,48780
7258,400901,409101,60,46860,7,"""22""",48780,48840
7258,409101,405501,60,46860,7,"""22""",48840,48900
7258,405501,404001,60,46860,7,"""22""",48900,48960
7258,404001,408704,120,46860,7,"""22""",48960,49080
7258,408704,601,0,46860,7,"""22""",49080,49080
7258,601,201,60,46860,7,"""22""",49080,49140
7258,201,501,60,46860,7,"""22""",49140,49200
7258,501,304,60,46860,7,"""22""",49200,49260
7258,304,100,120,46860,7,"""22""",49260,49380
7258,410201,34002,120,48060,7,"""22""",48060,48180
7258,34002,33902,60,48060,7,"""22""",48180,48240
7258,33902,26502,120,48060,7,"""22""",48240,48360
7258,26502,401302,60,48060,7,"""22""",48360,48420
7258,401302,502402,60,48060,7,"""22""",48420,48480
7258,502402,403402,60,48060,7,"""22""",48480,48540
7258,403402,404801,60,48060,7,"""22""",48540,48600
7258,404801,8102,60,48060,7,"""22""",48600,48660
7258,8102,405001,60,48060,7,"""22""",48660,48720
7258,405001,407504,120,48060,7,"""22""",48720,48840
7258,407504,409802,60,48060,7,"""22""",48840,48900
7258,409802,409702,60,48060,7,"""22""",48900,48960
7258,409702,409502,60,48060,7,"""22""",48960,49020
7258,409502,400104,60,48060,7,"""22""",49020,49080
7258,400104,409402,60,48060,7,"""22""",49080,49140
7258,409402,403104,120,48060,7,"""22""",49140,49260
7258,403104,112102,120,48060,7,"""22""",49260,49380
7258,112102,101101,120,48060,7,"""22""",49380,49500
7258,101101,403801,120,48060,7,"""22""",49500,49620
7258,403801,409002,60,48060,7,"""22""",49620,49680
7258,409002,407601,60,48060,7,"""22""",49680,49740
7258,407601,405106,120,48060,7,"""22""",49740,49860
7258,405106,404501,60,48060,7,"""22""",49860,49920
7258,404501,400901,60,48060,7,"""22""",49920,49980
7258,400901,409101,60,48060,7,"""22""",49980,50040
7258,409101,405501,60,48060,7,"""22""",50040,50100
7258,405501,404001,60,48060,7,"""22""",50100,50160
7258,404001,408704,120,48060,7,"""22""",50160,50280
7258,408704,601,0,48060,7,"""22""",50280,50280
7258,601,201,60,48060,7,"""22""",50280,50340
7258,201,501,60,48060,7,"""22""",50340,50400
7258,501,304,60,48060,7,"""22""",50400,50460
7258,304,100,120,48060,7,"""22""",50460,50580
7258,410201,34002,120,49260,7,"""22""",49260,49380
7258,34002,33902,60,49260,7,"""22""",49380,49440
7258,33902,26502,120,49260,7,"""22""",49440,49560
7258,26502,401302,60,49260,7,"""22""",49560,49620
7258,401302,502402,60,49260,7,"""22""",49620,49680
7258,502402,403402,60,49260,7,"""22""",49680,49740
7258,403402,404801,60,49260,7,"""22""",49740,49800
7258,404801,8102,60,49260,7,"""22""",49800,49860
7258,8102,405001,60,49260,7,"""22""",49860,49920
7258,405001,407504,120,49260,7,"""22""",49920,50040
7258,407504,409802,60,49260,7,"""22""",50040,50100
7258,409802,409702,60,49260,7,"""22""",50100,50160
7258,409702,409502,60,49260,7,"""22""",50160,50220
7258,409502,400104,60,49260,7,"""22""",50220,50280
7258,400104,409402,60,49260,7,"""22""",50280,50340
7258,409402,403104,120,49260,7,"""22""",50340,50460
7258,403104,112102,120,49260,7,"""22""",50460,50580
7258,112102,101101,120,49260,7,"""22""",50580,50700
7258,101101,403801,120,49260,7,"""22""",50700,50820
7258,403801,409002,60,49260,7,"""22""",50820,50880
7258,409002,407601,60,49260,7,"""22""",50880,50940
7258,407601,405106,120,49260,7,"""22""",50940,51060
7258,405106,404501,60,49260,7,"""22""",51060,51120
7258,404501,400901,60,49260,7,"""22""",51120,51180
7258,400901,409101,60,49260,7,"""22""",51180,51240
7258,409101,405501,60,49260,7,"""22""",51240,51300
7258,405501,404001,60,49260,7,"""22""",51300,51360
7258,404001,408704,120,49260,7,"""22""",51360,51480
7258,408704,601,0,49260,7,"""22""",51480,51480
7258,601,201,60,49260,7,"""22""",51480,51540
7258,201,501,60,49260,7,"""22""",51540,51600
7258,501,304,60,49260,7,"""22""",51600,51660
7258,304,100,120,49260,7,"""22""",51660,51780
7258,410201,34002,120,50460,7,"""22""",50460,50580
7258,34002,33902,60,50460,7,"""22""",50580,50640
7258,33902,26502,120,50460,7,"""22""",50640,50760
7258,26502,401302,60,50460,7,"""22""",50760,50820
7258,401302,502402,60,50460,7,"""22""",50820,50880
7258,502402,403402,60,50460,7,"""22""",50880,50940
7258,403402,404801,60,50460,7,"""22""",50940,51000
7258,404801,8102,60,50460,7,"""22""",51000,51060
7258,8102,405001,60,50460,7,"""22""",51060,51120
7258,405001,407504,120,50460,7,"""22""",51120,51240
7258,407504,409802,60,50460,7,"""22""",51240,51300
7258,409802,409702,60,50460,7,"""22""",51300,51360
7258,409702,409502,60,50460,7,"""22""",51360,51420
7258,409502,400104,60,50460,7,"""22""",51420,51480
7258,400104,409402,60,50460,7,"""22""",51480,51540
7258,409402,403104,120,50460,7,"""22""",51540,51660
7258,403104,112102,120,50460,7,"""22""",51660,51780
7258,112102,101101,120,50460,7,"""22""",51780,51900
7258,101101,403801,120,50460,7,"""22""",51900,52020
7258,403801,409002,60,50460,7,"""22""",52020,52080
7258,409002,407601,60,50460,7,"""22""",52080,52140
7258,407601,405106,120,50460,7,"""22""",52140,52260
7258,405106,404501,60,50460,7,"""22""",52260,52320
7258,404501,400901,60,50460,7,"""22""",52320,52380
7258,400901,409101,60,50460,7,"""22""",52380,52440
7258,409101,405501,60,50460,7,"""22""",52440,52500
7258,405501,404001,60,50460,7,"""22""",52500,52560
7258,404001,408704,120,50460,7,"""22""",52560,52680
7258,408704,601,0,50460,7,"""22""",52680,52680
7258,601,201,60,50460,7,"""22""",52680,52740
7258,201,501,60,50460,7,"""22""",52740,52800
7258,501,304,60,50460,7,"""22""",52800,52860
7258,304,100,120,50460,7,"""22""",52860,52980
7258,410201,34002,120,51660,7,"""22""",51660,51780
7258,34002,33902,60,51660,7,"""22""",51780,51840
7258,33902,26502,120,51660,7,"""22""",51840,51960
7258,26502,401302,60,51660,7,"""22""",51960,52020
7258,401302,502402,60,51660,7,"""22""",52020,52080
7258,502402,403402,60,51660,7,"""22""",52080,52140
7258,403402,404801,60,51660,7,"""22""",52140,52200
7258,404801,8102,60,51660,7,"""22""",52200,52260
7258,8102,405001,60,51660,7,"""22""",52260,52320
7258,405001,407504,120,51660,7,"""22""",52320,52440
7258,407504,409802,60,51660,7,"""22""",52440,52500
7258,409802,409702,60,51660,7,"""22""",52500,52560
7258,409702,409502,60,51660,7,"""22""",52560,52620
7258,409502,400104,60,51660,7,"""22""",52620,52680
7258,400104,409402,60,51660,7,"""22""",52680,52740
7258,409402,403104,120,51660,7,"""22""",52740,52860
7258,403104,112102,120,51660,7,"""22""",52860,52980
7258,112102,101101,120,51660,7,"""22""",52980,53100
7258,101101,403801,120,51660,7,"""22""",53100,53220
7258,403801,409002,60,51660,7,"""22""",53220,53280
7258,409002,407601,60,51660,7,"""22""",53280,53340
7258,407601,405106,120,51660,7,"""22""",53340,53460
7258,405106,404501,60,51660,7,"""22""",53460,53520
7258,404501,400901,60,51660,7,"""22""",53520,53580
7258,400901,409101,60,51660,7,"""22""",53580,53640
7258,409101,405501,60,51660,7,"""22""",53640,53700
7258,405501,404001,60,51660,7,"""22""",53700,53760
7258,404001,408704,120,51660,7,"""22""",53760,53880
7258,408704,601,0,51660,7,"""22""",53880,53880
7258,601,201,60,51660,7,"""22""",53880,53940
7258,201,501,60,51660,7,"""22""",53940,54000
7258,501,304,60,51660,7,"""22""",54000,54060
7258,304,100,120,51660,7,"""22""",54060,54180
7258,410201,34002,120,52860,7,"""22""",52860,52980
7258,34002,33902,60,52860,7,"""22""",52980,53040
7258,33902,26502,120,52860,7,"""22""",53040,53160
7258,26502,401302,60,52860,7,"""22""",53160,53220
7258,401302,502402,60,52860,7,"""22""",53220,53280
7258,502402,403402,60,52860,7,"""22""",53280,53340
7258,403402,404801,60,52860,7,"""22""",53340,53400
7258,404801,8102,60,52860,7,"""22""",53400,53460
7258,8102,405001,60,52860,7,"""22""",53460,53520
7258,405001,407504,120,52860,7,"""22""",53520,53640
7258,407504,409802,60,52860,7,"""22""",53640,53700
7258,409802,409702,60,52860,7,"""22""",53700,53760
7258,409702,409502,60,52860,7,"""22""",53760,53820
7258,409502,400104,60,52860,7,"""22""",53820,53880
7258,400104,409402,60,52860,7,"""22""",53880,53940
7258,409402,403104,120,52860,7,"""22""",53940,54060
7258,403104,112102,120,52860,7,"""22""",54060,54180
7258,112102,101101,120,52860,7,"""22""",54180,54300
7258,101101,403801,120,52860,7,"""22""",54300,54420
7258,403801,409002,60,52860,7,"""22""",54420,54480
7258,409002,407601,60,52860,7,"""22""",54480,54540
7258,407601,405106,120,52860,7,"""22""",54540,54660
7258,405106,404501,60,52860,7,"""22""",54660,54720
7258,404501,400901,60,52860,7,"""22""",54720,54780
7258,400901,409101,60,52860,7,"""22""",54780,54840
7258,409101,405501,60,52860,7,"""22""",54840,54900
7258,405501,404001,60,52860,7,"""22""",54900,54960
7258,404001,408704,120,52860,7,"""22""",54960,55080
7258,408704,601,0,52860,7,"""22""",55080,55080
7258,601,201,60,52860,7,"""22""",55080,55140
7258,201,501,60,52860,7,"""22""",55140,55200
7258,501,304,60,52860,7,"""22""",55200,55260
7258,304,100,120,52860,7,"""22""",55260,55380
7258,410201,34002,120,54060,7,"""22""",54060,54180
7258,34002,33902,60,54060,7,"""22""",54180,54240
7258,33902,26502,120,54060,7,"""22""",54240,54360
7258,26502,401302,60,54060,7,"""22""",54360,54420
7258,401302,502402,60,54060,7,"""22""",54420,54480
7258,502402,403402,60,54060,7,"""22""",54480,54540
7258,403402,404801,60,54060,7,"""22""",54540,54600
7258,404801,8102,60,54060,7,"""22""",54600,54660
7258,8102,405001,60,54060,7,"""22""",54660,54720
7258,405001,407504,120,54060,7,"""22""",54720,54840
7258,407504,409802,60,54060,7,"""22""",54840,54900
7258,409802,409702,60,54060,7,"""22""",54900,54960
7258,409702,409502,60,54060,7,"""22""",54960,55020
7258,409502,400104,60,54060,7,"""22""",55020,55080
7258,400104,409402,60,54060,7,"""22""",55080,55140
7258,409402,403104,120,54060,7,"""22""",55140,55260
7258,403104,112102,120,54060,7,"""22""",55260,55380
7258,112102,101101,120,54060,7,"""22""",55380,55500
7258,101101,403801,120,54060,7,"""22""",55500,55620
7258,403801,409002,60,54060,7,"""22""",55620,55680
7258,409002,407601,60,54060,7,"""22""",55680,55740
7258,407601,405106,120,54060,7,"""22""",55740,55860
7258,405106,404501,60,54060,7,"""22""",55860,55920
7258,404501,400901,60,54060,7,"""22""",55920,55980
7258,400901,409101,60,54060,7,"""22""",55980,56040
7258,409101,405501,60,54060,7,"""22""",56040,56100
7258,405501,404001,60,54060,7,"""22""",56100,56160
7258,404001,408704,120,54060,7,"""22""",56160,56280
7258,408704,601,0,54060,7,"""22""",56280,56280
7258,601,201,60,54060,7,"""22""",56280,56340
7258,201,501,60,54060,7,"""22""",56340,56400
7258,501,304,60,54060,7,"""22""",56400,56460
7258,304,100,120,54060,7,"""22""",56460,56580
7258,410201,34002,120,55260,7,"""22""",55260,55380
7258,34002,33902,60,55260,7,"""22""",55380,55440
7258,33902,26502,120,55260,7,"""22""",55440,55560
7258,26502,401302,60,55260,7,"""22""",55560,55620
7258,401302,502402,60,55260,7,"""22""",55620,55680
7258,502402,403402,60,55260,7,"""22""",55680,55740
7258,403402,404801,60,55260,7,"""22""",55740,55800
7258,404801,8102,60,55260,7,"""22""",55800,55860
7258,8102,405001,60,55260,7,"""22""",55860,55920
7258,405001,407504,120,55260,7,"""22""",55920,56040
7258,407504,409802,60,55260,7,"""22""",56040,56100
7258,409802,409702,60,55260,7,"""22""",56100,56160
7258,409702,409502,60,55260,7,"""22""",56160,56220
7258,409502,400104,60,55260,7,"""22""",56220,56280
7258,400104,409402,60,55260,7,"""22""",56280,56340
7258,409402,403104,120,55260,7,"""22""",56340,56460
7258,403104,112102,120,55260,7,"""22""",56460,56580
7258,112102,101101,120,55260,7,"""22""",56580,56700
7258,101101,403801,120,55260,7,"""22""",56700,56820
7258,403801,409002,60,55260,7,"""22""",56820,56880
7258,409002,407601,60,55260,7,"""22""",56880,56940
7258,407601,405106,120,55260,7,"""22""",56940,57060
7258,405106,404501,60,55260,7,"""22""",57060,57120
7258,404501,400901,60,55260,7,"""22""",57120,57180
7258,400901,409101,60,55260,7,"""22""",57180,57240
7258,409101,405501,60,55260,7,"""22""",57240,57300
7258,405501,404001,60,55260,7,"""22""",57300,57360
7258,404001,408704,120,55260,7,"""22""",57360,57480
7258,408704,601,0,55260,7,"""22""",57480,57480
7258,601,201,60,55260,7,"""22""",57480,57540
7258,201,501,60,55260,7,"""22""",57540,57600
7258,501,304,60,55260,7,"""22""",57600,57660
7258,304,100,120,55260,7,"""22""",57660,57780
7258,410201,34002,120,56460,7,"""22""",56460,56580
7258,34002,33902,60,56460,7,"""22""",56580,56640
7258,33902,26502,120,56460,7,"""22""",56640,56760
7258,26502,401302,60,56460,7,"""22""",56760,56820
7258,401302,502402,60,56460,7,"""22""",56820,56880
7258,502402,403402,60,56460,7,"""22""",56880,56940
7258,403402,404801,60,56460,7,"""22""",56940,57000
7258,404801,8102,60,56460,7,"""22""",57000,57060
7258,8102,405001,60,56460,7,"""22""",57060,57120
7258,405001,407504,120,56460,7,"""22""",57120,57240
7258,407504,409802,60,56460,7,"""22""",57240,57300
7258,409802,409702,60,56460,7,"""22""",57300,57360
7258,409702,409502,60,56460,7,"""22""",57360,57420
7258,409502,400104,60,56460,7,"""22""",57420,57480
7258,400104,409402,60,56460,7,"""22""",57480,57540
7258,409402,403104,120,56460,7,"""22""",57540,57660
7258,403104,112102,120,56460,7,"""22""",57660,57780
7258,112102,101101,120,56460,7,"""22""",57780,57900
7258,101101,403801,120,56460,7,"""22""",57900,58020
7258,403801,409002,60,56460,7,"""22""",58020,58080
7258,409002,407601,60,56460,7,"""22""",58080,58140
7258,407601,405106,120,56460,7,"""22""",58140,58260
7258,405106,404501,60,56460,7,"""22""",58260,58320
7258,404501,400901,60,56460,7,"""22""",58320,58380
7258,400901,409101,60,56460,7,"""22""",58380,58440
7258,409101,405501,60,56460,7,"""22""",58440,58500
7258,405501,404001,60,56460,7,"""22""",58500,58560
7258,404001,408704,120,56460,7,"""22""",58560,58680
7258,408704,601,0,56460,7,"""22""",58680,58680
7258,601,201,60,56460,7,"""22""",58680,58740
7258,201,501,60,56460,7,"""22""",58740,58800
7258,501,304,60,56460,7,"""22""",58800,58860
7258,304,100,120,56460,7,"""22""",58860,58980
7258,410201,34002,120,57660,7,"""22""",57660,57780
7258,34002,33902,60,57660,7,"""22""",57780,57840
7258,33902,26502,120,57660,7,"""22""",57840,57960
7258,26502,401302,60,57660,7,"""22""",57960,58020
7258,401302,502402,60,57660,7,"""22""",58020,58080
7258,502402,403402,60,57660,7,"""22""",58080,58140
7258,403402,404801,60,57660,7,"""22""",58140,58200
7258,404801,8102,60,57660,7,"""22""",58200,58260
7258,8102,405001,60,57660,7,"""22""",58260,58320
7258,405001,407504,120,57660,7,"""22""",58320,58440
7258,407504,409802,60,57660,7,"""22""",58440,58500
7258,409802,409702,60,57660,7,"""22""",58500,58560
7258,409702,409502,60,57660,7,"""22""",58560,58620
7258,409502,400104,60,57660,7,"""22""",58620,58680
7258,400104,409402,60,57660,7,"""22""",58680,58740
7258,409402,403104,120,57660,7,"""22""",58740,58860
7258,403104,112102,120,57660,7,"""22""",58860,58980
7258,112102,101101,120,57660,7,"""22""",58980,59100
7258,101101,403801,120,57660,7,"""22""",59100,59220
7258,403801,409002,60,57660,7,"""22""",59220,59280
7258,409002,407601,60,57660,7,"""22""",59280,59340
7258,407601,405106,120,57660,7,"""22""",59340,59460
7258,405106,404501,60,57660,7,"""22""",59460,59520
7258,404501,400901,60,57660,7,"""22""",59520,59580
7258,400901,409101,60,57660,7,"""22""",59580,59640
7258,409101,405501,60,57660,7,"""22""",59640,59700
7258,405501,404001,60,57660,7,"""22""",59700,59760
7258,404001,408704,120,57660,7,"""22""",59760,59880
7258,408704,601,0,57660,7,"""22""",59880,59880
7258,601,201,60,57660,7,"""22""",59880,59940
7258,201,501,60,57660,7,"""22""",59940,60000
7258,501,304,60,57660,7,"""22""",60000,60060
7258,304,100,120,57660,7,"""22""",60060,60180
7258,410201,34002,120,58860,7,"""22""",58860,58980
7258,34002,33902,60,58860,7,"""22""",58980,59040
7258,33902,26502,120,58860,7,"""22""",59040,59160
7258,26502,401302,60,58860,7,"""22""",59160,59220
7258,401302,502402,60,58860,7,"""22""",59220,59280
7258,502402,403402,60,58860,7,"""22""",59280,59340
7258,403402,404801,60,58860,7,"""22""",59340,59400
7258,404801,8102,60,58860,7,"""22""",59400,59460
7258,8102,405001,60,58860,7,"""22""",59460,59520
7258,405001,407504,120,58860,7,"""22""",59520,59640
7258,407504,409802,60,58860,7,"""22""",59640,59700
7258,409802,409702,60,58860,7,"""22""",59700,59760
7258,409702,409502,60,58860,7,"""22""",59760,59820
7258,409502,400104,60,58860,7,"""22""",59820,59880
7258,400104,409402,60,58860,7,"""22""",59880,59940
7258,409402,403104,120,58860,7,"""22""",59940,60060
7258,403104,112102,120,58860,7,"""22""",60060,60180
7258,112102,101101,120,58860,7,"""22""",60180,60300
7258,101101,403801,120,58860,7,"""22""",60300,60420
7258,403801,409002,60,58860,7,"""22""",60420,60480
7258,409002,407601,60,58860,7,"""22""",60480,60540
7258,407601,405106,120,58860,7,"""22""",60540,60660
7258,405106,404501,60,58860,7,"""22""",60660,60720
7258,404501,400901,60,58860,7,"""22""",60720,60780
7258,400901,409101,60,58860,7,"""22""",60780,60840
7258,409101,405501,60,58860,7,"""22""",60840,60900
7258,405501,404001,60,58860,7,"""22""",60900,60960
7258,404001,408704,120,58860,7,"""22""",60960,61080
7258,408704,601,0,58860,7,"""22""",61080,61080
7258,601,201,60,58860,7,"""22""",61080,61140
7258,201,501,60,58860,7,"""22""",61140,61200
7258,501,304,60,58860,7,"""22""",61200,61260
7258,304,100,120,58860,7,"""22""",61260,61380
7258,410201,34002,120,60060,7,"""22""",60060,60180
7258,34002,33902,60,60060,7,"""22""",60180,60240
7258,33902,26502,120,60060,7,"""22""",60240,60360
7258,26502,401302,60,60060,7,"""22""",60360,60420
7258,401302,502402,60,60060,7,"""22""",60420,60480
7258,502402,403402,60,60060,7,"""22""",60480,60540
7258,403402,404801,60,60060,7,"""22""",60540,60600
7258,404801,8102,60,60060,7,"""22""",60600,60660
7258,8102,405001,60,60060,7,"""22""",60660,60720
7258,405001,407504,120,60060,7,"""22""",60720,60840
7258,407504,409802,60,60060,7,"""22""",60840,60900
7258,409802,409702,60,60060,7,"""22""",60900,60960
7258,409702,409502,60,60060,7,"""22""",60960,61020
7258,409502,400104,60,60060,7,"""22""",61020,61080
7258,400104,409402,60,60060,7,"""22""",61080,61140
7258,409402,403104,120,60060,7,"""22""",61140,61260
7258,403104,112102,120,60060,7,"""22""",61260,61380
7258,112102,101101,120,60060,7,"""22""",61380,61500
7258,101101,403801,120,60060,7,"""22""",61500,61620
7258,403801,409002,60,60060,7,"""22""",61620,61680
7258,409002,407601,60,60060,7,"""22""",61680,61740
7258,407601,405106,120,60060,7,"""22""",61740,61860
7258,405106,404501,60,60060,7,"""22""",61860,61920
7258,404501,400901,60,60060,7,"""22""",61920,61980
7258,400901,409101,60,60060,7,"""22""",61980,62040
7258,409101,405501,60,60060,7,"""22""",62040,62100
7258,405501,404001,60,60060,7,"""22""",62100,62160
7258,404001,408704,120,60060,7,"""22""",62160,62280
7258,408704,601,0,60060,7,"""22""",62280,62280
7258,601,201,60,60060,7,"""22""",62280,62340
7258,201,501,60,60060,7,"""22""",62340,62400
7258,501,304,60,60060,7,"""22""",62400,62460
7258,304,100,120,60060,7,"""22""",62460,62580
7258,410201,34002,120,61260,7,"""22""",61260,61380
7258,34002,33902,60,61260,7,"""22""",61380,61440
7258,33902,26502,120,61260,7,"""22""",61440,61560
7258,26502,401302,60,61260,7,"""22""",61560,61620
7258,401302,502402,60,61260,7,"""22""",61620,61680
7258,502402,403402,60,61260,7,"""22""",61680,61740
7258,403402,404801,60,61260,7,"""22""",61740,61800
7258,404801,8102,60,61260,7,"""22""",61800,61860
7258,8102,405001,60,61260,7,"""22""",61860,61920
7258,405001,407504,120,61260,7,"""22""",61920,62040
7258,407504,409802,60,61260,7,"""22""",62040,62100
7258,409802,409702,60,61260,7,"""22""",62100,62160
7258,409702,409502,60,61260,7,"""22""",62160,62220
7258,409502,400104,60,61260,7,"""22""",62220,62280
7258,400104,409402,60,61260,7,"""22""",62280,62340
7258,409402,403104,120,61260,7,"""22""",62340,62460
7258,403104,112102,120,61260,7,"""22""",62460,62580
7258,112102,101101,120,61260,7,"""22""",62580,62700
7258,101101,403801,120,61260,7,"""22""",62700,62820
7258,403801,409002,60,61260,7,"""22""",62820,62880
7258,409002,407601,60,61260,7,"""22""",62880,62940
7258,407601,405106,120,61260,7,"""22""",62940,63060
7258,405106,404501,60,61260,7,"""22""",63060,63120
7258,404501,400901,60,61260,7,"""22""",63120,63180
7258,400901,409101,60,61260,7,"""22""",63180,63240
7258,409101,405501,60,61260,7,"""22""",63240,63300
7258,405501,404001,60,61260,7,"""22""",63300,63360
7258,404001,408704,120,61260,7,"""22""",63360,63480
7258,408704,601,0,61260,7,"""22""",63480,63480
7258,601,201,60,61260,7,"""22""",63480,63540
7258,201,501,60,61260,7,"""22""",63540,63600
7258,501,304,60,61260,7,"""22""",63600,63660
7258,304,100,120,61260,7,"""22""",63660,63780
7258,410201,34002,120,62460,7,"""22""",62460,62580
7258,34002,33902,60,62460,7,"""22""",62580,62640
7258,33902,26502,120,62460,7,"""22""",62640,62760
7258,26502,401302,60,62460,7,"""22""",62760,62820
7258,401302,502402,60,62460,7,"""22""",62820,62880
7258,502402,403402,60,62460,7,"""22""",62880,62940
7258,403402,404801,60,62460,7,"""22""",62940,63000
7258,404801,8102,60,62460,7,"""22""",63000,63060
7258,8102,405001,60,62460,7,"""22""",63060,63120
7258,405001,407504,120,62460,7,"""22""",63120,63240
7258,407504,409802,60,62460,7,"""22""",63240,63300
7258,409802,409702,60,62460,7,"""22""",63300,63360
7258,409702,409502,60,62460,7,"""22""",63360,63420
7258,409502,400104,60,62460,7,"""22""",63420,63480
7258,400104,409402,60,62460,7,"""22""",63480,63540
7258,409402,403104,120,62460,7,"""22""",63540,63660
7258,403104,112102,120,62460,7,"""22""",63660,63780
7258,112102,101101,120,62460,7,"""22""",63780,63900
7258,101101,403801,120,62460,7,"""22""",63900,64020
7258,403801,409002,60,62460,7,"""22""",64020,64080
7258,409002,407601,60,62460,7,"""22""",64080,64140
7258,407601,405106,120,62460,7,"""22""",64140,64260
7258,405106,404501,60,62460,7,"""22""",64260,64320
7258,404501,400901,60,62460,7,"""22""",64320,64380
7258,400901,409101,60,62460,7,"""22""",64380,64440
7258,409101,405501,60,62460,7,"""22""",64440,64500
7258,405501,404001,60,62460,7,"""22""",64500,64560
7258,404001,408704,120,62460,7,"""22""",64560,64680
7258,408704,601,0,62460,7,"""22""",64680,64680
7258,601,201,60,62460,7,"""22""",64680,64740
7258,201,501,60,62460,7,"""22""",64740,64800
7258,501,304,60,62460,7,"""22""",64800,64860
7258,304,100,120,62460,7,"""22""",64860,64980
7258,410201,34002,120,63660,7,"""22""",63660,63780
7258,34002,33902,60,63660,7,"""22""",63780,63840
7258,33902,26502,120,63660,7,"""22""",63840,63960
7258,26502,401302,60,63660,7,"""22""",63960,64020
7258,401302,502402,60,63660,7,"""22""",64020,64080
7258,502402,403402,60,63660,7,"""22""",64080,64140
7258,403402,404801,60,63660,7,"""22""",64140,64200
7258,404801,8102,60,63660,7,"""22""",64200,64260
7258,8102,405001,60,63660,7,"""22""",64260,64320
7258,405001,407504,120,63660,7,"""22""",64320,64440
7258,407504,409802,60,63660,7,"""22""",64440,64500
7258,409802,409702,60,63660,7,"""22""",64500,64560
7258,409702,409502,60,63660,7,"""22""",64560,64620
7258,409502,400104,60,63660,7,"""22""",64620,64680
7258,400104,409402,60,63660,7,"""22""",64680,64740
7258,409402,403104,120,63660,7,"""22""",64740,64860
7258,403104,112102,120,63660,7,"""22""",64860,64980
7258,112102,101101,120,63660,7,"""22""",64980,65100
7258,101101,403801,120,63660,7,"""22""",65100,65220
7258,403801,409002,60,63660,7,"""22""",65220,65280
7258,409002,407601,60,63660,7,"""22""",65280,65340
7258,407601,405106,120,63660,7,"""22""",65340,65460
7258,405106,404501,60,63660,7,"""22""",65460,65520
7258,404501,400901,60,63660,7,"""22""",65520,65580
7258,400901,409101,60,63660,7,"""22""",65580,65640
7258,409101,405501,60,63660,7,"""22""",65640,65700
7258,405501,404001,60,63660,7,"""22""",65700,65760
7258,404001,408704,120,63660,7,"""22""",65760,65880
7258,408704,601,0,63660,7,"""22""",65880,65880
7258,601,201,60,63660,7,"""22""",65880,65940
7258,201,501,60,63660,7,"""22""",65940,66000
7258,501,304,60,63660,7,"""22""",66000,66060
7258,304,100,120,63660,7,"""22""",66060,66180
7258,410201,34002,120,64860,7,"""22""",64860,64980
7258,34002,33902,60,64860,7,"""22""",64980,65040
7258,33902,26502,120,64860,7,"""22""",65040,65160
7258,26502,401302,60,64860,7,"""22""",65160,65220
7258,401302,502402,60,64860,7,"""22""",65220,65280
7258,502402,403402,60,64860,7,"""22""",65280,65340
7258,403402,404801,60,64860,7,"""22""",65340,65400
7258,404801,8102,60,64860,7,"""22""",65400,65460
7258,8102,405001,60,64860,7,"""22""",65460,65520
7258,405001,407504,120,64860,7,"""22""",65520,65640
7258,407504,409802,60,64860,7,"""22""",65640,65700
7258,409802,409702,60,64860,7,"""22""",65700,65760
7258,409702,409502,60,64860,7,"""22""",65760,65820
7258,409502,400104,60,64860,7,"""22""",65820,65880
7258,400104,409402,60,64860,7,"""22""",65880,65940
7258,409402,403104,120,64860,7,"""22""",65940,66060
7258,403104,112102,120,64860,7,"""22""",66060,66180
7258,112102,101101,120,64860,7,"""22""",66180,66300
7258,101101,403801,120,64860,7,"""22""",66300,66420
7258,403801,409002,60,64860,7,"""22""",66420,66480
7258,409002,407601,60,64860,7,"""22""",66480,66540
7258,407601,405106,120,64860,7,"""22""",66540,66660
7258,405106,404501,60,64860,7,"""22""",66660,66720
7258,404501,400901,60,64860,7,"""22""",66720,66780
7258,400901,409101,60,64860,7,"""22""",66780,66840
7258,409101,405501,60,64860,7,"""22""",66840,66900
7258,405501,404001,60,64860,7,"""22""",66900,66960
7258,404001,408704,120,64860,7,"""22""",66960,67080
7258,408704,601,0,64860,7,"""22""",67080,67080
7258,601,201,60,64860,7,"""22""",67080,67140
7258,201,501,60,64860,7,"""22""",67140,67200
7258,501,304,60,64860,7,"""22""",67200,67260
7258,304,100,120,64860,7,"""22""",67260,67380
7258,410201,34002,120,66060,7,"""22""",66060,66180
7258,34002,33902,60,66060,7,"""22""",66180,66240
7258,33902,26502,120,66060,7,"""22""",66240,66360
7258,26502,401302,60,66060,7,"""22""",66360,66420
7258,401302,502402,60,66060,7,"""22""",66420,66480
7258,502402,403402,60,66060,7,"""22""",66480,66540
7258,403402,404801,60,66060,7,"""22""",66540,66600
7258,404801,8102,60,66060,7,"""22""",66600,66660
7258,8102,405001,60,66060,7,"""22""",66660,66720
7258,405001,407504,120,66060,7,"""22""",66720,66840
7258,407504,409802,60,66060,7,"""22""",66840,66900
7258,409802,409702,60,66060,7,"""22""",66900,66960
7258,409702,409502,60,66060,7,"""22""",66960,67020
7258,409502,400104,60,66060,7,"""22""",67020,67080
7258,400104,409402,60,66060,7,"""22""",67080,67140
7258,409402,403104,120,66060,7,"""22""",67140,67260
7258,403104,112102,120,66060,7,"""22""",67260,67380
7258,112102,101101,120,66060,7,"""22""",67380,67500
7258,101101,403801,120,66060,7,"""22""",67500,67620
7258,403801,409002,60,66060,7,"""22""",67620,67680
7258,409002,407601,60,66060,7,"""22""",67680,67740
7258,407601,405106,120,66060,7,"""22""",67740,67860
7258,405106,404501,60,66060,7,"""22""",67860,67920
7258,404501,400901,60,66060,7,"""22""",67920,67980
7258,400901,409101,60,66060,7,"""22""",67980,68040
7258,409101,405501,60,66060,7,"""22""",68040,68100
7258,405501,404001,60,66060,7,"""22""",68100,68160
7258,404001,408704,120,66060,7,"""22""",68160,68280
7258,408704,601,0,66060,7,"""22""",68280,68280
7258,601,201,60,66060,7,"""22""",68280,68340
7258,201,501,60,66060,7,"""22""",68340,68400
7258,501,304,60,66060,7,"""22""",68400,68460
7258,304,100,120,66060,7,"""22""",68460,68580
7258,410201,34002,120,67260,7,"""22""",67260,67380
7258,34002,33902,60,67260,7,"""22""",67380,67440
7258,33902,26502,120,67260,7,"""22""",67440,67560
7258,26502,401302,60,67260,7,"""22""",67560,67620
7258,401302,502402,60,67260,7,"""22""",67620,67680
7258,502402,403402,60,67260,7,"""22""",67680,67740
7258,403402,404801,60,67260,7,"""22""",67740,67800
7258,404801,8102,60,67260,7,"""22""",67800,67860
7258,8102,405001,60,67260,7,"""22""",67860,67920
7258,405001,407504,120,67260,7,"""22""",67920,68040
7258,407504,409802,60,67260,7,"""22""",68040,68100
7258,409802,409702,60,67260,7,"""22""",68100,68160
7258,409702,409502,60,67260,7,"""22""",68160,68220
7258,409502,400104,60,67260,7,"""22""",68220,68280
7258,400104,409402,60,67260,7,"""22""",68280,68340
7258,409402,403104,120,67260,7,"""22""",68340,68460
7258,403104,112102,120,67260,7,"""22""",68460,68580
7258,112102,101101,120,67260,7,"""22""",68580,68700
7258,101101,403801,120,67260,7,"""22""",68700,68820
7258,403801,409002,60,67260,7,"""22""",68820,68880
7258,409002,407601,60,67260,7,"""22""",68880,68940
7258,407601,405106,120,67260,7,"""22""",68940,69060
7258,405106,404501,60,67260,7,"""22""",69060,69120
7258,404501,400901,60,67260,7,"""22""",69120,69180
7258,400901,409101,60,67260,7,"""22""",69180,69240
7258,409101,405501,60,67260,7,"""22""",69240,69300
7258,405501,404001,60,67260,7,"""22""",69300,69360
7258,404001,408704,120,67260,7,"""22""",69360,69480
7258,408704,601,0,67260,7,"""22""",69480,69480
7258,601,201,60,67260,7,"""22""",69480,69540
7258,201,501,60,67260,7,"""22""",69540,69600
7258,501,304,60,67260,7,"""22""",69600,69660
7258,304,100,120,67260,7,"""22""",69660,69780
7258,410201,34002,120,68820,7,"""22""",68820,68940
7258,34002,33902,60,68820,7,"""22""",68940,69000
7258,33902,26502,120,68820,7,"""22""",69000,69120
7258,26502,401302,60,68820,7,"""22""",69120,69180
7258,401302,502402,60,68820,7,"""22""",69180,69240
7258,502402,403402,60,68820,7,"""22""",69240,69300
7258,403402,404801,60,68820,7,"""22""",69300,69360
7258,404801,8102,60,68820,7,"""22""",69360,69420
7258,8102,405001,60,68820,7,"""22""",69420,69480
7258,405001,407504,120,68820,7,"""22""",69480,69600
7258,407504,409802,60,68820,7,"""22""",69600,69660
7258,409802,409702,60,68820,7,"""22""",69660,69720
7258,409702,409502,60,68820,7,"""22""",69720,69780
7258,409502,400104,60,68820,7,"""22""",69780,69840
7258,400104,409402,60,68820,7,"""22""",69840,69900
7258,409402,403104,120,68820,7,"""22""",69900,70020
7258,403104,112102,120,68820,7,"""22""",70020,70140
7258,112102,101101,120,68820,7,"""22""",70140,70260
7258,101101,403801,120,68820,7,"""22""",70260,70380
7258,403801,409002,60,68820,7,"""22""",70380,70440
7258,409002,407601,60,68820,7,"""22""",70440,70500
7258,407601,405106,120,68820,7,"""22""",70500,70620
7258,405106,404501,60,68820,7,"""22""",70620,70680
7258,404501,400901,60,68820,7,"""22""",70680,70740
7258,400901,409101,60,68820,7,"""22""",70740,70800
7258,409101,405501,60,68820,7,"""22""",70800,70860
7258,405501,404001,60,68820,7,"""22""",70860,70920
7258,404001,408704,120,68820,7,"""22""",70920,71040
7258,408704,601,0,68820,7,"""22""",71040,71040
7258,601,201,60,68820,7,"""22""",71040,71100
7258,201,501,60,68820,7,"""22""",71100,71160
7258,501,304,60,68820,7,"""22""",71160,71220
7258,304,100,120,68820,7,"""22""",71220,71340
7259,410201,34002,120,70500,7,"""22""",70500,70620
7259,34002,33902,60,70500,7,"""22""",70620,70680
7259,33902,26502,120,70500,7,"""22""",70680,70800
7259,26502,401302,60,70500,7,"""22""",70800,70860
7259,401302,502402,60,70500,7,"""22""",70860,70920
7259,502402,403402,60,70500,7,"""22""",70920,70980
7259,403402,404801,60,70500,7,"""22""",70980,71040
7259,404801,8102,60,70500,7,"""22""",71040,71100
7259,8102,405001,60,70500,7,"""22""",71100,71160
7259,405001,407504,120,70500,7,"""22""",71160,71280
7259,407504,409802,60,70500,7,"""22""",71280,71340
7259,409802,409702,60,70500,7,"""22""",71340,71400
7259,409702,409502,60,70500,7,"""22""",71400,71460
7259,409502,400104,60,70500,7,"""22""",71460,71520
7259,400104,409402,60,70500,7,"""22""",71520,71580
7259,409402,403104,120,70500,7,"""22""",71580,71700
7259,403104,112102,120,70500,7,"""22""",71700,71820
7259,112102,101101,120,70500,7,"""22""",71820,71940
7259,101101,403801,60,70500,7,"""22""",71940,72000
7259,403801,409002,60,70500,7,"""22""",72000,72060
7259,409002,407601,60,70500,7,"""22""",72060,72120
7259,407601,405106,120,70500,7,"""22""",72120,72240
7259,405106,404501,60,70500,7,"""22""",72240,72300
7259,404501,400901,60,70500,7,"""22""",72300,72360
7259,400901,409101,60,70500,7,"""22""",72360,72420
7259,409101,405501,60,70500,7,"""22""",72420,72480
7259,405501,404001,60,70500,7,"""22""",72480,72540
7259,404001,408704,60,70500,7,"""22""",72540,72600
7259,408704,601,0,70500,7,"""22""",72600,72600
7259,601,201,60,70500,7,"""22""",72600,72660
7259,201,501,60,70500,7,"""22""",72660,72720
7259,501,304,60,70500,7,"""22""",72720,72780
7259,304,100,120,70500,7,"""22""",72780,72900
7259,410201,34002,120,72300,7,"""22""",72300,72420
7259,34002,33902,60,72300,7,"""22""",72420,72480
7259,33902,26502,120,72300,7,"""22""",72480,72600
7259,26502,401302,60,72300,7,"""22""",72600,72660
7259,401302,502402,60,72300,7,"""22""",72660,72720
7259,502402,403402,60,72300,7,"""22""",72720,72780
7259,403402,404801,60,72300,7,"""22""",72780,72840
7259,404801,8102,60,72300,7,"""22""",72840,72900
7259,8102,405001,60,72300,7,"""22""",72900,72960
7259,405001,407504,120,72300,7,"""22""",72960,73080
7259,407504,409802,60,72300,7,"""22""",73080,73140
7259,409802,409702,60,72300,7,"""22""",73140,73200
7259,409702,409502,60,72300,7,"""22""",73200,73260
7259,409502,400104,60,72300,7,"""22""",73260,73320
7259,400104,409402,60,72300,7,"""22""",73320,73380
7259,409402,403104,120,72300,7,"""22""",73380,73500
7259,403104,112102,120,72300,7,"""22""",73500,73620
7259,112102,101101,120,72300,7,"""22""",73620,73740
7259,101101,403801,60,72300,7,"""22""",73740,73800
7259,403801,409002,60,72300,7,"""22""",73800,73860
7259,409002,407601,60,72300,7,"""22""",73860,73920
7259,407601,405106,120,72300,7,"""22""",73920,74040
7259,405106,404501,60,72300,7,"""22""",74040,74100
7259,404501,400901,60,72300,7,"""22""",74100,74160
7259,400901,409101,60,72300,7,"""22""",74160,74220
7259,409101,405501,60,72300,7,"""22""",74220,74280
7259,405501,404001,60,72300,7,"""22""",74280,74340
7259,404001,408704,60,72300,7,"""22""",74340,74400
7259,408704,601,0,72300,7,"""22""",74400,74400
7259,601,201,60,72300,7,"""22""",74400,74460
7259,201,501,60,72300,7,"""22""",74460,74520
7259,501,304,60,72300,7,"""22""",74520,74580
7259,304,100,120,72300,7,"""22""",74580,74700
7259,410201,34002,120,74100,7,"""22""",74100,74220
7259,34002,33902,60,74100,7,"""22""",74220,74280
7259,33902,26502,120,74100,7,"""22""",74280,74400
7259,26502,401302,60,74100,7,"""22""",74400,74460
7259,401302,502402,60,74100,7,"""22""",74460,74520
7259,502402,403402,60,74100,7,"""22""",74520,74580
7259,403402,404801,60,74100,7,"""22""",74580,74640
7259,404801,8102,60,74100,7,"""22""",74640,74700
7259,8102,405001,60,74100,7,"""22""",74700,74760
7259,405001,407504,120,74100,7,"""22""",74760,74880
7259,407504,409802,60,74100,7,"""22""",74880,74940
7259,409802,409702,60,74100,7,"""22""",74940,75000
7259,409702,409502,60,74100,7,"""22""",75000,75060
7259,409502,400104,60,74100,7,"""22""",75060,75120
7259,400104,409402,60,74100,7,"""22""",75120,75180
7259,409402,403104,120,74100,7,"""22""",75180,75300
7259,403104,112102,120,74100,7,"""22""",75300,75420
7259,112102,101101,120,74100,7,"""22""",75420,75540
7259,101101,403801,60,74100,7,"""22""",75540,75600
7259,403801,409002,60,74100,7,"""22""",75600,75660
7259,409002,407601,60,74100,7,"""22""",75660,75720
7259,407601,405106,120,74100,7,"""22""",75720,75840
7259,405106,404501,60,74100,7,"""22""",75840,75900
7259,404501,400901,60,74100,7,"""22""",75900,75960
7259,400901,409101,60,74100,7,"""22""",75960,76020
7259,409101,405501,60,74100,7,"""22""",76020,76080
7259,405501,404001,60,74100,7,"""22""",76080,76140
7259,404001,408704,60,74100,7,"""22""",76140,76200
7259,408704,601,0,74100,7,"""22""",76200,76200
7259,601,201,60,74100,7,"""22""",76200,76260
7259,201,501,60,74100,7,"""22""",76260,76320
7259,501,304,60,74100,7,"""22""",76320,76380
7259,304,100,120,74100,7,"""22""",76380,76500
7259,410201,34002,120,75900,7,"""22""",75900,76020
7259,34002,33902,60,75900,7,"""22""",76020,76080
7259,33902,26502,120,75900,7,"""22""",76080,76200
7259,26502,401302,60,75900,7,"""22""",76200,76260
7259,401302,502402,60,75900,7,"""22""",76260,76320
7259,502402,403402,60,75900,7,"""22""",76320,76380
7259,403402,404801,60,75900,7,"""22""",76380,76440
7259,404801,8102,60,75900,7,"""22""",76440,76500
7259,8102,405001,60,75900,7,"""22""",76500,76560
7259,405001,407504,120,75900,7,"""22""",76560,76680
7259,407504,409802,60,75900,7,"""22""",76680,76740
7259,409802,409702,60,75900,7,"""22""",76740,76800
7259,409702,409502,60,75900,7,"""22""",76800,76860
7259,409502,400104,60,75900,7,"""22""",76860,76920
7259,400104,409402,60,75900,7,"""22""",76920,76980
7259,409402,403104,120,75900,7,"""22""",76980,77100
7259,403104,112102,120,75900,7,"""22""",77100,77220
7259,112102,101101,120,75900,7,"""22""",77220,77340
7259,101101,403801,60,75900,7,"""22""",77340,77400
7259,403801,409002,60,75900,7,"""22""",77400,77460
7259,409002,407601,60,75900,7,"""22""",77460,77520
7259,407601,405106,120,75900,7,"""22""",77520,77640
7259,405106,404501,60,75900,7,"""22""",77640,77700
7259,404501,400901,60,75900,7,"""22""",77700,77760
7259,400901,409101,60,75900,7,"""22""",77760,77820
7259,409101,405501,60,75900,7,"""22""",77820,77880
7259,405501,404001,60,75900,7,"""22""",77880,77940
7259,404001,408704,60,75900,7,"""22""",77940,78000
7259,408704,601,0,75900,7,"""22""",78000,78000
7259,601,201,60,75900,7,"""22""",78000,78060
7259,201,501,60,75900,7,"""22""",78060,78120
7259,501,304,60,75900,7,"""22""",78120,78180
7259,304,100,120,75900,7,"""22""",78180,78300
7259,410201,34002,120,77700,7,"""22""",77700,77820
7259,34002,33902,60,77700,7,"""22""",77820,77880
7259,33902,26502,120,77700,7,"""22""",77880,78000
7259,26502,401302,60,77700,7,"""22""",78000,78060
7259,401302,502402,60,77700,7,"""22""",78060,78120
7259,502402,403402,60,77700,7,"""22""",78120,78180
7259,403402,404801,60,77700,7,"""22""",78180,78240
7259,404801,8102,60,77700,7,"""22""",78240,78300
7259,8102,405001,60,77700,7,"""22""",78300,78360
7259,405001,407504,120,77700,7,"""22""",78360,78480
7259,407504,409802,60,77700,7,"""22""",78480,78540
7259,409802,409702,60,77700,7,"""22""",78540,78600
7259,409702,409502,60,77700,7,"""22""",78600,78660
7259,409502,400104,60,77700,7,"""22""",78660,78720
7259,400104,409402,60,77700,7,"""22""",78720,78780
7259,409402,403104,120,77700,7,"""22""",78780,78900
7259,403104,112102,120,77700,7,"""22""",78900,79020
7259,112102,101101,120,77700,7,"""22""",79020,79140
7259,101101,403801,60,77700,7,"""22""",79140,79200
7259,403801,409002,60,77700,7,"""22""",79200,79260
7259,409002,407601,60,77700,7,"""22""",79260,79320
7259,407601,405106,120,77700,7,"""22""",79320,79440
7259,405106,404501,60,77700,7,"""22""",79440,79500
7259,404501,400901,60,77700,7,"""22""",79500,79560
7259,400901,409101,60,77700,7,"""22""",79560,79620
7259,409101,405501,60,77700,7,"""22""",79620,79680
7259,405501,404001,60,77700,7,"""22""",79680,79740
7259,404001,408704,60,77700,7,"""22""",79740,79800
7259,408704,601,0,77700,7,"""22""",79800,79800
7259,601,201,60,77700,7,"""22""",79800,79860
7259,201,501,60,77700,7,"""22""",79860,79920
7259,501,304,60,77700,7,"""22""",79920,79980
7259,304,100,120,77700,7,"""22""",79980,80100
7259,410201,34002,120,79500,7,"""22""",79500,79620
7259,34002,33902,60,79500,7,"""22""",79620,79680
7259,33902,26502,120,79500,7,"""22""",79680,79800
7259,26502,401302,60,79500,7,"""22""",79800,79860
7259,401302,502402,60,79500,7,"""22""",79860,79920
7259,502402,403402,60,79500,7,"""22""",79920,79980
7259,403402,404801,60,79500,7,"""22""",79980,80040
7259,404801,8102,60,79500,7,"""22""",80040,80100
7259,8102,405001,60,79500,7,"""22""",80100,80160
7259,405001,407504,120,79500,7,"""22""",80160,80280
7259,407504,409802,60,79500,7,"""22""",80280,80340
7259,409802,409702,60,79500,7,"""22""",80340,80400
7259,409702,409502,60,79500,7,"""22""",80400,80460
7259,409502,400104,60,79500,7,"""22""",80460,80520
7259,400104,409402,60,79500,7,"""22""",80520,80580
7259,409402,403104,120,79500,7,"""22""",80580,80700
7259,403104,112102,120,79500,7,"""22""",80700,80820
7259,112102,101101,120,79500,7,"""22""",80820,80940
7259,101101,403801,60,79500,7,"""22""",80940,81000
7259,403801,409002,60,79500,7,"""22""",81000,81060
7259,409002,407601,60,79500,7,"""22""",81060,81120
7259,407601,405106,120,79500,7,"""22""",81120,81240
7259,405106,404501,60,79500,7,"""22""",81240,81300
7259,404501,400901,60,79500,7,"""22""",81300,81360
7259,400901,409101,60,79500,7,"""22""",81360,81420
7259,409101,405501,60,79500,7,"""22""",81420,81480
7259,405501,404001,60,79500,7,"""22""",81480,81540
7259,404001,408704,60,79500,7,"""22""",81540,81600
7259,408704,601,0,79500,7,"""22""",81600,81600
7259,601,201,60,79500,7,"""22""",81600,81660
7259,201,501,60,79500,7,"""22""",81660,81720
7259,501,304,60,79500,7,"""22""",81720,81780
7259,304,100,120,79500,7,"""22""",81780,81900
7259,410201,34002,120,81300,7,"""22""",81300,81420
7259,34002,33902,60,81300,7,"""22""",81420,81480
7259,33902,26502,120,81300,7,"""22""",81480,81600
7259,26502,401302,60,81300,7,"""22""",81600,81660
7259,401302,502402,60,81300,7,"""22""",81660,81720
7259,502402,403402,60,81300,7,"""22""",81720,81780
7259,403402,404801,60,81300,7,"""22""",81780,81840
7259,404801,8102,60,81300,7,"""22""",81840,81900
7259,8102,405001,60,81300,7,"""22""",81900,81960
7259,405001,407504,120,81300,7,"""22""",81960,82080
7259,407504,409802,60,81300,7,"""22""",82080,82140
7259,409802,409702,60,81300,7,"""22""",82140,82200
7259,409702,409502,60,81300,7,"""22""",82200,82260
7259,409502,400104,60,81300,7,"""22""",82260,82320
7259,400104,409402,60,81300,7,"""22""",82320,82380
7259,409402,403104,120,81300,7,"""22""",82380,82500
7259,403104,112102,120,81300,7,"""22""",82500,82620
7259,112102,101101,120,81300,7,"""22""",82620,82740
7259,101101,403801,60,81300,7,"""22""",82740,82800
7259,403801,409002,60,81300,7,"""22""",82800,82860
7259,409002,407601,60,81300,7,"""22""",82860,82920
7259,407601,405106,120,81300,7,"""22""",82920,83040
7259,405106,404501,60,81300,7,"""22""",83040,83100
7259,404501,400901,60,81300,7,"""22""",83100,83160
7259,400901,409101,60,81300,7,"""22""",83160,83220
7259,409101,405501,60,81300,7,"""22""",83220,83280
7259,405501,404001,60,81300,7,"""22""",83280,83340
7259,404001,408704,60,81300,7,"""22""",83340,83400
7259,408704,601,0,81300,7,"""22""",83400,83400
7259,601,201,60,81300,7,"""22""",83400,83460
7259,201,501,60,81300,7,"""22""",83460,83520
7259,501,304,60,81300,7,"""22""",83520,83580
7259,304,100,120,81300,7,"""22""",83580,83700
7259,410201,34002,120,83100,7,"""22""",83100,83220
7259,34002,33902,60,83100,7,"""22""",83220,83280
7259,33902,26502,120,83100,7,"""22""",83280,83400
7259,26502,401302,60,83100,7,"""22""",83400,83460
7259,401302,502402,60,83100,7,"""22""",83460,83520
7259,502402,403402,60,83100,7,"""22""",83520,83580
7259,403402,404801,60,83100,7,"""22""",83580,83640
7259,404801,8102,60,83100,7,"""22""",83640,83700
7259,8102,405001,60,83100,7,"""22""",83700,83760
7259,405001,407504,120,83100,7,"""22""",83760,83880
7259,407504,409802,60,83100,7,"""22""",83880,83940
7259,409802,409702,60,83100,7,"""22""",83940,84000
7259,409702,409502,60,83100,7,"""22""",84000,84060
7259,409502,400104,60,83100,7,"""22""",84060,84120
7259,400104,409402,60,83100,7,"""22""",84120,84180
7259,409402,403104,120,83100,7,"""22""",84180,84300
7259,403104,112102,120,83100,7,"""22""",84300,84420
7259,112102,101101,120,83100,7,"""22""",84420,84540
7259,101101,403801,60,83100,7,"""22""",84540,84600
7259,403801,409002,60,83100,7,"""22""",84600,84660
7259,409002,407601,60,83100,7,"""22""",84660,84720
7259,407601,405106,120,83100,7,"""22""",84720,84840
7259,405106,404501,60,83100,7,"""22""",84840,84900
7259,404501,400901,60,83100,7,"""22""",84900,84960
7259,400901,409101,60,83100,7,"""22""",84960,85020
7259,409101,405501,60,83100,7,"""22""",85020,85080
7259,405501,404001,60,83100,7,"""22""",85080,85140
7259,404001,408704,60,83100,7,"""22""",85140,85200
7259,408704,601,0,83100,7,"""22""",85200,85200
7259,601,201,60,83100,7,"""22""",85200,85260
7259,201,501,60,83100,7,"""22""",85260,85320
7259,501,304,60,83100,7,"""22""",85320,85380
7259,304,100,120,83100,7,"""22""",85380,85500
7259,410201,34002,120,84900,7,"""22""",84900,85020
7259,34002,33902,60,84900,7,"""22""",85020,85080
7259,33902,26502,120,84900,7,"""22""",85080,85200
7259,26502,401302,60,84900,7,"""22""",85200,85260
7259,401302,502402,60,84900,7,"""22""",85260,85320
7259,502402,403402,60,84900,7,"""22""",85320,85380
7259,403402,404801,60,84900,7,"""22""",85380,85440
7259,404801,8102,60,84900,7,"""22""",85440,85500
7259,8102,405001,60,84900,7,"""22""",85500,85560
7259,405001,407504,120,84900,7,"""22""",85560,85680
7259,407504,409802,60,84900,7,"""22""",85680,85740
7259,409802,409702,60,84900,7,"""22""",85740,85800
7259,409702,409502,60,84900,7,"""22""",85800,85860
7259,409502,400104,60,84900,7,"""22""",85860,85920
7259,400104,409402,60,84900,7,"""22""",85920,85980
7259,409402,403104,120,84900,7,"""22""",85980,86100
7259,403104,112102,120,84900,7,"""22""",86100,86220
7259,112102,101101,120,84900,7,"""22""",86220,86340
7259,101101,403801,60,84900,7,"""22""",86340,86400
7259,403801,409002,60,84900,7,"""22""",86400,86460
7259,409002,407601,60,84900,7,"""22""",86460,86520
7259,407601,405106,120,84900,7,"""22""",86520,86640
7259,405106,404501,60,84900,7,"""22""",86640,86700
7259,404501,400901,60,84900,7,"""22""",86700,86760
7259,400901,409101,60,84900,7,"""22""",86760,86820
7259,409101,405501,60,84900,7,"""22""",86820,86880
7259,405501,404001,60,84900,7,"""22""",86880,86940
7259,404001,408704,60,84900,7,"""22""",86940,87000
7259,408704,601,0,84900,7,"""22""",87000,87000
7259,601,201,60,84900,7,"""22""",87000,87060
7259,201,501,60,84900,7,"""22""",87060,87120
7259,501,304,60,84900,7,"""22""",87120,87180
7259,304,100,120,84900,7,"""22""",87180,87300
7260,101103,115100,60,47100,8,"""17""",47100,47160
7260,115100,109015,120,47100,8,"""17""",47160,47280
7260,109015,112105,120,47100,8,"""17""",47280,47400
7260,112105,103001,120,47100,8,"""17""",47400,47520
7260,103001,8001,120,47100,8,"""17""",47520,47640
7260,8001,105001,60,47100,8,"""17""",47640,47700
7260,105001,34103,60,47100,8,"""17""",47700,47760
7260,34103,208104,120,47100,8,"""17""",47760,47880
7260,208104,200102,120,47100,8,"""17""",47880,48000
7260,200102,208501,180,47100,8,"""17""",48000,48180
7260,208501,208004,120,47100,8,"""17""",48180,48300
7260,208004,203602,60,47100,8,"""17""",48300,48360
7260,203602,204102,120,47100,8,"""17""",48360,48480
7260,204102,200702,120,47100,8,"""17""",48480,48600
7260,200702,201702,60,47100,8,"""17""",48600,48660
7260,201702,200202,60,47100,8,"""17""",48660,48720
7260,200202,203102,60,47100,8,"""17""",48720,48780
7260,203102,203202,60,47100,8,"""17""",48780,48840
7260,203202,700502,60,47100,8,"""17""",48840,48900
7260,700502,202303,60,47100,8,"""17""",48900,48960
7260,202303,202702,60,47100,8,"""17""",48960,49020
7260,202702,700102,60,47100,8,"""17""",49020,49080
7261,112105,103001,120,28200,8,"""1""",28200,28320
7261,103001,8001,120,28200,8,"""1""",28320,28440
7261,8001,105001,60,28200,8,"""1""",28440,28500
7261,105001,34103,60,28200,8,"""1""",28500,28560
7261,34103,208104,120,28200,8,"""1""",28560,28680
7261,208104,200102,120,28200,8,"""1""",28680,28800
7261,200102,208501,180,28200,8,"""1""",28800,28980
7261,208501,208004,120,28200,8,"""1""",28980,29100
7261,208004,203602,60,28200,8,"""1""",29100,29160
7261,203602,204102,120,28200,8,"""1""",29160,29280
7261,204102,200702,120,28200,8,"""1""",29280,29400
7261,200702,201702,60,28200,8,"""1""",29400,29460
7261,201702,200202,60,28200,8,"""1""",29460,29520
7261,200202,203102,60,28200,8,"""1""",29520,29580
7261,203102,203202,60,28200,8,"""1""",29580,29640
7261,203202,700502,60,28200,8,"""1""",29640,29700
7261,700502,202303,60,28200,8,"""1""",29700,29760
7261,202303,202702,60,28200,8,"""1""",29760,29820
7261,202702,700102,60,28200,8,"""1""",29820,29880
7261,700102,17702,60,28200,8,"""1""",29880,29940
7261,17702,83902,120,28200,8,"""1""",29940,30060
7261,112105,103001,120,31800,8,"""1""",31800,31920
7261,103001,8001,120,31800,8,"""1""",31920,32040
7261,8001,105001,60,31800,8,"""1""",32040,32100
7261,105001,34103,60,31800,8,"""1""",32100,32160
7261,34103,208104,120,31800,8,"""1""",32160,32280
7261,208104,200102,120,31800,8,"""1""",32280,32400
7261,200102,208501,180,31800,8,"""1""",32400,32580
7261,208501,208004,120,31800,8,"""1""",32580,32700
7261,208004,203602,60,31800,8,"""1""",32700,32760
7261,203602,204102,120,31800,8,"""1""",32760,32880
7261,204102,200702,120,31800,8,"""1""",32880,33000
7261,200702,201702,60,31800,8,"""1""",33000,33060
7261,201702,200202,60,31800,8,"""1""",33060,33120
7261,200202,203102,60,31800,8,"""1""",33120,33180
7261,203102,203202,60,31800,8,"""1""",33180,33240
7261,203202,700502,60,31800,8,"""1""",33240,33300
7261,700502,202303,60,31800,8,"""1""",33300,33360
7261,202303,202702,60,31800,8,"""1""",33360,33420
7261,202702,700102,60,31800,8,"""1""",33420,33480
7261,700102,17702,60,31800,8,"""1""",33480,33540
7261,17702,83902,120,31800,8,"""1""",33540,33660
7261,112105,103001,120,35400,8,"""1""",35400,35520
7261,103001,8001,120,35400,8,"""1""",35520,35640
7261,8001,105001,60,35400,8,"""1""",35640,35700
7261,105001,34103,60,35400,8,"""1""",35700,35760
7261,34103,208104,120,35400,8,"""1""",35760,35880
7261,208104,200102,120,35400,8,"""1""",35880,36000
7261,200102,208501,180,35400,8,"""1""",36000,36180
7261,208501,208004,120,35400,8,"""1""",36180,36300
7261,208004,203602,60,35400,8,"""1""",36300,36360
7261,203602,204102,120,35400,8,"""1""",36360,36480
7261,204102,200702,120,35400,8,"""1""",36480,36600
7261,200702,201702,60,35400,8,"""1""",36600,36660
7261,201702,200202,60,35400,8,"""1""",36660,36720
7261,200202,203102,60,35400,8,"""1""",36720,36780
7261,203102,203202,60,35400,8,"""1""",36780,36840
7261,203202,700502,60,35400,8,"""1""",36840,36900
7261,700502,202303,60,35400,8,"""1""",36900,36960
7261,202303,202702,60,35400,8,"""1""",36960,37020
7261,202702,700102,60,35400,8,"""1""",37020,37080
7261,700102,17702,60,35400,8,"""1""",37080,37140
7261,17702,83902,120,35400,8,"""1""",37140,37260
7261,112105,103001,120,39000,8,"""1""",39000,39120
7261,103001,8001,120,39000,8,"""1""",39120,39240
7261,8001,105001,60,39000,8,"""1""",39240,39300
7261,105001,34103,60,39000,8,"""1""",39300,39360
7261,34103,208104,120,39000,8,"""1""",39360,39480
7261,208104,200102,120,39000,8,"""1""",39480,39600
7261,200102,208501,180,39000,8,"""1""",39600,39780
7261,208501,208004,120,39000,8,"""1""",39780,39900
7261,208004,203602,60,39000,8,"""1""",39900,39960
7261,203602,204102,120,39000,8,"""1""",39960,40080
7261,204102,200702,120,39000,8,"""1""",40080,40200
7261,200702,201702,60,39000,8,"""1""",40200,40260
7261,201702,200202,60,39000,8,"""1""",40260,40320
7261,200202,203102,60,39000,8,"""1""",40320,40380
7261,203102,203202,60,39000,8,"""1""",40380,40440
7261,203202,700502,60,39000,8,"""1""",40440,40500
7261,700502,202303,60,39000,8,"""1""",40500,40560
7261,202303,202702,60,39000,8,"""1""",40560,40620
7261,202702,700102,60,39000,8,"""1""",40620,40680
7261,700102,17702,60,39000,8,"""1""",40680,40740
7261,17702,83902,120,39000,8,"""1""",40740,40860
7261,112105,103001,120,42600,8,"""1""",42600,42720
7261,103001,8001,120,42600,8,"""1""",42720,42840
7261,8001,105001,60,42600,8,"""1""",42840,42900
7261,105001,34103,60,42600,8,"""1""",42900,42960
7261,34103,208104,120,42600,8,"""1""",42960,43080
7261,208104,200102,120,42600,8,"""1""",43080,43200
7261,200102,208501,180,42600,8,"""1""",43200,43380
7261,208501,208004,120,42600,8,"""1""",43380,43500
7261,208004,203602,60,42600,8,"""1""",43500,43560
7261,203602,204102,120,42600,8,"""1""",43560,43680
7261,204102,200702,120,42600,8,"""1""",43680,43800
7261,200702,201702,60,42600,8,"""1""",43800,43860
7261,201702,200202,60,42600,8,"""1""",43860,43920
7261,200202,203102,60,42600,8,"""1""",43920,43980
7261,203102,203202,60,42600,8,"""1""",43980,44040
7261,203202,700502,60,42600,8,"""1""",44040,44100
7261,700502,202303,60,42600,8,"""1""",44100,44160
7261,202303,202702,60,42600,8,"""1""",44160,44220
7261,202702,700102,60,42600,8,"""1""",44220,44280
7261,700102,17702,60,42600,8,"""1""",44280,44340
7261,17702,83902,120,42600,8,"""1""",44340,44460
7261,112105,103001,120,46200,8,"""1""",46200,46320
7261,103001,8001,120,46200,8,"""1""",46320,46440
7261,8001,105001,60,46200,8,"""1""",46440,46500
7261,105001,34103,60,46200,8,"""1""",46500,46560
7261,34103,208104,120,46200,8,"""1""",46560,46680
7261,208104,200102,120,46200,8,"""1""",46680,46800
7261,200102,208501,180,46200,8,"""1""",46800,46980
7261,208501,208004,120,46200,8,"""1""",46980,47100
7261,208004,203602,60,46200,8,"""1""",47100,47160
7261,203602,204102,120,46200,8,"""1""",47160,47280
7261,204102,200702,120,46200,8,"""1""",47280,47400
7261,200702,201702,60,46200,8,"""1""",47400,47460
7261,201702,200202,60,46200,8,"""1""",47460,47520
7261,200202,203102,60,46200,8,"""1""",47520,47580
7261,203102,203202,60,46200,8,"""1""",47580,47640
7261,203202,700502,60,46200,8,"""1""",47640,47700
7261,700502,202303,60,46200,8,"""1""",47700,47760
7261,202303,202702,60,46200,8,"""1""",47760,47820
7261,202702,700102,60,46200,8,"""1""",47820,47880
7261,700102,17702,60,46200,8,"""1""",47880,47940
7261,17702,83902,120,46200,8,"""1""",47940,48060
7261,112105,103001,120,49800,8,"""1""",49800,49920
7261,103001,8001,120,49800,8,"""1""",49920,50040
7261,8001,105001,60,49800,8,"""1""",50040,50100
7261,105001,34103,60,49800,8,"""1""",50100,50160
7261,34103,208104,120,49800,8,"""1""",50160,50280
7261,208104,200102,120,49800,8,"""1""",50280,50400
7261,200102,208501,180,49800,8,"""1""",50400,50580
7261,208501,208004,120,49800,8,"""1""",50580,50700
7261,208004,203602,60,49800,8,"""1""",50700,50760
7261,203602,204102,120,49800,8,"""1""",50760,50880
7261,204102,200702,120,49800,8,"""1""",50880,51000
7261,200702,201702,60,49800,8,"""1""",51000,51060
7261,201702,200202,60,49800,8,"""1""",51060,51120
7261,200202,203102,60,49800,8,"""1""",51120,51180
7261,203102,203202,60,49800,8,"""1""",51180,51240
7261,203202,700502,60,49800,8,"""1""",51240,51300
7261,700502,202303,60,49800,8,"""1""",51300,51360
7261,202303,202702,60,49800,8,"""1""",51360,51420
7261,202702,700102,60,49800,8,"""1""",51420,51480
7261,700102,17702,60,49800,8,"""1""",51480,51540
7261,17702,83902,120,49800,8,"""1""",51540,51660
7261,112105,103001,120,53400,8,"""1""",53400,53520
7261,103001,8001,120,53400,8,"""1""",53520,53640
7261,8001,105001,60,53400,8,"""1""",53640,53700
7261,105001,34103,60,53400,8,"""1""",53700,53760
7261,34103,208104,120,53400,8,"""1""",53760,53880
7261,208104,200102,120,53400,8,"""1""",53880,54000
7261,200102,208501,180,53400,8,"""1""",54000,54180
7261,208501,208004,120,53400,8,"""1""",54180,54300
7261,208004,203602,60,53400,8,"""1""",54300,54360
7261,203602,204102,120,53400,8,"""1""",54360,54480
7261,204102,200702,120,53400,8,"""1""",54480,54600
7261,200702,201702,60,53400,8,"""1""",54600,54660
7261,201702,200202,60,53400,8,"""1""",54660,54720
7261,200202,203102,60,53400,8,"""1""",54720,54780
7261,203102,203202,60,53400,8,"""1""",54780,54840
7261,203202,700502,60,53400,8,"""1""",54840,54900
7261,700502,202303,60,53400,8,"""1""",54900,54960
7261,202303,202702,60,53400,8,"""1""",54960,55020
7261,202702,700102,60,53400,8,"""1""",55020,55080
7261,700102,17702,60,53400,8,"""1""",55080,55140
7261,17702,83902,120,53400,8,"""1""",55140,55260
7261,112105,103001,120,57000,8,"""1""",57000,57120
7261,103001,8001,120,57000,8,"""1""",57120,57240
7261,8001,105001,60,57000,8,"""1""",57240,57300
7261,105001,34103,60,57000,8,"""1""",57300,57360
7261,34103,208104,120,57000,8,"""1""",57360,57480
7261,208104,200102,120,57000,8,"""1""",57480,57600
7261,200102,208501,180,57000,8,"""1""",57600,57780
7261,208501,208004,120,57000,8,"""1""",57780,57900
7261,208004,203602,60,57000,8,"""1""",57900,57960
7261,203602,204102,120,57000,8,"""1""",57960,58080
7261,204102,200702,120,57000,8,"""1""",58080,58200
7261,200702,201702,60,57000,8,"""1""",58200,58260
7261,201702,200202,60,57000,8,"""1""",58260,58320
7261,200202,203102,60,57000,8,"""1""",58320,58380
7261,203102,203202,60,57000,8,"""1""",58380,58440
7261,203202,700502,60,57000,8,"""1""",58440,58500
7261,700502,202303,60,57000,8,"""1""",58500,58560
7261,202303,202702,60,57000,8,"""1""",58560,58620
7261,202702,700102,60,57000,8,"""1""",58620,58680
7261,700102,17702,60,57000,8,"""1""",58680,58740
7261,17702,83902,120,57000,8,"""1""",58740,58860
7261,112105,103001,120,60600,8,"""1""",60600,60720
7261,103001,8001,120,60600,8,"""1""",60720,60840
7261,8001,105001,60,60600,8,"""1""",60840,60900
7261,105001,34103,60,60600,8,"""1""",60900,60960
7261,34103,208104,120,60600,8,"""1""",60960,61080
7261,208104,200102,120,60600,8,"""1""",61080,61200
7261,200102,208501,180,60600,8,"""1""",61200,61380
7261,208501,208004,120,60600,8,"""1""",61380,61500
7261,208004,203602,60,60600,8,"""1""",61500,61560
7261,203602,204102,120,60600,8,"""1""",61560,61680
7261,204102,200702,120,60600,8,"""1""",61680,61800
7261,200702,201702,60,60600,8,"""1""",61800,61860
7261,201702,200202,60,60600,8,"""1""",61860,61920
7261,200202,203102,60,60600,8,"""1""",61920,61980
7261,203102,203202,60,60600,8,"""1""",61980,62040
7261,203202,700502,60,60600,8,"""1""",62040,62100
7261,700502,202303,60,60600,8,"""1""",62100,62160
7261,202303,202702,60,60600,8,"""1""",62160,62220
7261,202702,700102,60,60600,8,"""1""",62220,62280
7261,700102,17702,60,60600,8,"""1""",62280,62340
7261,17702,83902,120,60600,8,"""1""",62340,62460
7261,112105,103001,120,64200,8,"""1""",64200,64320
7261,103001,8001,120,64200,8,"""1""",64320,64440
7261,8001,105001,60,64200,8,"""1""",64440,64500
7261,105001,34103,60,64200,8,"""1""",64500,64560
7261,34103,208104,120,64200,8,"""1""",64560,64680
7261,208104,200102,120,64200,8,"""1""",64680,64800
7261,200102,208501,180,64200,8,"""1""",64800,64980
7261,208501,208004,120,64200,8,"""1""",64980,65100
7261,208004,203602,60,64200,8,"""1""",65100,65160
7261,203602,204102,120,64200,8,"""1""",65160,65280
7261,204102,200702,120,64200,8,"""1""",65280,65400
7261,200702,201702,60,64200,8,"""1""",65400,65460
7261,201702,200202,60,64200,8,"""1""",65460,65520
7261,200202,203102,60,64200,8,"""1""",65520,65580
7261,203102,203202,60,64200,8,"""1""",65580,65640
7261,203202,700502,60,64200,8,"""1""",65640,65700
7261,700502,202303,60,64200,8,"""1""",65700,65760
7261,202303,202702,60,64200,8,"""1""",65760,65820
7261,202702,700102,60,64200,8,"""1""",65820,65880
7261,700102,17702,60,64200,8,"""1""",65880,65940
7261,17702,83902,120,64200,8,"""1""",65940,66060
7261,112105,103001,120,67800,8,"""1""",67800,67920
7261,103001,8001,120,67800,8,"""1""",67920,68040
7261,8001,105001,60,67800,8,"""1""",68040,68100
7261,105001,34103,60,67800,8,"""1""",68100,68160
7261,34103,208104,120,67800,8,"""1""",68160,68280
7261,208104,200102,120,67800,8,"""1""",68280,68400
7261,200102,208501,180,67800,8,"""1""",68400,68580
7261,208501,208004,120,67800,8,"""1""",68580,68700
7261,208004,203602,60,67800,8,"""1""",68700,68760
7261,203602,204102,120,67800,8,"""1""",68760,68880
7261,204102,200702,120,67800,8,"""1""",68880,69000
7261,200702,201702,60,67800,8,"""1""",69000,69060
7261,201702,200202,60,67800,8,"""1""",69060,69120
7261,200202,203102,60,67800,8,"""1""",69120,69180
7261,203102,203202,60,67800,8,"""1""",69180,69240
7261,203202,700502,60,67800,8,"""1""",69240,69300
7261,700502,202303,60,67800,8,"""1""",69300,69360
7261,202303,202702,60,67800,8,"""1""",69360,69420
7261,202702,700102,60,67800,8,"""1""",69420,69480
7261,700102,17702,60,67800,8,"""1""",69480,69540
7261,17702,83902,120,67800,8,"""1""",69540,69660
7261,112105,103001,120,71400,8,"""1""",71400,71520
7261,103001,8001,120,71400,8,"""1""",71520,71640
7261,8001,105001,60,71400,8,"""1""",71640,71700
7261,105001,34103,60,71400,8,"""1""",71700,71760
7261,34103,208104,120,71400,8,"""1""",71760,71880
7261,208104,200102,120,71400,8,"""1""",71880,72000
7261,200102,208501,180,71400,8,"""1""",72000,72180
7261,208501,208004,120,71400,8,"""1""",72180,72300
7261,208004,203602,60,71400,8,"""1""",72300,72360
7261,203602,204102,120,71400,8,"""1""",72360,72480
7261,204102,200702,120,71400,8,"""1""",72480,72600
7261,200702,201702,60,71400,8,"""1""",72600,72660
7261,201702,200202,60,71400,8,"""1""",72660,72720
7261,200202,203102,60,71400,8,"""1""",72720,72780
7261,203102,203202,60,71400,8,"""1""",72780,72840
7261,203202,700502,60,71400,8,"""1""",72840,72900
7261,700502,202303,60,71400,8,"""1""",72900,72960
7261,202303,202702,60,71400,8,"""1""",72960,73020
7261,202702,700102,60,71400,8,"""1""",73020,73080
7261,700102,17702,60,71400,8,"""1""",73080,73140
7261,17702,83902,120,71400,8,"""1""",73140,73260
7262,112105,103001,120,24600,8,"""1""",24600,24720
7262,103001,8001,120,24600,8,"""1""",24720,24840
7262,8001,105001,60,24600,8,"""1""",24840,24900
7262,105001,34103,60,24600,8,"""1""",24900,24960
7262,34103,208104,120,24600,8,"""1""",24960,25080
7262,208104,200102,60,24600,8,"""1""",25080,25140
7262,200102,208501,120,24600,8,"""1""",25140,25260
7262,208501,208004,120,24600,8,"""1""",25260,25380
7262,208004,203602,60,24600,8,"""1""",25380,25440
7262,203602,204102,120,24600,8,"""1""",25440,25560
7262,204102,200702,120,24600,8,"""1""",25560,25680
7262,200702,201702,60,24600,8,"""1""",25680,25740
7262,201702,200202,60,24600,8,"""1""",25740,25800
7262,200202,203102,60,24600,8,"""1""",25800,25860
7262,203102,203202,60,24600,8,"""1""",25860,25920
7262,203202,700502,60,24600,8,"""1""",25920,25980
7262,700502,202303,60,24600,8,"""1""",25980,26040
7262,202303,202702,60,24600,8,"""1""",26040,26100
7262,202702,700102,60,24600,8,"""1""",26100,26160
7262,700102,17702,60,24600,8,"""1""",26160,26220
7262,17702,83902,120,24600,8,"""1""",26220,26340
7263,112105,103001,120,76500,8,"""1""",76500,76620
7263,103001,8001,120,76500,8,"""1""",76620,76740
7263,8001,105001,60,76500,8,"""1""",76740,76800
7263,105001,34103,60,76500,8,"""1""",76800,76860
7263,34103,208104,120,76500,8,"""1""",76860,76980
7263,208104,200102,60,76500,8,"""1""",76980,77040
7263,200102,208501,60,76500,8,"""1""",77040,77100
7263,208501,208004,60,76500,8,"""1""",77100,77160
7263,208004,203602,60,76500,8,"""1""",77160,77220
7263,203602,204102,60,76500,8,"""1""",77220,77280
7263,204102,200702,120,76500,8,"""1""",77280,77400
7263,200702,201702,60,76500,8,"""1""",77400,77460
7263,201702,200202,60,76500,8,"""1""",77460,77520
7263,200202,203102,60,76500,8,"""1""",77520,77580
7263,203102,203202,60,76500,8,"""1""",77580,77640
7263,203202,700502,60,76500,8,"""1""",77640,77700
7263,700502,202303,60,76500,8,"""1""",77700,77760
7263,202303,202702,60,76500,8,"""1""",77760,77820
7263,202702,700102,60,76500,8,"""1""",77820,77880
7263,700102,17702,60,76500,8,"""1""",77880,77940
7263,17702,83902,120,76500,8,"""1""",77940,78060
7263,112105,103001,120,80100,8,"""1""",80100,80220
7263,103001,8001,120,80100,8,"""1""",80220,80340
7263,8001,105001,60,80100,8,"""1""",80340,80400
7263,105001,34103,60,80100,8,"""1""",80400,80460
7263,34103,208104,120,80100,8,"""1""",80460,80580
7263,208104,200102,60,80100,8,"""1""",80580,80640
7263,200102,208501,60,80100,8,"""1""",80640,80700
7263,208501,208004,60,80100,8,"""1""",80700,80760
7263,208004,203602,60,80100,8,"""1""",80760,80820
7263,203602,204102,60,80100,8,"""1""",80820,80880
7263,204102,200702,120,80100,8,"""1""",80880,81000
7263,200702,201702,60,80100,8,"""1""",81000,81060
7263,201702,200202,60,80100,8,"""1""",81060,81120
7263,200202,203102,60,80100,8,"""1""",81120,81180
7263,203102,203202,60,80100,8,"""1""",81180,81240
7263,203202,700502,60,80100,8,"""1""",81240,81300
7263,700502,202303,60,80100,8,"""1""",81300,81360
7263,202303,202702,60,80100,8,"""1""",81360,81420
7263,202702,700102,60,80100,8,"""1""",81420,81480
7263,700102,17702,60,80100,8,"""1""",81480,81540
7263,17702,83902,120,80100,8,"""1""",81540,81660
7263,112105,103001,120,83700,8,"""1""",83700,83820
7263,103001,8001,120,83700,8,"""1""",83820,83940
7263,8001,105001,60,83700,8,"""1""",83940,84000
7263,105001,34103,60,83700,8,"""1""",84000,84060
7263,34103,208104,120,83700,8,"""1""",84060,84180
7263,208104,200102,60,83700,8,"""1""",84180,84240
7263,200102,208501,60,83700,8,"""1""",84240,84300
7263,208501,208004,60,83700,8,"""1""",84300,84360
7263,208004,203602,60,83700,8,"""1""",84360,84420
7263,203602,204102,60,83700,8,"""1""",84420,84480
7263,204102,200702,120,83700,8,"""1""",84480,84600
7263,200702,201702,60,83700,8,"""1""",84600,84660
7263,201702,200202,60,83700,8,"""1""",84660,84720
7263,200202,203102,60,83700,8,"""1""",84720,84780
7263,203102,203202,60,83700,8,"""1""",84780,84840
7263,203202,700502,60,83700,8,"""1""",84840,84900
7263,700502,202303,60,83700,8,"""1""",84900,84960
7263,202303,202702,60,83700,8,"""1""",84960,85020
7263,202702,700102,60,83700,8,"""1""",85020,85080
7263,700102,17702,60,83700,8,"""1""",85080,85140
7263,17702,83902,120,83700,8,"""1""",85140,85260
7263,112105,103001,120,85500,8,"""1""",85500,85620
7263,103001,8001,120,85500,8,"""1""",85620,85740
7263,8001,105001,60,85500,8,"""1""",85740,85800
7263,105001,34103,60,85500,8,"""1""",85800,85860
7263,34103,208104,120,85500,8,"""1""",85860,85980
7263,208104,200102,60,85500,8,"""1""",85980,86040
7263,200102,208501,60,85500,8,"""1""",86040,86100
7263,208501,208004,60,85500,8,"""1""",86100,86160
7263,208004,203602,60,85500,8,"""1""",86160,86220
7263,203602,204102,60,85500,8,"""1""",86220,86280
7263,204102,200702,120,85500,8,"""1""",86280,86400
7263,200702,201702,60,85500,8,"""1""",86400,86460
7263,201702,200202,60,85500,8,"""1""",86460,86520
7263,200202,203102,60,85500,8,"""1""",86520,86580
7263,203102,203202,60,85500,8,"""1""",86580,86640
7263,203202,700502,60,85500,8,"""1""",86640,86700
7263,700502,202303,60,85500,8,"""1""",86700,86760
7263,202303,202702,60,85500,8,"""1""",86760,86820
7263,202702,700102,60,85500,8,"""1""",86820,86880
7263,700102,17702,60,85500,8,"""1""",86880,86940
7263,17702,83902,120,85500,8,"""1""",86940,87060
7264,112105,103001,120,25800,8,"""3""",25800,25920
7264,103001,8001,120,25800,8,"""3""",25920,26040
7264,8001,105001,60,25800,8,"""3""",26040,26100
7264,105001,34103,60,25800,8,"""3""",26100,26160
7264,34103,208104,120,25800,8,"""3""",26160,26280
7264,208104,200102,120,25800,8,"""3""",26280,26400
7264,200102,208501,180,25800,8,"""3""",26400,26580
7264,208501,208004,120,25800,8,"""3""",26580,26700
7264,208004,203602,60,25800,8,"""3""",26700,26760
7264,203602,204102,120,25800,8,"""3""",26760,26880
7264,204102,200702,120,25800,8,"""3""",26880,27000
7264,200702,201702,60,25800,8,"""3""",27000,27060
7264,201702,200202,60,25800,8,"""3""",27060,27120
7264,200202,203102,60,25800,8,"""3""",27120,27180
7264,203102,203202,60,25800,8,"""3""",27180,27240
7264,203202,700502,60,25800,8,"""3""",27240,27300
7264,700502,202303,60,25800,8,"""3""",27300,27360
7264,202303,202702,60,25800,8,"""3""",27360,27420
7264,202702,700102,60,25800,8,"""3""",27420,27480
7264,700102,17702,60,25800,8,"""3""",27480,27540
7264,112105,103001,120,27000,8,"""3""",27000,27120
7264,103001,8001,120,27000,8,"""3""",27120,27240
7264,8001,105001,60,27000,8,"""3""",27240,27300
7264,105001,34103,60,27000,8,"""3""",27300,27360
7264,34103,208104,120,27000,8,"""3""",27360,27480
7264,208104,200102,120,27000,8,"""3""",27480,27600
7264,200102,208501,180,27000,8,"""3""",27600,27780
7264,208501,208004,120,27000,8,"""3""",27780,27900
7264,208004,203602,60,27000,8,"""3""",27900,27960
7264,203602,204102,120,27000,8,"""3""",27960,28080
7264,204102,200702,120,27000,8,"""3""",28080,28200
7264,200702,201702,60,27000,8,"""3""",28200,28260
7264,201702,200202,60,27000,8,"""3""",28260,28320
7264,200202,203102,60,27000,8,"""3""",28320,28380
7264,203102,203202,60,27000,8,"""3""",28380,28440
7264,203202,700502,60,27000,8,"""3""",28440,28500
7264,700502,202303,60,27000,8,"""3""",28500,28560
7264,202303,202702,60,27000,8,"""3""",28560,28620
7264,202702,700102,60,27000,8,"""3""",28620,28680
7264,700102,17702,60,27000,8,"""3""",28680,28740
7264,112105,103001,120,29400,8,"""3""",29400,29520
7264,103001,8001,120,29400,8,"""3""",29520,29640
7264,8001,105001,60,29400,8,"""3""",29640,29700
7264,105001,34103,60,29400,8,"""3""",29700,29760
7264,34103,208104,120,29400,8,"""3""",29760,29880
7264,208104,200102,120,29400,8,"""3""",29880,30000
7264,200102,208501,180,29400,8,"""3""",30000,30180
7264,208501,208004,120,29400,8,"""3""",30180,30300
7264,208004,203602,60,29400,8,"""3""",30300,30360
7264,203602,204102,120,29400,8,"""3""",30360,30480
7264,204102,200702,120,29400,8,"""3""",30480,30600
7264,200702,201702,60,29400,8,"""3""",30600,30660
7264,201702,200202,60,29400,8,"""3""",30660,30720
7264,200202,203102,60,29400,8,"""3""",30720,30780
7264,203102,203202,60,29400,8,"""3""",30780,30840
7264,203202,700502,60,29400,8,"""3""",30840,30900
7264,700502,202303,60,29400,8,"""3""",30900,30960
7264,202303,202702,60,29400,8,"""3""",30960,31020
7264,202702,700102,60,29400,8,"""3""",31020,31080
7264,700102,17702,60,29400,8,"""3""",31080,31140
7264,112105,103001,120,30600,8,"""3""",30600,30720
7264,103001,8001,120,30600,8,"""3""",30720,30840
7264,8001,105001,60,30600,8,"""3""",30840,30900
7264,105001,34103,60,30600,8,"""3""",30900,30960
7264,34103,208104,120,30600,8,"""3""",30960,31080
7264,208104,200102,120,30600,8,"""3""",31080,31200
7264,200102,208501,180,30600,8,"""3""",31200,31380
7264,208501,208004,120,30600,8,"""3""",31380,31500
7264,208004,203602,60,30600,8,"""3""",31500,31560
7264,203602,204102,120,30600,8,"""3""",31560,31680
7264,204102,200702,120,30600,8,"""3""",31680,31800
7264,200702,201702,60,30600,8,"""3""",31800,31860
7264,201702,200202,60,30600,8,"""3""",31860,31920
7264,200202,203102,60,30600,8,"""3""",31920,31980
7264,203102,203202,60,30600,8,"""3""",31980,32040
7264,203202,700502,60,30600,8,"""3""",32040,32100
7264,700502,202303,60,30600,8,"""3""",32100,32160
7264,202303,202702,60,30600,8,"""3""",32160,32220
7264,202702,700102,60,30600,8,"""3""",32220,32280
7264,700102,17702,60,30600,8,"""3""",32280,32340
7264,112105,103001,120,33000,8,"""3""",33000,33120
7264,103001,8001,120,33000,8,"""3""",33120,33240
7264,8001,105001,60,33000,8,"""3""",33240,33300
7264,105001,34103,60,33000,8,"""3""",33300,33360
7264,34103,208104,120,33000,8,"""3""",33360,33480
7264,208104,200102,120,33000,8,"""3""",33480,33600
7264,200102,208501,180,33000,8,"""3""",33600,33780
7264,208501,208004,120,33000,8,"""3""",33780,33900
7264,208004,203602,60,33000,8,"""3""",33900,33960
7264,203602,204102,120,33000,8,"""3""",33960,34080
7264,204102,200702,120,33000,8,"""3""",34080,34200
7264,200702,201702,60,33000,8,"""3""",34200,34260
7264,201702,200202,60,33000,8,"""3""",34260,34320
7264,200202,203102,60,33000,8,"""3""",34320,34380
7264,203102,203202,60,33000,8,"""3""",34380,34440
7264,203202,700502,60,33000,8,"""3""",34440,34500
7264,700502,202303,60,33000,8,"""3""",34500,34560
7264,202303,202702,60,33000,8,"""3""",34560,34620
7264,202702,700102,60,33000,8,"""3""",34620,34680
7264,700102,17702,60,33000,8,"""3""",34680,34740
7264,112105,103001,120,34200,8,"""3""",34200,34320
7264,103001,8001,120,34200,8,"""3""",34320,34440
7264,8001,105001,60,34200,8,"""3""",34440,34500
7264,105001,34103,60,34200,8,"""3""",34500,34560
7264,34103,208104,120,34200,8,"""3""",34560,34680
7264,208104,200102,120,34200,8,"""3""",34680,34800
7264,200102,208501,180,34200,8,"""3""",34800,34980
7264,208501,208004,120,34200,8,"""3""",34980,35100
7264,208004,203602,60,34200,8,"""3""",35100,35160
7264,203602,204102,120,34200,8,"""3""",35160,35280
7264,204102,200702,120,34200,8,"""3""",35280,35400
7264,200702,201702,60,34200,8,"""3""",35400,35460
7264,201702,200202,60,34200,8,"""3""",35460,35520
7264,200202,203102,60,34200,8,"""3""",35520,35580
7264,203102,203202,60,34200,8,"""3""",35580,35640
7264,203202,700502,60,34200,8,"""3""",35640,35700
7264,700502,202303,60,34200,8,"""3""",35700,35760
7264,202303,202702,60,34200,8,"""3""",35760,35820
7264,202702,700102,60,34200,8,"""3""",35820,35880
7264,700102,17702,60,34200,8,"""3""",35880,35940
7264,112105,103001,120,36600,8,"""3""",36600,36720
7264,103001,8001,120,36600,8,"""3""",36720,36840
7264,8001,105001,60,36600,8,"""3""",36840,36900
7264,105001,34103,60,36600,8,"""3""",36900,36960
7264,34103,208104,120,36600,8,"""3""",36960,37080
7264,208104,200102,120,36600,8,"""3""",37080,37200
7264,200102,208501,180,36600,8,"""3""",37200,37380
7264,208501,208004,120,36600,8,"""3""",37380,37500
7264,208004,203602,60,36600,8,"""3""",37500,37560
7264,203602,204102,120,36600,8,"""3""",37560,37680
7264,204102,200702,120,36600,8,"""3""",37680,37800
7264,200702,201702,60,36600,8,"""3""",37800,37860
7264,201702,200202,60,36600,8,"""3""",37860,37920
7264,200202,203102,60,36600,8,"""3""",37920,37980
7264,203102,203202,60,36600,8,"""3""",37980,38040
7264,203202,700502,60,36600,8,"""3""",38040,38100
7264,700502,202303,60,36600,8,"""3""",38100,38160
7264,202303,202702,60,36600,8,"""3""",38160,38220
7264,202702,700102,60,36600,8,"""3""",38220,38280
7264,700102,17702,60,36600,8,"""3""",38280,38340
7264,112105,103001,120,37800,8,"""3""",37800,37920
7264,103001,8001,120,37800,8,"""3""",37920,38040
7264,8001,105001,60,37800,8,"""3""",38040,38100
7264,105001,34103,60,37800,8,"""3""",38100,38160
7264,34103,208104,120,37800,8,"""3""",38160,38280
7264,208104,200102,120,37800,8,"""3""",38280,38400
7264,200102,208501,180,37800,8,"""3""",38400,38580
7264,208501,208004,120,37800,8,"""3""",38580,38700
7264,208004,203602,60,37800,8,"""3""",38700,38760
7264,203602,204102,120,37800,8,"""3""",38760,38880
7264,204102,200702,120,37800,8,"""3""",38880,39000
7264,200702,201702,60,37800,8,"""3""",39000,39060
7264,201702,200202,60,37800,8,"""3""",39060,39120
7264,200202,203102,60,37800,8,"""3""",39120,39180
7264,203102,203202,60,37800,8,"""3""",39180,39240
7264,203202,700502,60,37800,8,"""3""",39240,39300
7264,700502,202303,60,37800,8,"""3""",39300,39360
7264,202303,202702,60,37800,8,"""3""",39360,39420
7264,202702,700102,60,37800,8,"""3""",39420,39480
7264,700102,17702,60,37800,8,"""3""",39480,39540
7264,112105,103001,120,40200,8,"""3""",40200,40320
7264,103001,8001,120,40200,8,"""3""",40320,40440
7264,8001,105001,60,40200,8,"""3""",40440,40500
7264,105001,34103,60,40200,8,"""3""",40500,40560
7264,34103,208104,120,40200,8,"""3""",40560,40680
7264,208104,200102,120,40200,8,"""3""",40680,40800
7264,200102,208501,180,40200,8,"""3""",40800,40980
7264,208501,208004,120,40200,8,"""3""",40980,41100
7264,208004,203602,60,40200,8,"""3""",41100,41160
7264,203602,204102,120,40200,8,"""3""",41160,41280
7264,204102,200702,120,40200,8,"""3""",41280,41400
7264,200702,201702,60,40200,8,"""3""",41400,41460
7264,201702,200202,60,40200,8,"""3""",41460,41520
7264,200202,203102,60,40200,8,"""3""",41520,41580
7264,203102,203202,60,40200,8,"""3""",41580,41640
7264,203202,700502,60,40200,8,"""3""",41640,41700
7264,700502,202303,60,40200,8,"""3""",41700,41760
7264,202303,202702,60,40200,8,"""3""",41760,41820
7264,202702,700102,60,40200,8,"""3""",41820,41880
7264,700102,17702,60,40200,8,"""3""",41880,41940
7264,112105,103001,120,41400,8,"""3""",41400,41520
7264,103001,8001,120,41400,8,"""3""",41520,41640
7264,8001,105001,60,41400,8,"""3""",41640,41700
7264,105001,34103,60,41400,8,"""3""",41700,41760
7264,34103,208104,120,41400,8,"""3""",41760,41880
7264,208104,200102,120,41400,8,"""3""",41880,42000
7264,200102,208501,180,41400,8,"""3""",42000,42180
7264,208501,208004,120,41400,8,"""3""",42180,42300
7264,208004,203602,60,41400,8,"""3""",42300,42360
7264,203602,204102,120,41400,8,"""3""",42360,42480
7264,204102,200702,120,41400,8,"""3""",42480,42600
7264,200702,201702,60,41400,8,"""3""",42600,42660
7264,201702,200202,60,41400,8,"""3""",42660,42720
7264,200202,203102,60,41400,8,"""3""",42720,42780
7264,203102,203202,60,41400,8,"""3""",42780,42840
7264,203202,700502,60,41400,8,"""3""",42840,42900
7264,700502,202303,60,41400,8,"""3""",42900,42960
7264,202303,202702,60,41400,8,"""3""",42960,43020
7264,202702,700102,60,41400,8,"""3""",43020,43080
7264,700102,17702,60,41400,8,"""3""",43080,43140
7264,112105,103001,120,43800,8,"""3""",43800,43920
7264,103001,8001,120,43800,8,"""3""",43920,44040
7264,8001,105001,60,43800,8,"""3""",44040,44100
7264,105001,34103,60,43800,8,"""3""",44100,44160
7264,34103,208104,120,43800,8,"""3""",44160,44280
7264,208104,200102,120,43800,8,"""3""",44280,44400
7264,200102,208501,180,43800,8,"""3""",44400,44580
7264,208501,208004,120,43800,8,"""3""",44580,44700
7264,208004,203602,60,43800,8,"""3""",44700,44760
7264,203602,204102,120,43800,8,"""3""",44760,44880
7264,204102,200702,120,43800,8,"""3""",44880,45000
7264,200702,201702,60,43800,8,"""3""",45000,45060
7264,201702,200202,60,43800,8,"""3""",45060,45120
7264,200202,203102,60,43800,8,"""3""",45120,45180
7264,203102,203202,60,43800,8,"""3""",45180,45240
7264,203202,700502,60,43800,8,"""3""",45240,45300
7264,700502,202303,60,43800,8,"""3""",45300,45360
7264,202303,202702,60,43800,8,"""3""",45360,45420
7264,202702,700102,60,43800,8,"""3""",45420,45480
7264,700102,17702,60,43800,8,"""3""",45480,45540
7264,112105,103001,120,45000,8,"""3""",45000,45120
7264,103001,8001,120,45000,8,"""3""",45120,45240
7264,8001,105001,60,45000,8,"""3""",45240,45300
7264,105001,34103,60,45000,8,"""3""",45300,45360
7264,34103,208104,120,45000,8,"""3""",45360,45480
7264,208104,200102,120,45000,8,"""3""",45480,45600
7264,200102,208501,180,45000,8,"""3""",45600,45780
7264,208501,208004,120,45000,8,"""3""",45780,45900
7264,208004,203602,60,45000,8,"""3""",45900,45960
7264,203602,204102,120,45000,8,"""3""",45960,46080
7264,204102,200702,120,45000,8,"""3""",46080,46200
7264,200702,201702,60,45000,8,"""3""",46200,46260
7264,201702,200202,60,45000,8,"""3""",46260,46320
7264,200202,203102,60,45000,8,"""3""",46320,46380
7264,203102,203202,60,45000,8,"""3""",46380,46440
7264,203202,700502,60,45000,8,"""3""",46440,46500
7264,700502,202303,60,45000,8,"""3""",46500,46560
7264,202303,202702,60,45000,8,"""3""",46560,46620
7264,202702,700102,60,45000,8,"""3""",46620,46680
7264,700102,17702,60,45000,8,"""3""",46680,46740
7264,112105,103001,120,47400,8,"""3""",47400,47520
7264,103001,8001,120,47400,8,"""3""",47520,47640
7264,8001,105001,60,47400,8,"""3""",47640,47700
7264,105001,34103,60,47400,8,"""3""",47700,47760
7264,34103,208104,120,47400,8,"""3""",47760,47880
7264,208104,200102,120,47400,8,"""3""",47880,48000
7264,200102,208501,180,47400,8,"""3""",48000,48180
7264,208501,208004,120,47400,8,"""3""",48180,48300
7264,208004,203602,60,47400,8,"""3""",48300,48360
7264,203602,204102,120,47400,8,"""3""",48360,48480
7264,204102,200702,120,47400,8,"""3""",48480,48600
7264,200702,201702,60,47400,8,"""3""",48600,48660
7264,201702,200202,60,47400,8,"""3""",48660,48720
7264,200202,203102,60,47400,8,"""3""",48720,48780
7264,203102,203202,60,47400,8,"""3""",48780,48840
7264,203202,700502,60,47400,8,"""3""",48840,48900
7264,700502,202303,60,47400,8,"""3""",48900,48960
7264,202303,202702,60,47400,8,"""3""",48960,49020
7264,202702,700102,60,47400,8,"""3""",49020,49080
7264,700102,17702,60,47400,8,"""3""",49080,49140
7264,112105,103001,120,48600,8,"""3""",48600,48720
7264,103001,8001,120,48600,8,"""3""",48720,48840
7264,8001,105001,60,48600,8,"""3""",48840,48900
7264,105001,34103,60,48600,8,"""3""",48900,48960
7264,34103,208104,120,48600,8,"""3""",48960,49080
7264,208104,200102,120,48600,8,"""3""",49080,49200
7264,200102,208501,180,48600,8,"""3""",49200,49380
7264,208501,208004,120,48600,8,"""3""",49380,49500
7264,208004,203602,60,48600,8,"""3""",49500,49560
7264,203602,204102,120,48600,8,"""3""",49560,49680
7264,204102,200702,120,48600,8,"""3""",49680,49800
7264,200702,201702,60,48600,8,"""3""",49800,49860
7264,201702,200202,60,48600,8,"""3""",49860,49920
7264,200202,203102,60,48600,8,"""3""",49920,49980
7264,203102,203202,60,48600,8,"""3""",49980,50040
7264,203202,700502,60,48600,8,"""3""",50040,50100
7264,700502,202303,60,48600,8,"""3""",50100,50160
7264,202303,202702,60,48600,8,"""3""",50160,50220
7264,202702,700102,60,48600,8,"""3""",50220,50280
7264,700102,17702,60,48600,8,"""3""",50280,50340
7264,112105,103001,120,51000,8,"""3""",51000,51120
7264,103001,8001,120,51000,8,"""3""",51120,51240
7264,8001,105001,60,51000,8,"""3""",51240,51300
7264,105001,34103,60,51000,8,"""3""",51300,51360
7264,34103,208104,120,51000,8,"""3""",51360,51480
7264,208104,200102,120,51000,8,"""3""",51480,51600
7264,200102,208501,180,51000,8,"""3""",51600,51780
7264,208501,208004,120,51000,8,"""3""",51780,51900
7264,208004,203602,60,51000,8,"""3""",51900,51960
7264,203602,204102,120,51000,8,"""3""",51960,52080
7264,204102,200702,120,51000,8,"""3""",52080,52200
7264,200702,201702,60,51000,8,"""3""",52200,52260
7264,201702,200202,60,51000,8,"""3""",52260,52320
7264,200202,203102,60,51000,8,"""3""",52320,52380
7264,203102,203202,60,51000,8,"""3""",52380,52440
7264,203202,700502,60,51000,8,"""3""",52440,52500
7264,700502,202303,60,51000,8,"""3""",52500,52560
7264,202303,202702,60,51000,8,"""3""",52560,52620
7264,202702,700102,60,51000,8,"""3""",52620,52680
7264,700102,17702,60,51000,8,"""3""",52680,52740
7264,112105,103001,120,52200,8,"""3""",52200,52320
7264,103001,8001,120,52200,8,"""3""",52320,52440
7264,8001,105001,60,52200,8,"""3""",52440,52500
7264,105001,34103,60,52200,8,"""3""",52500,52560
7264,34103,208104,120,52200,8,"""3""",52560,52680
7264,208104,200102,120,52200,8,"""3""",52680,52800
7264,200102,208501,180,52200,8,"""3""",52800,52980
7264,208501,208004,120,52200,8,"""3""",52980,53100
7264,208004,203602,60,52200,8,"""3""",53100,53160
7264,203602,204102,120,52200,8,"""3""",53160,53280
7264,204102,200702,120,52200,8,"""3""",53280,53400
7264,200702,201702,60,52200,8,"""3""",53400,53460
7264,201702,200202,60,52200,8,"""3""",53460,53520
7264,200202,203102,60,52200,8,"""3""",53520,53580
7264,203102,203202,60,52200,8,"""3""",53580,53640
7264,203202,700502,60,52200,8,"""3""",53640,53700
7264,700502,202303,60,52200,8,"""3""",53700,53760
7264,202303,202702,60,52200,8,"""3""",53760,53820
7264,202702,700102,60,52200,8,"""3""",53820,53880
7264,700102,17702,60,52200,8,"""3""",53880,53940
7264,112105,103001,120,54600,8,"""3""",54600,54720
7264,103001,8001,120,54600,8,"""3""",54720,54840
7264,8001,105001,60,54600,8,"""3""",54840,54900
7264,105001,34103,60,54600,8,"""3""",54900,54960
7264,34103,208104,120,54600,8,"""3""",54960,55080
7264,208104,200102,120,54600,8,"""3""",55080,55200
7264,200102,208501,180,54600,8,"""3""",55200,55380
7264,208501,208004,120,54600,8,"""3""",55380,55500
7264,208004,203602,60,54600,8,"""3""",55500,55560
7264,203602,204102,120,54600,8,"""3""",55560,55680
7264,204102,200702,120,54600,8,"""3""",55680,55800
7264,200702,201702,60,54600,8,"""3""",55800,55860
7264,201702,200202,60,54600,8,"""3""",55860,55920
7264,200202,203102,60,54600,8,"""3""",55920,55980
7264,203102,203202,60,54600,8,"""3""",55980,56040
7264,203202,700502,60,54600,8,"""3""",56040,56100
7264,700502,202303,60,54600,8,"""3""",56100,56160
7264,202303,202702,60,54600,8,"""3""",56160,56220
7264,202702,700102,60,54600,8,"""3""",56220,56280
7264,700102,17702,60,54600,8,"""3""",56280,56340
7264,112105,103001,120,55800,8,"""3""",55800,55920
7264,103001,8001,120,55800,8,"""3""",55920,56040
7264,8001,105001,60,55800,8,"""3""",56040,56100
7264,105001,34103,60,55800,8,"""3""",56100,56160
7264,34103,208104,120,55800,8,"""3""",56160,56280
7264,208104,200102,120,55800,8,"""3""",56280,56400
7264,200102,208501,180,55800,8,"""3""",56400,56580
7264,208501,208004,120,55800,8,"""3""",56580,56700
7264,208004,203602,60,55800,8,"""3""",56700,56760
7264,203602,204102,120,55800,8,"""3""",56760,56880
7264,204102,200702,120,55800,8,"""3""",56880,57000
7264,200702,201702,60,55800,8,"""3""",57000,57060
7264,201702,200202,60,55800,8,"""3""",57060,57120
7264,200202,203102,60,55800,8,"""3""",57120,57180
7264,203102,203202,60,55800,8,"""3""",57180,57240
7264,203202,700502,60,55800,8,"""3""",57240,57300
7264,700502,202303,60,55800,8,"""3""",57300,57360
7264,202303,202702,60,55800,8,"""3""",57360,57420
7264,202702,700102,60,55800,8,"""3""",57420,57480
7264,700102,17702,60,55800,8,"""3""",57480,57540
7264,112105,103001,120,58200,8,"""3""",58200,58320
7264,103001,8001,120,58200,8,"""3""",58320,58440
7264,8001,105001,60,58200,8,"""3""",58440,58500
7264,105001,34103,60,58200,8,"""3""",58500,58560
7264,34103,208104,120,58200,8,"""3""",58560,58680
7264,208104,200102,120,58200,8,"""3""",58680,58800
7264,200102,208501,180,58200,8,"""3""",58800,58980
7264,208501,208004,120,58200,8,"""3""",58980,59100
7264,208004,203602,60,58200,8,"""3""",59100,59160
7264,203602,204102,120,58200,8,"""3""",59160,59280
7264,204102,200702,120,58200,8,"""3""",59280,59400
7264,200702,201702,60,58200,8,"""3""",59400,59460
7264,201702,200202,60,58200,8,"""3""",59460,59520
7264,200202,203102,60,58200,8,"""3""",59520,59580
7264,203102,203202,60,58200,8,"""3""",59580,59640
7264,203202,700502,60,58200,8,"""3""",59640,59700
7264,700502,202303,60,58200,8,"""3""",59700,59760
7264,202303,202702,60,58200,8,"""3""",59760,59820
7264,202702,700102,60,58200,8,"""3""",59820,59880
7264,700102,17702,60,58200,8,"""3""",59880,59940
7264,112105,103001,120,59400,8,"""3""",59400,59520
7264,103001,8001,120,59400,8,"""3""",59520,59640
7264,8001,105001,60,59400,8,"""3""",59640,59700
7264,105001,34103,60,59400,8,"""3""",59700,59760
7264,34103,208104,120,59400,8,"""3""",59760,59880
7264,208104,200102,120,59400,8,"""3""",59880,60000
7264,200102,208501,180,59400,8,"""3""",60000,60180
7264,208501,208004,120,59400,8,"""3""",60180,60300
7264,208004,203602,60,59400,8,"""3""",60300,60360
7264,203602,204102,120,59400,8,"""3""",60360,60480
7264,204102,200702,120,59400,8,"""3""",60480,60600
7264,200702,201702,60,59400,8,"""3""",60600,60660
7264,201702,200202,60,59400,8,"""3""",60660,60720
7264,200202,203102,60,59400,8,"""3""",60720,60780
7264,203102,203202,60,59400,8,"""3""",60780,60840
7264,203202,700502,60,59400,8,"""3""",60840,60900
7264,700502,202303,60,59400,8,"""3""",60900,60960
7264,202303,202702,60,59400,8,"""3""",60960,61020
7264,202702,700102,60,59400,8,"""3""",61020,61080
7264,700102,17702,60,59400,8,"""3""",61080,61140
7264,112105,103001,120,61800,8,"""3""",61800,61920
7264,103001,8001,120,61800,8,"""3""",61920,62040
7264,8001,105001,60,61800,8,"""3""",62040,62100
7264,105001,34103,60,61800,8,"""3""",62100,62160
7264,34103,208104,120,61800,8,"""3""",62160,62280
7264,208104,200102,120,61800,8,"""3""",62280,62400
7264,200102,208501,180,61800,8,"""3""",62400,62580
7264,208501,208004,120,61800,8,"""3""",62580,62700
7264,208004,203602,60,61800,8,"""3""",62700,62760
7264,203602,204102,120,61800,8,"""3""",62760,62880
7264,204102,200702,120,61800,8,"""3""",62880,63000
7264,200702,201702,60,61800,8,"""3""",63000,63060
7264,201702,200202,60,61800,8,"""3""",63060,63120
7264,200202,203102,60,61800,8,"""3""",63120,63180
7264,203102,203202,60,61800,8,"""3""",63180,63240
7264,203202,700502,60,61800,8,"""3""",63240,63300
7264,700502,202303,60,61800,8,"""3""",63300,63360
7264,202303,202702,60,61800,8,"""3""",63360,63420
7264,202702,700102,60,61800,8,"""3""",63420,63480
7264,700102,17702,60,61800,8,"""3""",63480,63540
7264,112105,103001,120,63000,8,"""3""",63000,63120
7264,103001,8001,120,63000,8,"""3""",63120,63240
7264,8001,105001,60,63000,8,"""3""",63240,63300
7264,105001,34103,60,63000,8,"""3""",63300,63360
7264,34103,208104,120,63000,8,"""3""",63360,63480
7264,208104,200102,120,63000,8,"""3""",63480,63600
7264,200102,208501,180,63000,8,"""3""",63600,63780
7264,208501,208004,120,63000,8,"""3""",63780,63900
7264,208004,203602,60,63000,8,"""3""",63900,63960
7264,203602,204102,120,63000,8,"""3""",63960,64080
7264,204102,200702,120,63000,8,"""3""",64080,64200
7264,200702,201702,60,63000,8,"""3""",64200,64260
7264,201702,200202,60,63000,8,"""3""",64260,64320
7264,200202,203102,60,63000,8,"""3""",64320,64380
7264,203102,203202,60,63000,8,"""3""",64380,64440
7264,203202,700502,60,63000,8,"""3""",64440,64500
7264,700502,202303,60,63000,8,"""3""",64500,64560
7264,202303,202702,60,63000,8,"""3""",64560,64620
7264,202702,700102,60,63000,8,"""3""",64620,64680
7264,700102,17702,60,63000,8,"""3""",64680,64740
7264,112105,103001,120,65400,8,"""3""",65400,65520
7264,103001,8001,120,65400,8,"""3""",65520,65640
7264,8001,105001,60,65400,8,"""3""",65640,65700
7264,105001,34103,60,65400,8,"""3""",65700,65760
7264,34103,208104,120,65400,8,"""3""",65760,65880
7264,208104,200102,120,65400,8,"""3""",65880,66000
7264,200102,208501,180,65400,8,"""3""",66000,66180
7264,208501,208004,120,65400,8,"""3""",66180,66300
7264,208004,203602,60,65400,8,"""3""",66300,66360
7264,203602,204102,120,65400,8,"""3""",66360,66480
7264,204102,200702,120,65400,8,"""3""",66480,66600
7264,200702,201702,60,65400,8,"""3""",66600,66660
7264,201702,200202,60,65400,8,"""3""",66660,66720
7264,200202,203102,60,65400,8,"""3""",66720,66780
7264,203102,203202,60,65400,8,"""3""",66780,66840
7264,203202,700502,60,65400,8,"""3""",66840,66900
7264,700502,202303,60,65400,8,"""3""",66900,66960
7264,202303,202702,60,65400,8,"""3""",66960,67020
7264,202702,700102,60,65400,8,"""3""",67020,67080
7264,700102,17702,60,65400,8,"""3""",67080,67140
7264,112105,103001,120,66600,8,"""3""",66600,66720
7264,103001,8001,120,66600,8,"""3""",66720,66840
7264,8001,105001,60,66600,8,"""3""",66840,66900
7264,105001,34103,60,66600,8,"""3""",66900,66960
7264,34103,208104,120,66600,8,"""3""",66960,67080
7264,208104,200102,120,66600,8,"""3""",67080,67200
7264,200102,208501,180,66600,8,"""3""",67200,67380
7264,208501,208004,120,66600,8,"""3""",67380,67500
7264,208004,203602,60,66600,8,"""3""",67500,67560
7264,203602,204102,120,66600,8,"""3""",67560,67680
7264,204102,200702,120,66600,8,"""3""",67680,67800
7264,200702,201702,60,66600,8,"""3""",67800,67860
7264,201702,200202,60,66600,8,"""3""",67860,67920
7264,200202,203102,60,66600,8,"""3""",67920,67980
7264,203102,203202,60,66600,8,"""3""",67980,68040
7264,203202,700502,60,66600,8,"""3""",68040,68100
7264,700502,202303,60,66600,8,"""3""",68100,68160
7264,202303,202702,60,66600,8,"""3""",68160,68220
7264,202702,700102,60,66600,8,"""3""",68220,68280
7264,700102,17702,60,66600,8,"""3""",68280,68340
7264,112105,103001,120,69000,8,"""3""",69000,69120
7264,103001,8001,120,69000,8,"""3""",69120,69240
7264,8001,105001,60,69000,8,"""3""",69240,69300
7264,105001,34103,60,69000,8,"""3""",69300,69360
7264,34103,208104,120,69000,8,"""3""",69360,69480
7264,208104,200102,120,69000,8,"""3""",69480,69600
7264,200102,208501,180,69000,8,"""3""",69600,69780
7264,208501,208004,120,69000,8,"""3""",69780,69900
7264,208004,203602,60,69000,8,"""3""",69900,69960
7264,203602,204102,120,69000,8,"""3""",69960,70080
7264,204102,200702,120,69000,8,"""3""",70080,70200
7264,200702,201702,60,69000,8,"""3""",70200,70260
7264,201702,200202,60,69000,8,"""3""",70260,70320
7264,200202,203102,60,69000,8,"""3""",70320,70380
7264,203102,203202,60,69000,8,"""3""",70380,70440
7264,203202,700502,60,69000,8,"""3""",70440,70500
7264,700502,202303,60,69000,8,"""3""",70500,70560
7264,202303,202702,60,69000,8,"""3""",70560,70620
7264,202702,700102,60,69000,8,"""3""",70620,70680
7264,700102,17702,60,69000,8,"""3""",70680,70740
7264,112105,103001,120,70200,8,"""3""",70200,70320
7264,103001,8001,120,70200,8,"""3""",70320,70440
7264,8001,105001,60,70200,8,"""3""",70440,70500
7264,105001,34103,60,70200,8,"""3""",70500,70560
7264,34103,208104,120,70200,8,"""3""",70560,70680
7264,208104,200102,120,70200,8,"""3""",70680,70800
7264,200102,208501,180,70200,8,"""3""",70800,70980
7264,208501,208004,120,70200,8,"""3""",70980,71100
7264,208004,203602,60,70200,8,"""3""",71100,71160
7264,203602,204102,120,70200,8,"""3""",71160,71280
7264,204102,200702,120,70200,8,"""3""",71280,71400
7264,200702,201702,60,70200,8,"""3""",71400,71460
7264,201702,200202,60,70200,8,"""3""",71460,71520
7264,200202,203102,60,70200,8,"""3""",71520,71580
7264,203102,203202,60,70200,8,"""3""",71580,71640
7264,203202,700502,60,70200,8,"""3""",71640,71700
7264,700502,202303,60,70200,8,"""3""",71700,71760
7264,202303,202702,60,70200,8,"""3""",71760,71820
7264,202702,700102,60,70200,8,"""3""",71820,71880
7264,700102,17702,60,70200,8,"""3""",71880,71940
7265,112105,103001,120,22200,8,"""3""",22200,22320
7265,103001,8001,120,22200,8,"""3""",22320,22440
7265,8001,105001,60,22200,8,"""3""",22440,22500
7265,105001,34103,60,22200,8,"""3""",22500,22560
7265,34103,208104,120,22200,8,"""3""",22560,22680
7265,208104,200102,60,22200,8,"""3""",22680,22740
7265,200102,208501,120,22200,8,"""3""",22740,22860
7265,208501,208004,120,22200,8,"""3""",22860,22980
7265,208004,203602,60,22200,8,"""3""",22980,23040
7265,203602,204102,120,22200,8,"""3""",23040,23160
7265,204102,200702,120,22200,8,"""3""",23160,23280
7265,200702,201702,60,22200,8,"""3""",23280,23340
7265,201702,200202,60,22200,8,"""3""",23340,23400
7265,200202,203102,60,22200,8,"""3""",23400,23460
7265,203102,203202,60,22200,8,"""3""",23460,23520
7265,203202,700502,60,22200,8,"""3""",23520,23580
7265,700502,202303,60,22200,8,"""3""",23580,23640
7265,202303,202702,60,22200,8,"""3""",23640,23700
7265,202702,700102,60,22200,8,"""3""",23700,23760
7265,700102,17702,60,22200,8,"""3""",23760,23820
7265,112105,103001,120,23400,8,"""3""",23400,23520
7265,103001,8001,120,23400,8,"""3""",23520,23640
7265,8001,105001,60,23400,8,"""3""",23640,23700
7265,105001,34103,60,23400,8,"""3""",23700,23760
7265,34103,208104,120,23400,8,"""3""",23760,23880
7265,208104,200102,60,23400,8,"""3""",23880,23940
7265,200102,208501,120,23400,8,"""3""",23940,24060
7265,208501,208004,120,23400,8,"""3""",24060,24180
7265,208004,203602,60,23400,8,"""3""",24180,24240
7265,203602,204102,120,23400,8,"""3""",24240,24360
7265,204102,200702,120,23400,8,"""3""",24360,24480
7265,200702,201702,60,23400,8,"""3""",24480,24540
7265,201702,200202,60,23400,8,"""3""",24540,24600
7265,200202,203102,60,23400,8,"""3""",24600,24660
7265,203102,203202,60,23400,8,"""3""",24660,24720
7265,203202,700502,60,23400,8,"""3""",24720,24780
7265,700502,202303,60,23400,8,"""3""",24780,24840
7265,202303,202702,60,23400,8,"""3""",24840,24900
7265,202702,700102,60,23400,8,"""3""",24900,24960
7265,700102,17702,60,23400,8,"""3""",24960,25020
7266,112105,103001,120,18900,8,"""3""",18900,19020
7266,103001,8001,120,18900,8,"""3""",19020,19140
7266,8001,105001,60,18900,8,"""3""",19140,19200
7266,105001,34103,60,18900,8,"""3""",19200,19260
7266,34103,208104,120,18900,8,"""3""",19260,19380
7266,208104,200102,60,18900,8,"""3""",19380,19440
7266,200102,208501,120,18900,8,"""3""",19440,19560
7266,208501,208004,60,18900,8,"""3""",19560,19620
7266,208004,203602,60,18900,8,"""3""",19620,19680
7266,203602,204102,120,18900,8,"""3""",19680,19800
7266,204102,200702,120,18900,8,"""3""",19800,19920
7266,200702,201702,60,18900,8,"""3""",19920,19980
7266,201702,200202,60,18900,8,"""3""",19980,20040
7266,200202,203102,60,18900,8,"""3""",20040,20100
7266,203102,203202,60,18900,8,"""3""",20100,20160
7266,203202,700502,60,18900,8,"""3""",20160,20220
7266,700502,202303,60,18900,8,"""3""",20220,20280
7266,202303,202702,60,18900,8,"""3""",20280,20340
7266,202702,700102,60,18900,8,"""3""",20340,20400
7266,700102,17702,60,18900,8,"""3""",20400,20460
7266,112105,103001,120,20700,8,"""3""",20700,20820
7266,103001,8001,120,20700,8,"""3""",20820,20940
7266,8001,105001,60,20700,8,"""3""",20940,21000
7266,105001,34103,60,20700,8,"""3""",21000,21060
7266,34103,208104,120,20700,8,"""3""",21060,21180
7266,208104,200102,60,20700,8,"""3""",21180,21240
7266,200102,208501,120,20700,8,"""3""",21240,21360
7266,208501,208004,60,20700,8,"""3""",21360,21420
7266,208004,203602,60,20700,8,"""3""",21420,21480
7266,203602,204102,120,20700,8,"""3""",21480,21600
7266,204102,200702,120,20700,8,"""3""",21600,21720
7266,200702,201702,60,20700,8,"""3""",21720,21780
7266,201702,200202,60,20700,8,"""3""",21780,21840
7266,200202,203102,60,20700,8,"""3""",21840,21900
7266,203102,203202,60,20700,8,"""3""",21900,21960
7266,203202,700502,60,20700,8,"""3""",21960,22020
7266,700502,202303,60,20700,8,"""3""",22020,22080
7266,202303,202702,60,20700,8,"""3""",22080,22140
7266,202702,700102,60,20700,8,"""3""",22140,22200
7266,700102,17702,60,20700,8,"""3""",22200,22260
7267,112105,103001,120,72900,8,"""3""",72900,73020
7267,103001,8001,120,72900,8,"""3""",73020,73140
7267,8001,105001,60,72900,8,"""3""",73140,73200
7267,105001,34103,60,72900,8,"""3""",73200,73260
7267,34103,208104,120,72900,8,"""3""",73260,73380
7267,208104,200102,60,72900,8,"""3""",73380,73440
7267,200102,208501,60,72900,8,"""3""",73440,73500
7267,208501,208004,60,72900,8,"""3""",73500,73560
7267,208004,203602,60,72900,8,"""3""",73560,73620
7267,203602,204102,60,72900,8,"""3""",73620,73680
7267,204102,200702,120,72900,8,"""3""",73680,73800
7267,200702,201702,60,72900,8,"""3""",73800,73860
7267,201702,200202,60,72900,8,"""3""",73860,73920
7267,200202,203102,60,72900,8,"""3""",73920,73980
7267,203102,203202,60,72900,8,"""3""",73980,74040
7267,203202,700502,60,72900,8,"""3""",74040,74100
7267,700502,202303,60,72900,8,"""3""",74100,74160
7267,202303,202702,60,72900,8,"""3""",74160,74220
7267,202702,700102,60,72900,8,"""3""",74220,74280
7267,700102,17702,60,72900,8,"""3""",74280,74340
7268,17701,700101,60,25860,8,"""6""",25860,25920
7268,700101,202701,60,25860,8,"""6""",25920,25980
7268,202701,202302,60,25860,8,"""6""",25980,26040
7268,202302,700501,60,25860,8,"""6""",26040,26100
7268,700501,203201,60,25860,8,"""6""",26100,26160
7268,203201,203101,60,25860,8,"""6""",26160,26220
7268,203101,200201,60,25860,8,"""6""",26220,26280
7268,200201,201701,60,25860,8,"""6""",26280,26340
7268,201701,200701,60,25860,8,"""6""",26340,26400
7268,200701,204103,120,25860,8,"""6""",26400,26520
7268,204103,203605,60,25860,8,"""6""",26520,26580
7268,203605,208005,60,25860,8,"""6""",26580,26640
7268,208005,208502,60,25860,8,"""6""",26640,26700
7268,208502,200101,120,25860,8,"""6""",26700,26820
7268,200101,202401,60,25860,8,"""6""",26820,26880
7268,202401,208103,60,25860,8,"""6""",26880,26940
7268,208103,34104,60,25860,8,"""6""",26940,27000
7268,34104,105002,60,25860,8,"""6""",27000,27060
7268,105002,8002,60,25860,8,"""6""",27060,27120
7268,8002,103005,120,25860,8,"""6""",27120,27240
7268,103005,112105,120,25860,8,"""6""",27240,27360
7268,112105,101104,240,25860,8,"""6""",27360,27600
7269,83901,17701,120,73740,8,"""2""",73740,73860
7269,17701,700101,60,73740,8,"""2""",73860,73920
7269,700101,202701,60,73740,8,"""2""",73920,73980
7269,202701,202302,60,73740,8,"""2""",73980,74040
7269,202302,700501,60,73740,8,"""2""",74040,74100
7269,700501,203201,60,73740,8,"""2""",74100,74160
7269,203201,203101,60,73740,8,"""2""",74160,74220
7269,203101,200201,60,73740,8,"""2""",74220,74280
7269,200201,201701,60,73740,8,"""2""",74280,74340
7269,201701,200701,60,73740,8,"""2""",74340,74400
7269,200701,204103,120,73740,8,"""2""",74400,74520
7269,204103,203605,60,73740,8,"""2""",74520,74580
7269,203605,208005,60,73740,8,"""2""",74580,74640
7269,208005,208502,60,73740,8,"""2""",74640,74700
7269,208502,200101,120,73740,8,"""2""",74700,74820
7269,200101,202401,60,73740,8,"""2""",74820,74880
7269,202401,208103,60,73740,8,"""2""",74880,74940
7269,208103,34104,60,73740,8,"""2""",74940,75000
7269,34104,105002,60,73740,8,"""2""",75000,75060
7269,105002,8002,60,73740,8,"""2""",75060,75120
7269,8002,103005,120,73740,8,"""2""",75120,75240
7269,103005,112105,180,73740,8,"""2""",75240,75420
7269,83901,17701,120,77340,8,"""2""",77340,77460
7269,17701,700101,60,77340,8,"""2""",77460,77520
7269,700101,202701,60,77340,8,"""2""",77520,77580
7269,202701,202302,60,77340,8,"""2""",77580,77640
7269,202302,700501,60,77340,8,"""2""",77640,77700
7269,700501,203201,60,77340,8,"""2""",77700,77760
7269,203201,203101,60,77340,8,"""2""",77760,77820
7269,203101,200201,60,77340,8,"""2""",77820,77880
7269,200201,201701,60,77340,8,"""2""",77880,77940
7269,201701,200701,60,77340,8,"""2""",77940,78000
7269,200701,204103,120,77340,8,"""2""",78000,78120
7269,204103,203605,60,77340,8,"""2""",78120,78180
7269,203605,208005,60,77340,8,"""2""",78180,78240
7269,208005,208502,60,77340,8,"""2""",78240,78300
7269,208502,200101,120,77340,8,"""2""",78300,78420
7269,200101,202401,60,77340,8,"""2""",78420,78480
7269,202401,208103,60,77340,8,"""2""",78480,78540
7269,208103,34104,60,77340,8,"""2""",78540,78600
7269,34104,105002,60,77340,8,"""2""",78600,78660
7269,105002,8002,60,77340,8,"""2""",78660,78720
7269,8002,103005,120,77340,8,"""2""",78720,78840
7269,103005,112105,180,77340,8,"""2""",78840,79020
7269,83901,17701,120,80940,8,"""2""",80940,81060
7269,17701,700101,60,80940,8,"""2""",81060,81120
7269,700101,202701,60,80940,8,"""2""",81120,81180
7269,202701,202302,60,80940,8,"""2""",81180,81240
7269,202302,700501,60,80940,8,"""2""",81240,81300
7269,700501,203201,60,80940,8,"""2""",81300,81360
7269,203201,203101,60,80940,8,"""2""",81360,81420
7269,203101,200201,60,80940,8,"""2""",81420,81480
7269,200201,201701,60,80940,8,"""2""",81480,81540
7269,201701,200701,60,80940,8,"""2""",81540,81600
7269,200701,204103,120,80940,8,"""2""",81600,81720
7269,204103,203605,60,80940,8,"""2""",81720,81780
7269,203605,208005,60,80940,8,"""2""",81780,81840
7269,208005,208502,60,80940,8,"""2""",81840,81900
7269,208502,200101,120,80940,8,"""2""",81900,82020
7269,200101,202401,60,80940,8,"""2""",82020,82080
7269,202401,208103,60,80940,8,"""2""",82080,82140
7269,208103,34104,60,80940,8,"""2""",82140,82200
7269,34104,105002,60,80940,8,"""2""",82200,82260
7269,105002,8002,60,80940,8,"""2""",82260,82320
7269,8002,103005,120,80940,8,"""2""",82320,82440
7269,103005,112105,180,80940,8,"""2""",82440,82620
7269,83901,17701,120,84540,8,"""2""",84540,84660
7269,17701,700101,60,84540,8,"""2""",84660,84720
7269,700101,202701,60,84540,8,"""2""",84720,84780
7269,202701,202302,60,84540,8,"""2""",84780,84840
7269,202302,700501,60,84540,8,"""2""",84840,84900
7269,700501,203201,60,84540,8,"""2""",84900,84960
7269,203201,203101,60,84540,8,"""2""",84960,85020
7269,203101,200201,60,84540,8,"""2""",85020,85080
7269,200201,201701,60,84540,8,"""2""",85080,85140
7269,201701,200701,60,84540,8,"""2""",85140,85200
7269,200701,204103,120,84540,8,"""2""",85200,85320
7269,204103,203605,60,84540,8,"""2""",85320,85380
7269,203605,208005,60,84540,8,"""2""",85380,85440
7269,208005,208502,60,84540,8,"""2""",85440,85500
7269,208502,200101,120,84540,8,"""2""",85500,85620
7269,200101,202401,60,84540,8,"""2""",85620,85680
7269,202401,208103,60,84540,8,"""2""",85680,85740
7269,208103,34104,60,84540,8,"""2""",85740,85800
7269,34104,105002,60,84540,8,"""2""",85800,85860
7269,105002,8002,60,84540,8,"""2""",85860,85920
7269,8002,103005,120,84540,8,"""2""",85920,86040
7269,103005,112105,180,84540,8,"""2""",86040,86220
7270,83901,17701,120,26940,8,"""2""",26940,27060
7270,17701,700101,60,26940,8,"""2""",27060,27120
7270,700101,202701,60,26940,8,"""2""",27120,27180
7270,202701,202302,60,26940,8,"""2""",27180,27240
7270,202302,700501,60,26940,8,"""2""",27240,27300
7270,700501,203201,60,26940,8,"""2""",27300,27360
7270,203201,203101,60,26940,8,"""2""",27360,27420
7270,203101,200201,60,26940,8,"""2""",27420,27480
7270,200201,201701,60,26940,8,"""2""",27480,27540
7270,201701,200701,60,26940,8,"""2""",27540,27600
7270,200701,204103,120,26940,8,"""2""",27600,27720
7270,204103,203605,60,26940,8,"""2""",27720,27780
7270,203605,208005,60,26940,8,"""2""",27780,27840
7270,208005,208502,60,26940,8,"""2""",27840,27900
7270,208502,200101,120,26940,8,"""2""",27900,28020
7270,200101,202401,60,26940,8,"""2""",28020,28080
7270,202401,208103,60,26940,8,"""2""",28080,28140
7270,208103,34104,60,26940,8,"""2""",28140,28200
7270,34104,105002,60,26940,8,"""2""",28200,28260
7270,105002,8002,60,26940,8,"""2""",28260,28320
7270,8002,103005,120,26940,8,"""2""",28320,28440
7270,103005,112105,120,26940,8,"""2""",28440,28560
7270,83901,17701,120,30540,8,"""2""",30540,30660
7270,17701,700101,60,30540,8,"""2""",30660,30720
7270,700101,202701,60,30540,8,"""2""",30720,30780
7270,202701,202302,60,30540,8,"""2""",30780,30840
7270,202302,700501,60,30540,8,"""2""",30840,30900
7270,700501,203201,60,30540,8,"""2""",30900,30960
7270,203201,203101,60,30540,8,"""2""",30960,31020
7270,203101,200201,60,30540,8,"""2""",31020,31080
7270,200201,201701,60,30540,8,"""2""",31080,31140
7270,201701,200701,60,30540,8,"""2""",31140,31200
7270,200701,204103,120,30540,8,"""2""",31200,31320
7270,204103,203605,60,30540,8,"""2""",31320,31380
7270,203605,208005,60,30540,8,"""2""",31380,31440
7270,208005,208502,60,30540,8,"""2""",31440,31500
7270,208502,200101,120,30540,8,"""2""",31500,31620
7270,200101,202401,60,30540,8,"""2""",31620,31680
7270,202401,208103,60,30540,8,"""2""",31680,31740
7270,208103,34104,60,30540,8,"""2""",31740,31800
7270,34104,105002,60,30540,8,"""2""",31800,31860
7270,105002,8002,60,30540,8,"""2""",31860,31920
7270,8002,103005,120,30540,8,"""2""",31920,32040
7270,103005,112105,120,30540,8,"""2""",32040,32160
7270,83901,17701,120,34140,8,"""2""",34140,34260
7270,17701,700101,60,34140,8,"""2""",34260,34320
7270,700101,202701,60,34140,8,"""2""",34320,34380
7270,202701,202302,60,34140,8,"""2""",34380,34440
7270,202302,700501,60,34140,8,"""2""",34440,34500
7270,700501,203201,60,34140,8,"""2""",34500,34560
7270,203201,203101,60,34140,8,"""2""",34560,34620
7270,203101,200201,60,34140,8,"""2""",34620,34680
7270,200201,201701,60,34140,8,"""2""",34680,34740
7270,201701,200701,60,34140,8,"""2""",34740,34800
7270,200701,204103,120,34140,8,"""2""",34800,34920
7270,204103,203605,60,34140,8,"""2""",34920,34980
7270,203605,208005,60,34140,8,"""2""",34980,35040
7270,208005,208502,60,34140,8,"""2""",35040,35100
7270,208502,200101,120,34140,8,"""2""",35100,35220
7270,200101,202401,60,34140,8,"""2""",35220,35280
7270,202401,208103,60,34140,8,"""2""",35280,35340
7270,208103,34104,60,34140,8,"""2""",35340,35400
7270,34104,105002,60,34140,8,"""2""",35400,35460
7270,105002,8002,60,34140,8,"""2""",35460,35520
7270,8002,103005,120,34140,8,"""2""",35520,35640
7270,103005,112105,120,34140,8,"""2""",35640,35760
7270,83901,17701,120,37740,8,"""2""",37740,37860
7270,17701,700101,60,37740,8,"""2""",37860,37920
7270,700101,202701,60,37740,8,"""2""",37920,37980
7270,202701,202302,60,37740,8,"""2""",37980,38040
7270,202302,700501,60,37740,8,"""2""",38040,38100
7270,700501,203201,60,37740,8,"""2""",38100,38160
7270,203201,203101,60,37740,8,"""2""",38160,38220
7270,203101,200201,60,37740,8,"""2""",38220,38280
7270,200201,201701,60,37740,8,"""2""",38280,38340
7270,201701,200701,60,37740,8,"""2""",38340,38400
7270,200701,204103,120,37740,8,"""2""",38400,38520
7270,204103,203605,60,37740,8,"""2""",38520,38580
7270,203605,208005,60,37740,8,"""2""",38580,38640
7270,208005,208502,60,37740,8,"""2""",38640,38700
7270,208502,200101,120,37740,8,"""2""",38700,38820
7270,200101,202401,60,37740,8,"""2""",38820,38880
7270,202401,208103,60,37740,8,"""2""",38880,38940
7270,208103,34104,60,37740,8,"""2""",38940,39000
7270,34104,105002,60,37740,8,"""2""",39000,39060
7270,105002,8002,60,37740,8,"""2""",39060,39120
7270,8002,103005,120,37740,8,"""2""",39120,39240
7270,103005,112105,120,37740,8,"""2""",39240,39360
7270,83901,17701,120,41340,8,"""2""",41340,41460
7270,17701,700101,60,41340,8,"""2""",41460,41520
7270,700101,202701,60,41340,8,"""2""",41520,41580
7270,202701,202302,60,41340,8,"""2""",41580,41640
7270,202302,700501,60,41340,8,"""2""",41640,41700
7270,700501,203201,60,41340,8,"""2""",41700,41760
7270,203201,203101,60,41340,8,"""2""",41760,41820
7270,203101,200201,60,41340,8,"""2""",41820,41880
7270,200201,201701,60,41340,8,"""2""",41880,41940
7270,201701,200701,60,41340,8,"""2""",41940,42000
7270,200701,204103,120,41340,8,"""2""",42000,42120
7270,204103,203605,60,41340,8,"""2""",42120,42180
7270,203605,208005,60,41340,8,"""2""",42180,42240
7270,208005,208502,60,41340,8,"""2""",42240,42300
7270,208502,200101,120,41340,8,"""2""",42300,42420
7270,200101,202401,60,41340,8,"""2""",42420,42480
7270,202401,208103,60,41340,8,"""2""",42480,42540
7270,208103,34104,60,41340,8,"""2""",42540,42600
7270,34104,105002,60,41340,8,"""2""",42600,42660
7270,105002,8002,60,41340,8,"""2""",42660,42720
7270,8002,103005,120,41340,8,"""2""",42720,42840
7270,103005,112105,120,41340,8,"""2""",42840,42960
7270,83901,17701,120,44940,8,"""2""",44940,45060
7270,17701,700101,60,44940,8,"""2""",45060,45120
7270,700101,202701,60,44940,8,"""2""",45120,45180
7270,202701,202302,60,44940,8,"""2""",45180,45240
7270,202302,700501,60,44940,8,"""2""",45240,45300
7270,700501,203201,60,44940,8,"""2""",45300,45360
7270,203201,203101,60,44940,8,"""2""",45360,45420
7270,203101,200201,60,44940,8,"""2""",45420,45480
7270,200201,201701,60,44940,8,"""2""",45480,45540
7270,201701,200701,60,44940,8,"""2""",45540,45600
7270,200701,204103,120,44940,8,"""2""",45600,45720
7270,204103,203605,60,44940,8,"""2""",45720,45780
7270,203605,208005,60,44940,8,"""2""",45780,45840
7270,208005,208502,60,44940,8,"""2""",45840,45900
7270,208502,200101,120,44940,8,"""2""",45900,46020
7270,200101,202401,60,44940,8,"""2""",46020,46080
7270,202401,208103,60,44940,8,"""2""",46080,46140
7270,208103,34104,60,44940,8,"""2""",46140,46200
7270,34104,105002,60,44940,8,"""2""",46200,46260
7270,105002,8002,60,44940,8,"""2""",46260,46320
7270,8002,103005,120,44940,8,"""2""",46320,46440
7270,103005,112105,120,44940,8,"""2""",46440,46560
7270,83901,17701,120,48540,8,"""2""",48540,48660
7270,17701,700101,60,48540,8,"""2""",48660,48720
7270,700101,202701,60,48540,8,"""2""",48720,48780
7270,202701,202302,60,48540,8,"""2""",48780,48840
7270,202302,700501,60,48540,8,"""2""",48840,48900
7270,700501,203201,60,48540,8,"""2""",48900,48960
7270,203201,203101,60,48540,8,"""2""",48960,49020
7270,203101,200201,60,48540,8,"""2""",49020,49080
7270,200201,201701,60,48540,8,"""2""",49080,49140
7270,201701,200701,60,48540,8,"""2""",49140,49200
7270,200701,204103,120,48540,8,"""2""",49200,49320
7270,204103,203605,60,48540,8,"""2""",49320,49380
7270,203605,208005,60,48540,8,"""2""",49380,49440
7270,208005,208502,60,48540,8,"""2""",49440,49500
7270,208502,200101,120,48540,8,"""2""",49500,49620
7270,200101,202401,60,48540,8,"""2""",49620,49680
7270,202401,208103,60,48540,8,"""2""",49680,49740
7270,208103,34104,60,48540,8,"""2""",49740,49800
7270,34104,105002,60,48540,8,"""2""",49800,49860
7270,105002,8002,60,48540,8,"""2""",49860,49920
7270,8002,103005,120,48540,8,"""2""",49920,50040
7270,103005,112105,120,48540,8,"""2""",50040,50160
7270,83901,17701,120,52140,8,"""2""",52140,52260
7270,17701,700101,60,52140,8,"""2""",52260,52320
7270,700101,202701,60,52140,8,"""2""",52320,52380
7270,202701,202302,60,52140,8,"""2""",52380,52440
7270,202302,700501,60,52140,8,"""2""",52440,52500
7270,700501,203201,60,52140,8,"""2""",52500,52560
7270,203201,203101,60,52140,8,"""2""",52560,52620
7270,203101,200201,60,52140,8,"""2""",52620,52680
7270,200201,201701,60,52140,8,"""2""",52680,52740
7270,201701,200701,60,52140,8,"""2""",52740,52800
7270,200701,204103,120,52140,8,"""2""",52800,52920
7270,204103,203605,60,52140,8,"""2""",52920,52980
7270,203605,208005,60,52140,8,"""2""",52980,53040
7270,208005,208502,60,52140,8,"""2""",53040,53100
7270,208502,200101,120,52140,8,"""2""",53100,53220
7270,200101,202401,60,52140,8,"""2""",53220,53280
7270,202401,208103,60,52140,8,"""2""",53280,53340
7270,208103,34104,60,52140,8,"""2""",53340,53400
7270,34104,105002,60,52140,8,"""2""",53400,53460
7270,105002,8002,60,52140,8,"""2""",53460,53520
7270,8002,103005,120,52140,8,"""2""",53520,53640
7270,103005,112105,120,52140,8,"""2""",53640,53760
7270,83901,17701,120,55740,8,"""2""",55740,55860
7270,17701,700101,60,55740,8,"""2""",55860,55920
7270,700101,202701,60,55740,8,"""2""",55920,55980
7270,202701,202302,60,55740,8,"""2""",55980,56040
7270,202302,700501,60,55740,8,"""2""",56040,56100
7270,700501,203201,60,55740,8,"""2""",56100,56160
7270,203201,203101,60,55740,8,"""2""",56160,56220
7270,203101,200201,60,55740,8,"""2""",56220,56280
7270,200201,201701,60,55740,8,"""2""",56280,56340
7270,201701,200701,60,55740,8,"""2""",56340,56400
7270,200701,204103,120,55740,8,"""2""",56400,56520
7270,204103,203605,60,55740,8,"""2""",56520,56580
7270,203605,208005,60,55740,8,"""2""",56580,56640
7270,208005,208502,60,55740,8,"""2""",56640,56700
7270,208502,200101,120,55740,8,"""2""",56700,56820
7270,200101,202401,60,55740,8,"""2""",56820,56880
7270,202401,208103,60,55740,8,"""2""",56880,56940
7270,208103,34104,60,55740,8,"""2""",56940,57000
7270,34104,105002,60,55740,8,"""2""",57000,57060
7270,105002,8002,60,55740,8,"""2""",57060,57120
7270,8002,103005,120,55740,8,"""2""",57120,57240
7270,103005,112105,120,55740,8,"""2""",57240,57360
7270,83901,17701,120,59340,8,"""2""",59340,59460
7270,17701,700101,60,59340,8,"""2""",59460,59520
7270,700101,202701,60,59340,8,"""2""",59520,59580
7270,202701,202302,60,59340,8,"""2""",59580,59640
7270,202302,700501,60,59340,8,"""2""",59640,59700
7270,700501,203201,60,59340,8,"""2""",59700,59760
7270,203201,203101,60,59340,8,"""2""",59760,59820
7270,203101,200201,60,59340,8,"""2""",59820,59880
7270,200201,201701,60,59340,8,"""2""",59880,59940
7270,201701,200701,60,59340,8,"""2""",59940,60000
7270,200701,204103,120,59340,8,"""2""",60000,60120
7270,204103,203605,60,59340,8,"""2""",60120,60180
7270,203605,208005,60,59340,8,"""2""",60180,60240
7270,208005,208502,60,59340,8,"""2""",60240,60300
7270,208502,200101,120,59340,8,"""2""",60300,60420
7270,200101,202401,60,59340,8,"""2""",60420,60480
7270,202401,208103,60,59340,8,"""2""",60480,60540
7270,208103,34104,60,59340,8,"""2""",60540,60600
7270,34104,105002,60,59340,8,"""2""",60600,60660
7270,105002,8002,60,59340,8,"""2""",60660,60720
7270,8002,103005,120,59340,8,"""2""",60720,60840
7270,103005,112105,120,59340,8,"""2""",60840,60960
7270,83901,17701,120,62940,8,"""2""",62940,63060
7270,17701,700101,60,62940,8,"""2""",63060,63120
7270,700101,202701,60,62940,8,"""2""",63120,63180
7270,202701,202302,60,62940,8,"""2""",63180,63240
7270,202302,700501,60,62940,8,"""2""",63240,63300
7270,700501,203201,60,62940,8,"""2""",63300,63360
7270,203201,203101,60,62940,8,"""2""",63360,63420
7270,203101,200201,60,62940,8,"""2""",63420,63480
7270,200201,201701,60,62940,8,"""2""",63480,63540
7270,201701,200701,60,62940,8,"""2""",63540,63600
7270,200701,204103,120,62940,8,"""2""",63600,63720
7270,204103,203605,60,62940,8,"""2""",63720,63780
7270,203605,208005,60,62940,8,"""2""",63780,63840
7270,208005,208502,60,62940,8,"""2""",63840,63900
7270,208502,200101,120,62940,8,"""2""",63900,64020
7270,200101,202401,60,62940,8,"""2""",64020,64080
7270,202401,208103,60,62940,8,"""2""",64080,64140
7270,208103,34104,60,62940,8,"""2""",64140,64200
7270,34104,105002,60,62940,8,"""2""",64200,64260
7270,105002,8002,60,62940,8,"""2""",64260,64320
7270,8002,103005,120,62940,8,"""2""",64320,64440
7270,103005,112105,120,62940,8,"""2""",64440,64560
7270,83901,17701,120,66540,8,"""2""",66540,66660
7270,17701,700101,60,66540,8,"""2""",66660,66720
7270,700101,202701,60,66540,8,"""2""",66720,66780
7270,202701,202302,60,66540,8,"""2""",66780,66840
7270,202302,700501,60,66540,8,"""2""",66840,66900
7270,700501,203201,60,66540,8,"""2""",66900,66960
7270,203201,203101,60,66540,8,"""2""",66960,67020
7270,203101,200201,60,66540,8,"""2""",67020,67080
7270,200201,201701,60,66540,8,"""2""",67080,67140
7270,201701,200701,60,66540,8,"""2""",67140,67200
7270,200701,204103,120,66540,8,"""2""",67200,67320
7270,204103,203605,60,66540,8,"""2""",67320,67380
7270,203605,208005,60,66540,8,"""2""",67380,67440
7270,208005,208502,60,66540,8,"""2""",67440,67500
7270,208502,200101,120,66540,8,"""2""",67500,67620
7270,200101,202401,60,66540,8,"""2""",67620,67680
7270,202401,208103,60,66540,8,"""2""",67680,67740
7270,208103,34104,60,66540,8,"""2""",67740,67800
7270,34104,105002,60,66540,8,"""2""",67800,67860
7270,105002,8002,60,66540,8,"""2""",67860,67920
7270,8002,103005,120,66540,8,"""2""",67920,68040
7270,103005,112105,120,66540,8,"""2""",68040,68160
7270,83901,17701,120,69360,8,"""2""",69360,69480
7270,17701,700101,60,69360,8,"""2""",69480,69540
7270,700101,202701,60,69360,8,"""2""",69540,69600
7270,202701,202302,60,69360,8,"""2""",69600,69660
7270,202302,700501,60,69360,8,"""2""",69660,69720
7270,700501,203201,60,69360,8,"""2""",69720,69780
7270,203201,203101,60,69360,8,"""2""",69780,69840
7270,203101,200201,60,69360,8,"""2""",69840,69900
7270,200201,201701,60,69360,8,"""2""",69900,69960
7270,201701,200701,60,69360,8,"""2""",69960,70020
7270,200701,204103,120,69360,8,"""2""",70020,70140
7270,204103,203605,60,69360,8,"""2""",70140,70200
7270,203605,208005,60,69360,8,"""2""",70200,70260
7270,208005,208502,60,69360,8,"""2""",70260,70320
7270,208502,200101,120,69360,8,"""2""",70320,70440
7270,200101,202401,60,69360,8,"""2""",70440,70500
7270,202401,208103,60,69360,8,"""2""",70500,70560
7270,208103,34104,60,69360,8,"""2""",70560,70620
7270,34104,105002,60,69360,8,"""2""",70620,70680
7270,105002,8002,60,69360,8,"""2""",70680,70740
7270,8002,103005,120,69360,8,"""2""",70740,70860
7270,103005,112105,120,69360,8,"""2""",70860,70980
7271,17701,700101,60,71160,8,"""4""",71160,71220
7271,700101,202701,60,71160,8,"""4""",71220,71280
7271,202701,202302,60,71160,8,"""4""",71280,71340
7271,202302,700501,60,71160,8,"""4""",71340,71400
7271,700501,203201,60,71160,8,"""4""",71400,71460
7271,203201,203101,60,71160,8,"""4""",71460,71520
7271,203101,200201,60,71160,8,"""4""",71520,71580
7271,200201,201701,60,71160,8,"""4""",71580,71640
7271,201701,200701,60,71160,8,"""4""",71640,71700
7271,200701,204103,120,71160,8,"""4""",71700,71820
7271,204103,203605,60,71160,8,"""4""",71820,71880
7271,203605,208005,60,71160,8,"""4""",71880,71940
7271,208005,208502,60,71160,8,"""4""",71940,72000
7271,208502,200101,120,71160,8,"""4""",72000,72120
7271,200101,202401,60,71160,8,"""4""",72120,72180
7271,202401,208103,60,71160,8,"""4""",72180,72240
7271,208103,34104,60,71160,8,"""4""",72240,72300
7271,34104,105002,60,71160,8,"""4""",72300,72360
7271,105002,8002,60,71160,8,"""4""",72360,72420
7271,8002,103005,120,71160,8,"""4""",72420,72540
7271,103005,112105,180,71160,8,"""4""",72540,72720
7272,17701,700101,60,21240,8,"""4""",21240,21300
7272,700101,202701,60,21240,8,"""4""",21300,21360
7272,202701,202302,60,21240,8,"""4""",21360,21420
7272,202302,700501,60,21240,8,"""4""",21420,21480
7272,700501,203201,60,21240,8,"""4""",21480,21540
7272,203201,203101,60,21240,8,"""4""",21540,21600
7272,203101,200201,60,21240,8,"""4""",21600,21660
7272,200201,201701,60,21240,8,"""4""",21660,21720
7272,201701,200701,60,21240,8,"""4""",21720,21780
7272,200701,204103,120,21240,8,"""4""",21780,21900
7272,204103,203605,60,21240,8,"""4""",21900,21960
7272,203605,208005,60,21240,8,"""4""",21960,22020
7272,208005,208502,60,21240,8,"""4""",22020,22080
7272,208502,200101,120,21240,8,"""4""",22080,22200
7272,200101,202401,60,21240,8,"""4""",22200,22260
7272,202401,208103,60,21240,8,"""4""",22260,22320
7272,208103,34104,60,21240,8,"""4""",22320,22380
7272,34104,105002,60,21240,8,"""4""",22380,22440
7272,105002,8002,60,21240,8,"""4""",22440,22500
7272,8002,103005,120,21240,8,"""4""",22500,22620
7272,103005,112105,120,21240,8,"""4""",22620,22740
7272,17701,700101,60,22260,8,"""4""",22260,22320
7272,700101,202701,60,22260,8,"""4""",22320,22380
7272,202701,202302,60,22260,8,"""4""",22380,22440
7272,202302,700501,60,22260,8,"""4""",22440,22500
7272,700501,203201,60,22260,8,"""4""",22500,22560
7272,203201,203101,60,22260,8,"""4""",22560,22620
7272,203101,200201,60,22260,8,"""4""",22620,22680
7272,200201,201701,60,22260,8,"""4""",22680,22740
7272,201701,200701,60,22260,8,"""4""",22740,22800
7272,200701,204103,120,22260,8,"""4""",22800,22920
7272,204103,203605,60,22260,8,"""4""",22920,22980
7272,203605,208005,60,22260,8,"""4""",22980,23040
7272,208005,208502,60,22260,8,"""4""",23040,23100
7272,208502,200101,120,22260,8,"""4""",23100,23220
7272,200101,202401,60,22260,8,"""4""",23220,23280
7272,202401,208103,60,22260,8,"""4""",23280,23340
7272,208103,34104,60,22260,8,"""4""",23340,23400
7272,34104,105002,60,22260,8,"""4""",23400,23460
7272,105002,8002,60,22260,8,"""4""",23460,23520
7272,8002,103005,120,22260,8,"""4""",23520,23640
7272,103005,112105,120,22260,8,"""4""",23640,23760
7272,17701,700101,60,23460,8,"""4""",23460,23520
7272,700101,202701,60,23460,8,"""4""",23520,23580
7272,202701,202302,60,23460,8,"""4""",23580,23640
7272,202302,700501,60,23460,8,"""4""",23640,23700
7272,700501,203201,60,23460,8,"""4""",23700,23760
7272,203201,203101,60,23460,8,"""4""",23760,23820
7272,203101,200201,60,23460,8,"""4""",23820,23880
7272,200201,201701,60,23460,8,"""4""",23880,23940
7272,201701,200701,60,23460,8,"""4""",23940,24000
7272,200701,204103,120,23460,8,"""4""",24000,24120
7272,204103,203605,60,23460,8,"""4""",24120,24180
7272,203605,208005,60,23460,8,"""4""",24180,24240
7272,208005,208502,60,23460,8,"""4""",24240,24300
7272,208502,200101,120,23460,8,"""4""",24300,24420
7272,200101,202401,60,23460,8,"""4""",24420,24480
7272,202401,208103,60,23460,8,"""4""",24480,24540
7272,208103,34104,60,23460,8,"""4""",24540,24600
7272,34104,105002,60,23460,8,"""4""",24600,24660
7272,105002,8002,60,23460,8,"""4""",24660,24720
7272,8002,103005,120,23460,8,"""4""",24720,24840
7272,103005,112105,120,23460,8,"""4""",24840,24960
7272,17701,700101,60,24660,8,"""4""",24660,24720
7272,700101,202701,60,24660,8,"""4""",24720,24780
7272,202701,202302,60,24660,8,"""4""",24780,24840
7272,202302,700501,60,24660,8,"""4""",24840,24900
7272,700501,203201,60,24660,8,"""4""",24900,24960
7272,203201,203101,60,24660,8,"""4""",24960,25020
7272,203101,200201,60,24660,8,"""4""",25020,25080
7272,200201,201701,60,24660,8,"""4""",25080,25140
7272,201701,200701,60,24660,8,"""4""",25140,25200
7272,200701,204103,120,24660,8,"""4""",25200,25320
7272,204103,203605,60,24660,8,"""4""",25320,25380
7272,203605,208005,60,24660,8,"""4""",25380,25440
7272,208005,208502,60,24660,8,"""4""",25440,25500
7272,208502,200101,120,24660,8,"""4""",25500,25620
7272,200101,202401,60,24660,8,"""4""",25620,25680
7272,202401,208103,60,24660,8,"""4""",25680,25740
7272,208103,34104,60,24660,8,"""4""",25740,25800
7272,34104,105002,60,24660,8,"""4""",25800,25860
7272,105002,8002,60,24660,8,"""4""",25860,25920
7272,8002,103005,120,24660,8,"""4""",25920,26040
7272,103005,112105,120,24660,8,"""4""",26040,26160
7272,17701,700101,60,28260,8,"""4""",28260,28320
7272,700101,202701,60,28260,8,"""4""",28320,28380
7272,202701,202302,60,28260,8,"""4""",28380,28440
7272,202302,700501,60,28260,8,"""4""",28440,28500
7272,700501,203201,60,28260,8,"""4""",28500,28560
7272,203201,203101,60,28260,8,"""4""",28560,28620
7272,203101,200201,60,28260,8,"""4""",28620,28680
7272,200201,201701,60,28260,8,"""4""",28680,28740
7272,201701,200701,60,28260,8,"""4""",28740,28800
7272,200701,204103,120,28260,8,"""4""",28800,28920
7272,204103,203605,60,28260,8,"""4""",28920,28980
7272,203605,208005,60,28260,8,"""4""",28980,29040
7272,208005,208502,60,28260,8,"""4""",29040,29100
7272,208502,200101,120,28260,8,"""4""",29100,29220
7272,200101,202401,60,28260,8,"""4""",29220,29280
7272,202401,208103,60,28260,8,"""4""",29280,29340
7272,208103,34104,60,28260,8,"""4""",29340,29400
7272,34104,105002,60,28260,8,"""4""",29400,29460
7272,105002,8002,60,28260,8,"""4""",29460,29520
7272,8002,103005,120,28260,8,"""4""",29520,29640
7272,103005,112105,120,28260,8,"""4""",29640,29760
7272,17701,700101,60,29460,8,"""4""",29460,29520
7272,700101,202701,60,29460,8,"""4""",29520,29580
7272,202701,202302,60,29460,8,"""4""",29580,29640
7272,202302,700501,60,29460,8,"""4""",29640,29700
7272,700501,203201,60,29460,8,"""4""",29700,29760
7272,203201,203101,60,29460,8,"""4""",29760,29820
7272,203101,200201,60,29460,8,"""4""",29820,29880
7272,200201,201701,60,29460,8,"""4""",29880,29940
7272,201701,200701,60,29460,8,"""4""",29940,30000
7272,200701,204103,120,29460,8,"""4""",30000,30120
7272,204103,203605,60,29460,8,"""4""",30120,30180
7272,203605,208005,60,29460,8,"""4""",30180,30240
7272,208005,208502,60,29460,8,"""4""",30240,30300
7272,208502,200101,120,29460,8,"""4""",30300,30420
7272,200101,202401,60,29460,8,"""4""",30420,30480
7272,202401,208103,60,29460,8,"""4""",30480,30540
7272,208103,34104,60,29460,8,"""4""",30540,30600
7272,34104,105002,60,29460,8,"""4""",30600,30660
7272,105002,8002,60,29460,8,"""4""",30660,30720
7272,8002,103005,120,29460,8,"""4""",30720,30840
7272,103005,112105,120,29460,8,"""4""",30840,30960
7272,17701,700101,60,31860,8,"""4""",31860,31920
7272,700101,202701,60,31860,8,"""4""",31920,31980
7272,202701,202302,60,31860,8,"""4""",31980,32040
7272,202302,700501,60,31860,8,"""4""",32040,32100
7272,700501,203201,60,31860,8,"""4""",32100,32160
7272,203201,203101,60,31860,8,"""4""",32160,32220
7272,203101,200201,60,31860,8,"""4""",32220,32280
7272,200201,201701,60,31860,8,"""4""",32280,32340
7272,201701,200701,60,31860,8,"""4""",32340,32400
7272,200701,204103,120,31860,8,"""4""",32400,32520
7272,204103,203605,60,31860,8,"""4""",32520,32580
7272,203605,208005,60,31860,8,"""4""",32580,32640
7272,208005,208502,60,31860,8,"""4""",32640,32700
7272,208502,200101,120,31860,8,"""4""",32700,32820
7272,200101,202401,60,31860,8,"""4""",32820,32880
7272,202401,208103,60,31860,8,"""4""",32880,32940
7272,208103,34104,60,31860,8,"""4""",32940,33000
7272,34104,105002,60,31860,8,"""4""",33000,33060
7272,105002,8002,60,31860,8,"""4""",33060,33120
7272,8002,103005,120,31860,8,"""4""",33120,33240
7272,103005,112105,120,31860,8,"""4""",33240,33360
7272,17701,700101,60,33060,8,"""4""",33060,33120
7272,700101,202701,60,33060,8,"""4""",33120,33180
7272,202701,202302,60,33060,8,"""4""",33180,33240
7272,202302,700501,60,33060,8,"""4""",33240,33300
7272,700501,203201,60,33060,8,"""4""",33300,33360
7272,203201,203101,60,33060,8,"""4""",33360,33420
7272,203101,200201,60,33060,8,"""4""",33420,33480
7272,200201,201701,60,33060,8,"""4""",33480,33540
7272,201701,200701,60,33060,8,"""4""",33540,33600
7272,200701,204103,120,33060,8,"""4""",33600,33720
7272,204103,203605,60,33060,8,"""4""",33720,33780
7272,203605,208005,60,33060,8,"""4""",33780,33840
7272,208005,208502,60,33060,8,"""4""",33840,33900
7272,208502,200101,120,33060,8,"""4""",33900,34020
7272,200101,202401,60,33060,8,"""4""",34020,34080
7272,202401,208103,60,33060,8,"""4""",34080,34140
7272,208103,34104,60,33060,8,"""4""",34140,34200
7272,34104,105002,60,33060,8,"""4""",34200,34260
7272,105002,8002,60,33060,8,"""4""",34260,34320
7272,8002,103005,120,33060,8,"""4""",34320,34440
7272,103005,112105,120,33060,8,"""4""",34440,34560
7272,17701,700101,60,35460,8,"""4""",35460,35520
7272,700101,202701,60,35460,8,"""4""",35520,35580
7272,202701,202302,60,35460,8,"""4""",35580,35640
7272,202302,700501,60,35460,8,"""4""",35640,35700
7272,700501,203201,60,35460,8,"""4""",35700,35760
7272,203201,203101,60,35460,8,"""4""",35760,35820
7272,203101,200201,60,35460,8,"""4""",35820,35880
7272,200201,201701,60,35460,8,"""4""",35880,35940
7272,201701,200701,60,35460,8,"""4""",35940,36000
7272,200701,204103,120,35460,8,"""4""",36000,36120
7272,204103,203605,60,35460,8,"""4""",36120,36180
7272,203605,208005,60,35460,8,"""4""",36180,36240
7272,208005,208502,60,35460,8,"""4""",36240,36300
7272,208502,200101,120,35460,8,"""4""",36300,36420
7272,200101,202401,60,35460,8,"""4""",36420,36480
7272,202401,208103,60,35460,8,"""4""",36480,36540
7272,208103,34104,60,35460,8,"""4""",36540,36600
7272,34104,105002,60,35460,8,"""4""",36600,36660
7272,105002,8002,60,35460,8,"""4""",36660,36720
7272,8002,103005,120,35460,8,"""4""",36720,36840
7272,103005,112105,120,35460,8,"""4""",36840,36960
7272,17701,700101,60,36660,8,"""4""",36660,36720
7272,700101,202701,60,36660,8,"""4""",36720,36780
7272,202701,202302,60,36660,8,"""4""",36780,36840
7272,202302,700501,60,36660,8,"""4""",36840,36900
7272,700501,203201,60,36660,8,"""4""",36900,36960
7272,203201,203101,60,36660,8,"""4""",36960,37020
7272,203101,200201,60,36660,8,"""4""",37020,37080
7272,200201,201701,60,36660,8,"""4""",37080,37140
7272,201701,200701,60,36660,8,"""4""",37140,37200
7272,200701,204103,120,36660,8,"""4""",37200,37320
7272,204103,203605,60,36660,8,"""4""",37320,37380
7272,203605,208005,60,36660,8,"""4""",37380,37440
7272,208005,208502,60,36660,8,"""4""",37440,37500
7272,208502,200101,120,36660,8,"""4""",37500,37620
7272,200101,202401,60,36660,8,"""4""",37620,37680
7272,202401,208103,60,36660,8,"""4""",37680,37740
7272,208103,34104,60,36660,8,"""4""",37740,37800
7272,34104,105002,60,36660,8,"""4""",37800,37860
7272,105002,8002,60,36660,8,"""4""",37860,37920
7272,8002,103005,120,36660,8,"""4""",37920,38040
7272,103005,112105,120,36660,8,"""4""",38040,38160
7272,17701,700101,60,39060,8,"""4""",39060,39120
7272,700101,202701,60,39060,8,"""4""",39120,39180
7272,202701,202302,60,39060,8,"""4""",39180,39240
7272,202302,700501,60,39060,8,"""4""",39240,39300
7272,700501,203201,60,39060,8,"""4""",39300,39360
7272,203201,203101,60,39060,8,"""4""",39360,39420
7272,203101,200201,60,39060,8,"""4""",39420,39480
7272,200201,201701,60,39060,8,"""4""",39480,39540
7272,201701,200701,60,39060,8,"""4""",39540,39600
7272,200701,204103,120,39060,8,"""4""",39600,39720
7272,204103,203605,60,39060,8,"""4""",39720,39780
7272,203605,208005,60,39060,8,"""4""",39780,39840
7272,208005,208502,60,39060,8,"""4""",39840,39900
7272,208502,200101,120,39060,8,"""4""",39900,40020
7272,200101,202401,60,39060,8,"""4""",40020,40080
7272,202401,208103,60,39060,8,"""4""",40080,40140
7272,208103,34104,60,39060,8,"""4""",40140,40200
7272,34104,105002,60,39060,8,"""4""",40200,40260
7272,105002,8002,60,39060,8,"""4""",40260,40320
7272,8002,103005,120,39060,8,"""4""",40320,40440
7272,103005,112105,120,39060,8,"""4""",40440,40560
7272,17701,700101,60,40260,8,"""4""",40260,40320
7272,700101,202701,60,40260,8,"""4""",40320,40380
7272,202701,202302,60,40260,8,"""4""",40380,40440
7272,202302,700501,60,40260,8,"""4""",40440,40500
7272,700501,203201,60,40260,8,"""4""",40500,40560
7272,203201,203101,60,40260,8,"""4""",40560,40620
7272,203101,200201,60,40260,8,"""4""",40620,40680
7272,200201,201701,60,40260,8,"""4""",40680,40740
7272,201701,200701,60,40260,8,"""4""",40740,40800
7272,200701,204103,120,40260,8,"""4""",40800,40920
7272,204103,203605,60,40260,8,"""4""",40920,40980
7272,203605,208005,60,40260,8,"""4""",40980,41040
7272,208005,208502,60,40260,8,"""4""",41040,41100
7272,208502,200101,120,40260,8,"""4""",41100,41220
7272,200101,202401,60,40260,8,"""4""",41220,41280
7272,202401,208103,60,40260,8,"""4""",41280,41340
7272,208103,34104,60,40260,8,"""4""",41340,41400
7272,34104,105002,60,40260,8,"""4""",41400,41460
7272,105002,8002,60,40260,8,"""4""",41460,41520
7272,8002,103005,120,40260,8,"""4""",41520,41640
7272,103005,112105,120,40260,8,"""4""",41640,41760
7272,17701,700101,60,42660,8,"""4""",42660,42720
7272,700101,202701,60,42660,8,"""4""",42720,42780
7272,202701,202302,60,42660,8,"""4""",42780,42840
7272,202302,700501,60,42660,8,"""4""",42840,42900
7272,700501,203201,60,42660,8,"""4""",42900,42960
7272,203201,203101,60,42660,8,"""4""",42960,43020
7272,203101,200201,60,42660,8,"""4""",43020,43080
7272,200201,201701,60,42660,8,"""4""",43080,43140
7272,201701,200701,60,42660,8,"""4""",43140,43200
7272,200701,204103,120,42660,8,"""4""",43200,43320
7272,204103,203605,60,42660,8,"""4""",43320,43380
7272,203605,208005,60,42660,8,"""4""",43380,43440
7272,208005,208502,60,42660,8,"""4""",43440,43500
7272,208502,200101,120,42660,8,"""4""",43500,43620
7272,200101,202401,60,42660,8,"""4""",43620,43680
7272,202401,208103,60,42660,8,"""4""",43680,43740
7272,208103,34104,60,42660,8,"""4""",43740,43800
7272,34104,105002,60,42660,8,"""4""",43800,43860
7272,105002,8002,60,42660,8,"""4""",43860,43920
7272,8002,103005,120,42660,8,"""4""",43920,44040
7272,103005,112105,120,42660,8,"""4""",44040,44160
7272,17701,700101,60,43860,8,"""4""",43860,43920
7272,700101,202701,60,43860,8,"""4""",43920,43980
7272,202701,202302,60,43860,8,"""4""",43980,44040
7272,202302,700501,60,43860,8,"""4""",44040,44100
7272,700501,203201,60,43860,8,"""4""",44100,44160
7272,203201,203101,60,43860,8,"""4""",44160,44220
7272,203101,200201,60,43860,8,"""4""",44220,44280
7272,200201,201701,60,43860,8,"""4""",44280,44340
7272,201701,200701,60,43860,8,"""4""",44340,44400
7272,200701,204103,120,43860,8,"""4""",44400,44520
7272,204103,203605,60,43860,8,"""4""",44520,44580
7272,203605,208005,60,43860,8,"""4""",44580,44640
7272,208005,208502,60,43860,8,"""4""",44640,44700
7272,208502,200101,120,43860,8,"""4""",44700,44820
7272,200101,202401,60,43860,8,"""4""",44820,44880
7272,202401,208103,60,43860,8,"""4""",44880,44940
7272,208103,34104,60,43860,8,"""4""",44940,45000
7272,34104,105002,60,43860,8,"""4""",45000,45060
7272,105002,8002,60,43860,8,"""4""",45060,45120
7272,8002,103005,120,43860,8,"""4""",45120,45240
7272,103005,112105,120,43860,8,"""4""",45240,45360
7272,17701,700101,60,46260,8,"""4""",46260,46320
7272,700101,202701,60,46260,8,"""4""",46320,46380
7272,202701,202302,60,46260,8,"""4""",46380,46440
7272,202302,700501,60,46260,8,"""4""",46440,46500
7272,700501,203201,60,46260,8,"""4""",46500,46560
7272,203201,203101,60,46260,8,"""4""",46560,46620
7272,203101,200201,60,46260,8,"""4""",46620,46680
7272,200201,201701,60,46260,8,"""4""",46680,46740
7272,201701,200701,60,46260,8,"""4""",46740,46800
7272,200701,204103,120,46260,8,"""4""",46800,46920
7272,204103,203605,60,46260,8,"""4""",46920,46980
7272,203605,208005,60,46260,8,"""4""",46980,47040
7272,208005,208502,60,46260,8,"""4""",47040,47100
7272,208502,200101,120,46260,8,"""4""",47100,47220
7272,200101,202401,60,46260,8,"""4""",47220,47280
7272,202401,208103,60,46260,8,"""4""",47280,47340
7272,208103,34104,60,46260,8,"""4""",47340,47400
7272,34104,105002,60,46260,8,"""4""",47400,47460
7272,105002,8002,60,46260,8,"""4""",47460,47520
7272,8002,103005,120,46260,8,"""4""",47520,47640
7272,103005,112105,120,46260,8,"""4""",47640,47760
7272,17701,700101,60,47460,8,"""4""",47460,47520
7272,700101,202701,60,47460,8,"""4""",47520,47580
7272,202701,202302,60,47460,8,"""4""",47580,47640
7272,202302,700501,60,47460,8,"""4""",47640,47700
7272,700501,203201,60,47460,8,"""4""",47700,47760
7272,203201,203101,60,47460,8,"""4""",47760,47820
7272,203101,200201,60,47460,8,"""4""",47820,47880
7272,200201,201701,60,47460,8,"""4""",47880,47940
7272,201701,200701,60,47460,8,"""4""",47940,48000
7272,200701,204103,120,47460,8,"""4""",48000,48120
7272,204103,203605,60,47460,8,"""4""",48120,48180
7272,203605,208005,60,47460,8,"""4""",48180,48240
7272,208005,208502,60,47460,8,"""4""",48240,48300
7272,208502,200101,120,47460,8,"""4""",48300,48420
7272,200101,202401,60,47460,8,"""4""",48420,48480
7272,202401,208103,60,47460,8,"""4""",48480,48540
7272,208103,34104,60,47460,8,"""4""",48540,48600
7272,34104,105002,60,47460,8,"""4""",48600,48660
7272,105002,8002,60,47460,8,"""4""",48660,48720
7272,8002,103005,120,47460,8,"""4""",48720,48840
7272,103005,112105,120,47460,8,"""4""",48840,48960
7272,17701,700101,60,49860,8,"""4""",49860,49920
7272,700101,202701,60,49860,8,"""4""",49920,49980
7272,202701,202302,60,49860,8,"""4""",49980,50040
7272,202302,700501,60,49860,8,"""4""",50040,50100
7272,700501,203201,60,49860,8,"""4""",50100,50160
7272,203201,203101,60,49860,8,"""4""",50160,50220
7272,203101,200201,60,49860,8,"""4""",50220,50280
7272,200201,201701,60,49860,8,"""4""",50280,50340
7272,201701,200701,60,49860,8,"""4""",50340,50400
7272,200701,204103,120,49860,8,"""4""",50400,50520
7272,204103,203605,60,49860,8,"""4""",50520,50580
7272,203605,208005,60,49860,8,"""4""",50580,50640
7272,208005,208502,60,49860,8,"""4""",50640,50700
7272,208502,200101,120,49860,8,"""4""",50700,50820
7272,200101,202401,60,49860,8,"""4""",50820,50880
7272,202401,208103,60,49860,8,"""4""",50880,50940
7272,208103,34104,60,49860,8,"""4""",50940,51000
7272,34104,105002,60,49860,8,"""4""",51000,51060
7272,105002,8002,60,49860,8,"""4""",51060,51120
7272,8002,103005,120,49860,8,"""4""",51120,51240
7272,103005,112105,120,49860,8,"""4""",51240,51360
7272,17701,700101,60,51060,8,"""4""",51060,51120
7272,700101,202701,60,51060,8,"""4""",51120,51180
7272,202701,202302,60,51060,8,"""4""",51180,51240
7272,202302,700501,60,51060,8,"""4""",51240,51300
7272,700501,203201,60,51060,8,"""4""",51300,51360
7272,203201,203101,60,51060,8,"""4""",51360,51420
7272,203101,200201,60,51060,8,"""4""",51420,51480
7272,200201,201701,60,51060,8,"""4""",51480,51540
7272,201701,200701,60,51060,8,"""4""",51540,51600
7272,200701,204103,120,51060,8,"""4""",51600,51720
7272,204103,203605,60,51060,8,"""4""",51720,51780
7272,203605,208005,60,51060,8,"""4""",51780,51840
7272,208005,208502,60,51060,8,"""4""",51840,51900
7272,208502,200101,120,51060,8,"""4""",51900,52020
7272,200101,202401,60,51060,8,"""4""",52020,52080
7272,202401,208103,60,51060,8,"""4""",52080,52140
7272,208103,34104,60,51060,8,"""4""",52140,52200
7272,34104,105002,60,51060,8,"""4""",52200,52260
7272,105002,8002,60,51060,8,"""4""",52260,52320
7272,8002,103005,120,51060,8,"""4""",52320,52440
7272,103005,112105,120,51060,8,"""4""",52440,52560
7272,17701,700101,60,53460,8,"""4""",53460,53520
7272,700101,202701,60,53460,8,"""4""",53520,53580
7272,202701,202302,60,53460,8,"""4""",53580,53640
7272,202302,700501,60,53460,8,"""4""",53640,53700
7272,700501,203201,60,53460,8,"""4""",53700,53760
7272,203201,203101,60,53460,8,"""4""",53760,53820
7272,203101,200201,60,53460,8,"""4""",53820,53880
7272,200201,201701,60,53460,8,"""4""",53880,53940
7272,201701,200701,60,53460,8,"""4""",53940,54000
7272,200701,204103,120,53460,8,"""4""",54000,54120
7272,204103,203605,60,53460,8,"""4""",54120,54180
7272,203605,208005,60,53460,8,"""4""",54180,54240
7272,208005,208502,60,53460,8,"""4""",54240,54300
7272,208502,200101,120,53460,8,"""4""",54300,54420
7272,200101,202401,60,53460,8,"""4""",54420,54480
7272,202401,208103,60,53460,8,"""4""",54480,54540
7272,208103,34104,60,53460,8,"""4""",54540,54600
7272,34104,105002,60,53460,8,"""4""",54600,54660
7272,105002,8002,60,53460,8,"""4""",54660,54720
7272,8002,103005,120,53460,8,"""4""",54720,54840
7272,103005,112105,120,53460,8,"""4""",54840,54960
7272,17701,700101,60,54660,8,"""4""",54660,54720
7272,700101,202701,60,54660,8,"""4""",54720,54780
7272,202701,202302,60,54660,8,"""4""",54780,54840
7272,202302,700501,60,54660,8,"""4""",54840,54900
7272,700501,203201,60,54660,8,"""4""",54900,54960
7272,203201,203101,60,54660,8,"""4""",54960,55020
7272,203101,200201,60,54660,8,"""4""",55020,55080
7272,200201,201701,60,54660,8,"""4""",55080,55140
7272,201701,200701,60,54660,8,"""4""",55140,55200
7272,200701,204103,120,54660,8,"""4""",55200,55320
7272,204103,203605,60,54660,8,"""4""",55320,55380
7272,203605,208005,60,54660,8,"""4""",55380,55440
7272,208005,208502,60,54660,8,"""4""",55440,55500
7272,208502,200101,120,54660,8,"""4""",55500,55620
7272,200101,202401,60,54660,8,"""4""",55620,55680
7272,202401,208103,60,54660,8,"""4""",55680,55740
7272,208103,34104,60,54660,8,"""4""",55740,55800
7272,34104,105002,60,54660,8,"""4""",55800,55860
7272,105002,8002,60,54660,8,"""4""",55860,55920
7272,8002,103005,120,54660,8,"""4""",55920,56040
7272,103005,112105,120,54660,8,"""4""",56040,56160
7272,17701,700101,60,57060,8,"""4""",57060,57120
7272,700101,202701,60,57060,8,"""4""",57120,57180
7272,202701,202302,60,57060,8,"""4""",57180,57240
7272,202302,700501,60,57060,8,"""4""",57240,57300
7272,700501,203201,60,57060,8,"""4""",57300,57360
7272,203201,203101,60,57060,8,"""4""",57360,57420
7272,203101,200201,60,57060,8,"""4""",57420,57480
7272,200201,201701,60,57060,8,"""4""",57480,57540
7272,201701,200701,60,57060,8,"""4""",57540,57600
7272,200701,204103,120,57060,8,"""4""",57600,57720
7272,204103,203605,60,57060,8,"""4""",57720,57780
7272,203605,208005,60,57060,8,"""4""",57780,57840
7272,208005,208502,60,57060,8,"""4""",57840,57900
7272,208502,200101,120,57060,8,"""4""",57900,58020
7272,200101,202401,60,57060,8,"""4""",58020,58080
7272,202401,208103,60,57060,8,"""4""",58080,58140
7272,208103,34104,60,57060,8,"""4""",58140,58200
7272,34104,105002,60,57060,8,"""4""",58200,58260
7272,105002,8002,60,57060,8,"""4""",58260,58320
7272,8002,103005,120,57060,8,"""4""",58320,58440
7272,103005,112105,120,57060,8,"""4""",58440,58560
7272,17701,700101,60,58260,8,"""4""",58260,58320
7272,700101,202701,60,58260,8,"""4""",58320,58380
7272,202701,202302,60,58260,8,"""4""",58380,58440
7272,202302,700501,60,58260,8,"""4""",58440,58500
7272,700501,203201,60,58260,8,"""4""",58500,58560
7272,203201,203101,60,58260,8,"""4""",58560,58620
7272,203101,200201,60,58260,8,"""4""",58620,58680
7272,200201,201701,60,58260,8,"""4""",58680,58740
7272,201701,200701,60,58260,8,"""4""",58740,58800
7272,200701,204103,120,58260,8,"""4""",58800,58920
7272,204103,203605,60,58260,8,"""4""",58920,58980
7272,203605,208005,60,58260,8,"""4""",58980,59040
7272,208005,208502,60,58260,8,"""4""",59040,59100
7272,208502,200101,120,58260,8,"""4""",59100,59220
7272,200101,202401,60,58260,8,"""4""",59220,59280
7272,202401,208103,60,58260,8,"""4""",59280,59340
7272,208103,34104,60,58260,8,"""4""",59340,59400
7272,34104,105002,60,58260,8,"""4""",59400,59460
7272,105002,8002,60,58260,8,"""4""",59460,59520
7272,8002,103005,120,58260,8,"""4""",59520,59640
7272,103005,112105,120,58260,8,"""4""",59640,59760
7272,17701,700101,60,60660,8,"""4""",60660,60720
7272,700101,202701,60,60660,8,"""4""",60720,60780
7272,202701,202302,60,60660,8,"""4""",60780,60840
7272,202302,700501,60,60660,8,"""4""",60840,60900
7272,700501,203201,60,60660,8,"""4""",60900,60960
7272,203201,203101,60,60660,8,"""4""",60960,61020
7272,203101,200201,60,60660,8,"""4""",61020,61080
7272,200201,201701,60,60660,8,"""4""",61080,61140
7272,201701,200701,60,60660,8,"""4""",61140,61200
7272,200701,204103,120,60660,8,"""4""",61200,61320
7272,204103,203605,60,60660,8,"""4""",61320,61380
7272,203605,208005,60,60660,8,"""4""",61380,61440
7272,208005,208502,60,60660,8,"""4""",61440,61500
7272,208502,200101,120,60660,8,"""4""",61500,61620
7272,200101,202401,60,60660,8,"""4""",61620,61680
7272,202401,208103,60,60660,8,"""4""",61680,61740
7272,208103,34104,60,60660,8,"""4""",61740,61800
7272,34104,105002,60,60660,8,"""4""",61800,61860
7272,105002,8002,60,60660,8,"""4""",61860,61920
7272,8002,103005,120,60660,8,"""4""",61920,62040
7272,103005,112105,120,60660,8,"""4""",62040,62160
7272,17701,700101,60,61860,8,"""4""",61860,61920
7272,700101,202701,60,61860,8,"""4""",61920,61980
7272,202701,202302,60,61860,8,"""4""",61980,62040
7272,202302,700501,60,61860,8,"""4""",62040,62100
7272,700501,203201,60,61860,8,"""4""",62100,62160
7272,203201,203101,60,61860,8,"""4""",62160,62220
7272,203101,200201,60,61860,8,"""4""",62220,62280
7272,200201,201701,60,61860,8,"""4""",62280,62340
7272,201701,200701,60,61860,8,"""4""",62340,62400
7272,200701,204103,120,61860,8,"""4""",62400,62520
7272,204103,203605,60,61860,8,"""4""",62520,62580
7272,203605,208005,60,61860,8,"""4""",62580,62640
7272,208005,208502,60,61860,8,"""4""",62640,62700
7272,208502,200101,120,61860,8,"""4""",62700,62820
7272,200101,202401,60,61860,8,"""4""",62820,62880
7272,202401,208103,60,61860,8,"""4""",62880,62940
7272,208103,34104,60,61860,8,"""4""",62940,63000
7272,34104,105002,60,61860,8,"""4""",63000,63060
7272,105002,8002,60,61860,8,"""4""",63060,63120
7272,8002,103005,120,61860,8,"""4""",63120,63240
7272,103005,112105,120,61860,8,"""4""",63240,63360
7272,17701,700101,60,64260,8,"""4""",64260,64320
7272,700101,202701,60,64260,8,"""4""",64320,64380
7272,202701,202302,60,64260,8,"""4""",64380,64440
7272,202302,700501,60,64260,8,"""4""",64440,64500
7272,700501,203201,60,64260,8,"""4""",64500,64560
7272,203201,203101,60,64260,8,"""4""",64560,64620
7272,203101,200201,60,64260,8,"""4""",64620,64680
7272,200201,201701,60,64260,8,"""4""",64680,64740
7272,201701,200701,60,64260,8,"""4""",64740,64800
7272,200701,204103,120,64260,8,"""4""",64800,64920
7272,204103,203605,60,64260,8,"""4""",64920,64980
7272,203605,208005,60,64260,8,"""4""",64980,65040
7272,208005,208502,60,64260,8,"""4""",65040,65100
7272,208502,200101,120,64260,8,"""4""",65100,65220
7272,200101,202401,60,64260,8,"""4""",65220,65280
7272,202401,208103,60,64260,8,"""4""",65280,65340
7272,208103,34104,60,64260,8,"""4""",65340,65400
7272,34104,105002,60,64260,8,"""4""",65400,65460
7272,105002,8002,60,64260,8,"""4""",65460,65520
7272,8002,103005,120,64260,8,"""4""",65520,65640
7272,103005,112105,120,64260,8,"""4""",65640,65760
7272,17701,700101,60,65460,8,"""4""",65460,65520
7272,700101,202701,60,65460,8,"""4""",65520,65580
7272,202701,202302,60,65460,8,"""4""",65580,65640
7272,202302,700501,60,65460,8,"""4""",65640,65700
7272,700501,203201,60,65460,8,"""4""",65700,65760
7272,203201,203101,60,65460,8,"""4""",65760,65820
7272,203101,200201,60,65460,8,"""4""",65820,65880
7272,200201,201701,60,65460,8,"""4""",65880,65940
7272,201701,200701,60,65460,8,"""4""",65940,66000
7272,200701,204103,120,65460,8,"""4""",66000,66120
7272,204103,203605,60,65460,8,"""4""",66120,66180
7272,203605,208005,60,65460,8,"""4""",66180,66240
7272,208005,208502,60,65460,8,"""4""",66240,66300
7272,208502,200101,120,65460,8,"""4""",66300,66420
7272,200101,202401,60,65460,8,"""4""",66420,66480
7272,202401,208103,60,65460,8,"""4""",66480,66540
7272,208103,34104,60,65460,8,"""4""",66540,66600
7272,34104,105002,60,65460,8,"""4""",66600,66660
7272,105002,8002,60,65460,8,"""4""",66660,66720
7272,8002,103005,120,65460,8,"""4""",66720,66840
7272,103005,112105,120,65460,8,"""4""",66840,66960
7273,17701,700101,60,19740,8,"""4""",19740,19800
7273,700101,202701,60,19740,8,"""4""",19800,19860
7273,202701,202302,60,19740,8,"""4""",19860,19920
7273,202302,700501,60,19740,8,"""4""",19920,19980
7273,700501,203201,60,19740,8,"""4""",19980,20040
7273,203201,203101,60,19740,8,"""4""",20040,20100
7273,203101,200201,60,19740,8,"""4""",20100,20160
7273,200201,201701,60,19740,8,"""4""",20160,20220
7273,201701,200701,60,19740,8,"""4""",20220,20280
7273,200701,204103,120,19740,8,"""4""",20280,20400
7273,204103,203605,60,19740,8,"""4""",20400,20460
7273,203605,208005,60,19740,8,"""4""",20460,20520
7273,208005,208502,60,19740,8,"""4""",20520,20580
7273,208502,200101,120,19740,8,"""4""",20580,20700
7273,200101,202401,60,19740,8,"""4""",20700,20760
7273,202401,208103,120,19740,8,"""4""",20760,20880
7273,208103,34104,60,19740,8,"""4""",20880,20940
7273,34104,105002,60,19740,8,"""4""",20940,21000
7273,105002,8002,60,19740,8,"""4""",21000,21060
7273,8002,103005,120,19740,8,"""4""",21060,21180
7273,103005,112105,60,19740,8,"""4""",21180,21240
7274,700101,202701,60,25860,8,"""18""",25860,25920
7274,202701,202302,60,25860,8,"""18""",25920,25980
7274,202302,700501,60,25860,8,"""18""",25980,26040
7274,700501,203201,60,25860,8,"""18""",26040,26100
7274,203201,203101,60,25860,8,"""18""",26100,26160
7274,203101,200201,60,25860,8,"""18""",26160,26220
7274,200201,201701,60,25860,8,"""18""",26220,26280
7274,201701,200701,60,25860,8,"""18""",26280,26340
7274,200701,204103,120,25860,8,"""18""",26340,26460
7274,204103,203605,60,25860,8,"""18""",26460,26520
7274,203605,208005,60,25860,8,"""18""",26520,26580
7274,208005,208502,60,25860,8,"""18""",26580,26640
7274,208502,200101,120,25860,8,"""18""",26640,26760
7274,200101,202401,60,25860,8,"""18""",26760,26820
7274,202401,208103,60,25860,8,"""18""",26820,26880
7274,208103,34104,60,25860,8,"""18""",26880,26940
7274,34104,105002,60,25860,8,"""18""",26940,27000
7274,105002,8002,60,25860,8,"""18""",27000,27060
7274,8002,103005,120,25860,8,"""18""",27060,27180
7275,408402,409103,180,47280,54,"""4""",47280,47460
7275,409103,405501,60,47280,54,"""4""",47460,47520
7275,405501,404001,60,47280,54,"""4""",47520,47580
7275,404001,408704,120,47280,54,"""4""",47580,47700
7276,304302,109202,0,25260,9,"""1""",25260,25260
7276,109202,304803,60,25260,9,"""1""",25260,25320
7276,304803,306001,60,25260,9,"""1""",25320,25380
7276,306001,304401,180,25260,9,"""1""",25380,25560
7276,304401,305202,120,25260,9,"""1""",25560,25680
7276,305202,301101,60,25260,9,"""1""",25680,25740
7276,301101,301502,120,25260,9,"""1""",25740,25860
7276,301502,301201,0,25260,9,"""1""",25860,25860
7276,301201,301600,60,25260,9,"""1""",25860,25920
7276,301600,301001,60,25260,9,"""1""",25920,25980
7276,301001,301302,60,25260,9,"""1""",25980,26040
7276,301302,305001,120,25260,9,"""1""",26040,26160
7276,305001,33902,120,25260,9,"""1""",26160,26280
7276,33902,26502,120,25260,9,"""1""",26280,26400
7276,26502,401302,60,25260,9,"""1""",26400,26460
7276,401302,400801,120,25260,9,"""1""",26460,26580
7276,400801,400704,120,25260,9,"""1""",26580,26700
7276,400704,408503,60,25260,9,"""1""",26700,26760
7276,408503,405602,60,25260,9,"""1""",26760,26820
7276,405602,407102,60,25260,9,"""1""",26820,26880
7276,407102,404202,60,25260,9,"""1""",26880,26940
7276,404202,117000,60,25260,9,"""1""",26940,27000
7276,117000,112103,180,25260,9,"""1""",27000,27180
7276,112103,103001,180,25260,9,"""1""",27180,27360
7276,103001,8001,120,25260,9,"""1""",27360,27480
7276,8001,105001,60,25260,9,"""1""",27480,27540
7276,105001,34103,60,25260,9,"""1""",27540,27600
7276,34103,208101,180,25260,9,"""1""",27600,27780
7276,208101,201502,120,25260,9,"""1""",27780,27900
7276,201502,203903,60,25260,9,"""1""",27900,27960
7276,203903,207501,60,25260,9,"""1""",27960,28020
7276,207501,207703,60,25260,9,"""1""",28020,28080
7276,207703,208601,120,25260,9,"""1""",28080,28200
7276,208601,202101,60,25260,9,"""1""",28200,28260
7276,202101,202501,120,25260,9,"""1""",28260,28380
7276,202501,205300,120,25260,9,"""1""",28380,28500
7276,304302,109202,0,27060,9,"""1""",27060,27060
7276,109202,304803,60,27060,9,"""1""",27060,27120
7276,304803,306001,60,27060,9,"""1""",27120,27180
7276,306001,304401,180,27060,9,"""1""",27180,27360
7276,304401,305202,120,27060,9,"""1""",27360,27480
7276,305202,301101,60,27060,9,"""1""",27480,27540
7276,301101,301502,120,27060,9,"""1""",27540,27660
7276,301502,301201,0,27060,9,"""1""",27660,27660
7276,301201,301600,60,27060,9,"""1""",27660,27720
7276,301600,301001,60,27060,9,"""1""",27720,27780
7276,301001,301302,60,27060,9,"""1""",27780,27840
7276,301302,305001,120,27060,9,"""1""",27840,27960
7276,305001,33902,120,27060,9,"""1""",27960,28080
7276,33902,26502,120,27060,9,"""1""",28080,28200
7276,26502,401302,60,27060,9,"""1""",28200,28260
7276,401302,400801,120,27060,9,"""1""",28260,28380
7276,400801,400704,120,27060,9,"""1""",28380,28500
7276,400704,408503,60,27060,9,"""1""",28500,28560
7276,408503,405602,60,27060,9,"""1""",28560,28620
7276,405602,407102,60,27060,9,"""1""",28620,28680
7276,407102,404202,60,27060,9,"""1""",28680,28740
7276,404202,117000,60,27060,9,"""1""",28740,28800
7276,117000,112103,180,27060,9,"""1""",28800,28980
7276,112103,103001,180,27060,9,"""1""",28980,29160
7276,103001,8001,120,27060,9,"""1""",29160,29280
7276,8001,105001,60,27060,9,"""1""",29280,29340
7276,105001,34103,60,27060,9,"""1""",29340,29400
7276,34103,208101,180,27060,9,"""1""",29400,29580
7276,208101,201502,120,27060,9,"""1""",29580,29700
7276,201502,203903,60,27060,9,"""1""",29700,29760
7276,203903,207501,60,27060,9,"""1""",29760,29820
7276,207501,207703,60,27060,9,"""1""",29820,29880
7276,207703,208601,120,27060,9,"""1""",29880,30000
7276,208601,202101,60,27060,9,"""1""",30000,30060
7276,202101,202501,120,27060,9,"""1""",30060,30180
7276,202501,205300,120,27060,9,"""1""",30180,30300
7276,304302,109202,0,28860,9,"""1""",28860,28860
7276,109202,304803,60,28860,9,"""1""",28860,28920
7276,304803,306001,60,28860,9,"""1""",28920,28980
7276,306001,304401,180,28860,9,"""1""",28980,29160
7276,304401,305202,120,28860,9,"""1""",29160,29280
7276,305202,301101,60,28860,9,"""1""",29280,29340
7276,301101,301502,120,28860,9,"""1""",29340,29460
7276,301502,301201,0,28860,9,"""1""",29460,29460
7276,301201,301600,60,28860,9,"""1""",29460,29520
7276,301600,301001,60,28860,9,"""1""",29520,29580
7276,301001,301302,60,28860,9,"""1""",29580,29640
7276,301302,305001,120,28860,9,"""1""",29640,29760
7276,305001,33902,120,28860,9,"""1""",29760,29880
7276,33902,26502,120,28860,9,"""1""",29880,30000
7276,26502,401302,60,28860,9,"""1""",30000,30060
7276,401302,400801,120,28860,9,"""1""",30060,30180
7276,400801,400704,120,28860,9,"""1""",30180,30300
7276,400704,408503,60,28860,9,"""1""",30300,30360
7276,408503,405602,60,28860,9,"""1""",30360,30420
7276,405602,407102,60,28860,9,"""1""",30420,30480
7276,407102,404202,60,28860,9,"""1""",30480,30540
7276,404202,117000,60,28860,9,"""1""",30540,30600
7276,117000,112103,180,28860,9,"""1""",30600,30780
7276,112103,103001,180,28860,9,"""1""",30780,30960
7276,103001,8001,120,28860,9,"""1""",30960,31080
7276,8001,105001,60,28860,9,"""1""",31080,31140
7276,105001,34103,60,28860,9,"""1""",31140,31200
7276,34103,208101,180,28860,9,"""1""",31200,31380
7276,208101,201502,120,28860,9,"""1""",31380,31500
7276,201502,203903,60,28860,9,"""1""",31500,31560
7276,203903,207501,60,28860,9,"""1""",31560,31620
7276,207501,207703,60,28860,9,"""1""",31620,31680
7276,207703,208601,120,28860,9,"""1""",31680,31800
7276,208601,202101,60,28860,9,"""1""",31800,31860
7276,202101,202501,120,28860,9,"""1""",31860,31980
7276,202501,205300,120,28860,9,"""1""",31980,32100
7276,304302,109202,0,32460,9,"""1""",32460,32460
7276,109202,304803,60,32460,9,"""1""",32460,32520
7276,304803,306001,60,32460,9,"""1""",32520,32580
7276,306001,304401,180,32460,9,"""1""",32580,32760
7276,304401,305202,120,32460,9,"""1""",32760,32880
7276,305202,301101,60,32460,9,"""1""",32880,32940
7276,301101,301502,120,32460,9,"""1""",32940,33060
7276,301502,301201,0,32460,9,"""1""",33060,33060
7276,301201,301600,60,32460,9,"""1""",33060,33120
7276,301600,301001,60,32460,9,"""1""",33120,33180
7276,301001,301302,60,32460,9,"""1""",33180,33240
7276,301302,305001,120,32460,9,"""1""",33240,33360
7276,305001,33902,120,32460,9,"""1""",33360,33480
7276,33902,26502,120,32460,9,"""1""",33480,33600
7276,26502,401302,60,32460,9,"""1""",33600,33660
7276,401302,400801,120,32460,9,"""1""",33660,33780
7276,400801,400704,120,32460,9,"""1""",33780,33900
7276,400704,408503,60,32460,9,"""1""",33900,33960
7276,408503,405602,60,32460,9,"""1""",33960,34020
7276,405602,407102,60,32460,9,"""1""",34020,34080
7276,407102,404202,60,32460,9,"""1""",34080,34140
7276,404202,117000,60,32460,9,"""1""",34140,34200
7276,117000,112103,180,32460,9,"""1""",34200,34380
7276,112103,103001,180,32460,9,"""1""",34380,34560
7276,103001,8001,120,32460,9,"""1""",34560,34680
7276,8001,105001,60,32460,9,"""1""",34680,34740
7276,105001,34103,60,32460,9,"""1""",34740,34800
7276,34103,208101,180,32460,9,"""1""",34800,34980
7276,208101,201502,120,32460,9,"""1""",34980,35100
7276,201502,203903,60,32460,9,"""1""",35100,35160
7276,203903,207501,60,32460,9,"""1""",35160,35220
7276,207501,207703,60,32460,9,"""1""",35220,35280
7276,207703,208601,120,32460,9,"""1""",35280,35400
7276,208601,202101,60,32460,9,"""1""",35400,35460
7276,202101,202501,120,32460,9,"""1""",35460,35580
7276,202501,205300,120,32460,9,"""1""",35580,35700
7276,304302,109202,0,36060,9,"""1""",36060,36060
7276,109202,304803,60,36060,9,"""1""",36060,36120
7276,304803,306001,60,36060,9,"""1""",36120,36180
7276,306001,304401,180,36060,9,"""1""",36180,36360
7276,304401,305202,120,36060,9,"""1""",36360,36480
7276,305202,301101,60,36060,9,"""1""",36480,36540
7276,301101,301502,120,36060,9,"""1""",36540,36660
7276,301502,301201,0,36060,9,"""1""",36660,36660
7276,301201,301600,60,36060,9,"""1""",36660,36720
7276,301600,301001,60,36060,9,"""1""",36720,36780
7276,301001,301302,60,36060,9,"""1""",36780,36840
7276,301302,305001,120,36060,9,"""1""",36840,36960
7276,305001,33902,120,36060,9,"""1""",36960,37080
7276,33902,26502,120,36060,9,"""1""",37080,37200
7276,26502,401302,60,36060,9,"""1""",37200,37260
7276,401302,400801,120,36060,9,"""1""",37260,37380
7276,400801,400704,120,36060,9,"""1""",37380,37500
7276,400704,408503,60,36060,9,"""1""",37500,37560
7276,408503,405602,60,36060,9,"""1""",37560,37620
7276,405602,407102,60,36060,9,"""1""",37620,37680
7276,407102,404202,60,36060,9,"""1""",37680,37740
7276,404202,117000,60,36060,9,"""1""",37740,37800
7276,117000,112103,180,36060,9,"""1""",37800,37980
7276,112103,103001,180,36060,9,"""1""",37980,38160
7276,103001,8001,120,36060,9,"""1""",38160,38280
7276,8001,105001,60,36060,9,"""1""",38280,38340
7276,105001,34103,60,36060,9,"""1""",38340,38400
7276,34103,208101,180,36060,9,"""1""",38400,38580
7276,208101,201502,120,36060,9,"""1""",38580,38700
7276,201502,203903,60,36060,9,"""1""",38700,38760
7276,203903,207501,60,36060,9,"""1""",38760,38820
7276,207501,207703,60,36060,9,"""1""",38820,38880
7276,207703,208601,120,36060,9,"""1""",38880,39000
7276,208601,202101,60,36060,9,"""1""",39000,39060
7276,202101,202501,120,36060,9,"""1""",39060,39180
7276,202501,205300,120,36060,9,"""1""",39180,39300
7276,304302,109202,0,39660,9,"""1""",39660,39660
7276,109202,304803,60,39660,9,"""1""",39660,39720
7276,304803,306001,60,39660,9,"""1""",39720,39780
7276,306001,304401,180,39660,9,"""1""",39780,39960
7276,304401,305202,120,39660,9,"""1""",39960,40080
7276,305202,301101,60,39660,9,"""1""",40080,40140
7276,301101,301502,120,39660,9,"""1""",40140,40260
7276,301502,301201,0,39660,9,"""1""",40260,40260
7276,301201,301600,60,39660,9,"""1""",40260,40320
7276,301600,301001,60,39660,9,"""1""",40320,40380
7276,301001,301302,60,39660,9,"""1""",40380,40440
7276,301302,305001,120,39660,9,"""1""",40440,40560
7276,305001,33902,120,39660,9,"""1""",40560,40680
7276,33902,26502,120,39660,9,"""1""",40680,40800
7276,26502,401302,60,39660,9,"""1""",40800,40860
7276,401302,400801,120,39660,9,"""1""",40860,40980
7276,400801,400704,120,39660,9,"""1""",40980,41100
7276,400704,408503,60,39660,9,"""1""",41100,41160
7276,408503,405602,60,39660,9,"""1""",41160,41220
7276,405602,407102,60,39660,9,"""1""",41220,41280
7276,407102,404202,60,39660,9,"""1""",41280,41340
7276,404202,117000,60,39660,9,"""1""",41340,41400
7276,117000,112103,180,39660,9,"""1""",41400,41580
7276,112103,103001,180,39660,9,"""1""",41580,41760
7276,103001,8001,120,39660,9,"""1""",41760,41880
7276,8001,105001,60,39660,9,"""1""",41880,41940
7276,105001,34103,60,39660,9,"""1""",41940,42000
7276,34103,208101,180,39660,9,"""1""",42000,42180
7276,208101,201502,120,39660,9,"""1""",42180,42300
7276,201502,203903,60,39660,9,"""1""",42300,42360
7276,203903,207501,60,39660,9,"""1""",42360,42420
7276,207501,207703,60,39660,9,"""1""",42420,42480
7276,207703,208601,120,39660,9,"""1""",42480,42600
7276,208601,202101,60,39660,9,"""1""",42600,42660
7276,202101,202501,120,39660,9,"""1""",42660,42780
7276,202501,205300,120,39660,9,"""1""",42780,42900
7276,304302,109202,0,43260,9,"""1""",43260,43260
7276,109202,304803,60,43260,9,"""1""",43260,43320
7276,304803,306001,60,43260,9,"""1""",43320,43380
7276,306001,304401,180,43260,9,"""1""",43380,43560
7276,304401,305202,120,43260,9,"""1""",43560,43680
7276,305202,301101,60,43260,9,"""1""",43680,43740
7276,301101,301502,120,43260,9,"""1""",43740,43860
7276,301502,301201,0,43260,9,"""1""",43860,43860
7276,301201,301600,60,43260,9,"""1""",43860,43920
7276,301600,301001,60,43260,9,"""1""",43920,43980
7276,301001,301302,60,43260,9,"""1""",43980,44040
7276,301302,305001,120,43260,9,"""1""",44040,44160
7276,305001,33902,120,43260,9,"""1""",44160,44280
7276,33902,26502,120,43260,9,"""1""",44280,44400
7276,26502,401302,60,43260,9,"""1""",44400,44460
7276,401302,400801,120,43260,9,"""1""",44460,44580
7276,400801,400704,120,43260,9,"""1""",44580,44700
7276,400704,408503,60,43260,9,"""1""",44700,44760
7276,408503,405602,60,43260,9,"""1""",44760,44820
7276,405602,407102,60,43260,9,"""1""",44820,44880
7276,407102,404202,60,43260,9,"""1""",44880,44940
7276,404202,117000,60,43260,9,"""1""",44940,45000
7276,117000,112103,180,43260,9,"""1""",45000,45180
7276,112103,103001,180,43260,9,"""1""",45180,45360
7276,103001,8001,120,43260,9,"""1""",45360,45480
7276,8001,105001,60,43260,9,"""1""",45480,45540
7276,105001,34103,60,43260,9,"""1""",45540,45600
7276,34103,208101,180,43260,9,"""1""",45600,45780
7276,208101,201502,120,43260,9,"""1""",45780,45900
7276,201502,203903,60,43260,9,"""1""",45900,45960
7276,203903,207501,60,43260,9,"""1""",45960,46020
7276,207501,207703,60,43260,9,"""1""",46020,46080
7276,207703,208601,120,43260,9,"""1""",46080,46200
7276,208601,202101,60,43260,9,"""1""",46200,46260
7276,202101,202501,120,43260,9,"""1""",46260,46380
7276,202501,205300,120,43260,9,"""1""",46380,46500
7276,304302,109202,0,46860,9,"""1""",46860,46860
7276,109202,304803,60,46860,9,"""1""",46860,46920
7276,304803,306001,60,46860,9,"""1""",46920,46980
7276,306001,304401,180,46860,9,"""1""",46980,47160
7276,304401,305202,120,46860,9,"""1""",47160,47280
7276,305202,301101,60,46860,9,"""1""",47280,47340
7276,301101,301502,120,46860,9,"""1""",47340,47460
7276,301502,301201,0,46860,9,"""1""",47460,47460
7276,301201,301600,60,46860,9,"""1""",47460,47520
7276,301600,301001,60,46860,9,"""1""",47520,47580
7276,301001,301302,60,46860,9,"""1""",47580,47640
7276,301302,305001,120,46860,9,"""1""",47640,47760
7276,305001,33902,120,46860,9,"""1""",47760,47880
7276,33902,26502,120,46860,9,"""1""",47880,48000
7276,26502,401302,60,46860,9,"""1""",48000,48060
7276,401302,400801,120,46860,9,"""1""",48060,48180
7276,400801,400704,120,46860,9,"""1""",48180,48300
7276,400704,408503,60,46860,9,"""1""",48300,48360
7276,408503,405602,60,46860,9,"""1""",48360,48420
7276,405602,407102,60,46860,9,"""1""",48420,48480
7276,407102,404202,60,46860,9,"""1""",48480,48540
7276,404202,117000,60,46860,9,"""1""",48540,48600
7276,117000,112103,180,46860,9,"""1""",48600,48780
7276,112103,103001,180,46860,9,"""1""",48780,48960
7276,103001,8001,120,46860,9,"""1""",48960,49080
7276,8001,105001,60,46860,9,"""1""",49080,49140
7276,105001,34103,60,46860,9,"""1""",49140,49200
7276,34103,208101,180,46860,9,"""1""",49200,49380
7276,208101,201502,120,46860,9,"""1""",49380,49500
7276,201502,203903,60,46860,9,"""1""",49500,49560
7276,203903,207501,60,46860,9,"""1""",49560,49620
7276,207501,207703,60,46860,9,"""1""",49620,49680
7276,207703,208601,120,46860,9,"""1""",49680,49800
7276,208601,202101,60,46860,9,"""1""",49800,49860
7276,202101,202501,120,46860,9,"""1""",49860,49980
7276,202501,205300,120,46860,9,"""1""",49980,50100
7276,304302,109202,0,50460,9,"""1""",50460,50460
7276,109202,304803,60,50460,9,"""1""",50460,50520
7276,304803,306001,60,50460,9,"""1""",50520,50580
7276,306001,304401,180,50460,9,"""1""",50580,50760
7276,304401,305202,120,50460,9,"""1""",50760,50880
7276,305202,301101,60,50460,9,"""1""",50880,50940
7276,301101,301502,120,50460,9,"""1""",50940,51060
7276,301502,301201,0,50460,9,"""1""",51060,51060
7276,301201,301600,60,50460,9,"""1""",51060,51120
7276,301600,301001,60,50460,9,"""1""",51120,51180
7276,301001,301302,60,50460,9,"""1""",51180,51240
7276,301302,305001,120,50460,9,"""1""",51240,51360
7276,305001,33902,120,50460,9,"""1""",51360,51480
7276,33902,26502,120,50460,9,"""1""",51480,51600
7276,26502,401302,60,50460,9,"""1""",51600,51660
7276,401302,400801,120,50460,9,"""1""",51660,51780
7276,400801,400704,120,50460,9,"""1""",51780,51900
7276,400704,408503,60,50460,9,"""1""",51900,51960
7276,408503,405602,60,50460,9,"""1""",51960,52020
7276,405602,407102,60,50460,9,"""1""",52020,52080
7276,407102,404202,60,50460,9,"""1""",52080,52140
7276,404202,117000,60,50460,9,"""1""",52140,52200
7276,117000,112103,180,50460,9,"""1""",52200,52380
7276,112103,103001,180,50460,9,"""1""",52380,52560
7276,103001,8001,120,50460,9,"""1""",52560,52680
7276,8001,105001,60,50460,9,"""1""",52680,52740
7276,105001,34103,60,50460,9,"""1""",52740,52800
7276,34103,208101,180,50460,9,"""1""",52800,52980
7276,208101,201502,120,50460,9,"""1""",52980,53100
7276,201502,203903,60,50460,9,"""1""",53100,53160
7276,203903,207501,60,50460,9,"""1""",53160,53220
7276,207501,207703,60,50460,9,"""1""",53220,53280
7276,207703,208601,120,50460,9,"""1""",53280,53400
7276,208601,202101,60,50460,9,"""1""",53400,53460
7276,202101,202501,120,50460,9,"""1""",53460,53580
7276,202501,205300,120,50460,9,"""1""",53580,53700
7276,304302,109202,0,54060,9,"""1""",54060,54060
7276,109202,304803,60,54060,9,"""1""",54060,54120
7276,304803,306001,60,54060,9,"""1""",54120,54180
7276,306001,304401,180,54060,9,"""1""",54180,54360
7276,304401,305202,120,54060,9,"""1""",54360,54480
7276,305202,301101,60,54060,9,"""1""",54480,54540
7276,301101,301502,120,54060,9,"""1""",54540,54660
7276,301502,301201,0,54060,9,"""1""",54660,54660
7276,301201,301600,60,54060,9,"""1""",54660,54720
7276,301600,301001,60,54060,9,"""1""",54720,54780
7276,301001,301302,60,54060,9,"""1""",54780,54840
7276,301302,305001,120,54060,9,"""1""",54840,54960
7276,305001,33902,120,54060,9,"""1""",54960,55080
7276,33902,26502,120,54060,9,"""1""",55080,55200
7276,26502,401302,60,54060,9,"""1""",55200,55260
7276,401302,400801,120,54060,9,"""1""",55260,55380
7276,400801,400704,120,54060,9,"""1""",55380,55500
7276,400704,408503,60,54060,9,"""1""",55500,55560
7276,408503,405602,60,54060,9,"""1""",55560,55620
7276,405602,407102,60,54060,9,"""1""",55620,55680
7276,407102,404202,60,54060,9,"""1""",55680,55740
7276,404202,117000,60,54060,9,"""1""",55740,55800
7276,117000,112103,180,54060,9,"""1""",55800,55980
7276,112103,103001,180,54060,9,"""1""",55980,56160
7276,103001,8001,120,54060,9,"""1""",56160,56280
7276,8001,105001,60,54060,9,"""1""",56280,56340
7276,105001,34103,60,54060,9,"""1""",56340,56400
7276,34103,208101,180,54060,9,"""1""",56400,56580
7276,208101,201502,120,54060,9,"""1""",56580,56700
7276,201502,203903,60,54060,9,"""1""",56700,56760
7276,203903,207501,60,54060,9,"""1""",56760,56820
7276,207501,207703,60,54060,9,"""1""",56820,56880
7276,207703,208601,120,54060,9,"""1""",56880,57000
7276,208601,202101,60,54060,9,"""1""",57000,57060
7276,202101,202501,120,54060,9,"""1""",57060,57180
7276,202501,205300,120,54060,9,"""1""",57180,57300
7276,304302,109202,0,55860,9,"""1""",55860,55860
7276,109202,304803,60,55860,9,"""1""",55860,55920
7276,304803,306001,60,55860,9,"""1""",55920,55980
7276,306001,304401,180,55860,9,"""1""",55980,56160
7276,304401,305202,120,55860,9,"""1""",56160,56280
7276,305202,301101,60,55860,9,"""1""",56280,56340
7276,301101,301502,120,55860,9,"""1""",56340,56460
7276,301502,301201,0,55860,9,"""1""",56460,56460
7276,301201,301600,60,55860,9,"""1""",56460,56520
7276,301600,301001,60,55860,9,"""1""",56520,56580
7276,301001,301302,60,55860,9,"""1""",56580,56640
7276,301302,305001,120,55860,9,"""1""",56640,56760
7276,305001,33902,120,55860,9,"""1""",56760,56880
7276,33902,26502,120,55860,9,"""1""",56880,57000
7276,26502,401302,60,55860,9,"""1""",57000,57060
7276,401302,400801,120,55860,9,"""1""",57060,57180
7276,400801,400704,120,55860,9,"""1""",57180,57300
7276,400704,408503,60,55860,9,"""1""",57300,57360
7276,408503,405602,60,55860,9,"""1""",57360,57420
7276,405602,407102,60,55860,9,"""1""",57420,57480
7276,407102,404202,60,55860,9,"""1""",57480,57540
7276,404202,117000,60,55860,9,"""1""",57540,57600
7276,117000,112103,180,55860,9,"""1""",57600,57780
7276,112103,103001,180,55860,9,"""1""",57780,57960
7276,103001,8001,120,55860,9,"""1""",57960,58080
7276,8001,105001,60,55860,9,"""1""",58080,58140
7276,105001,34103,60,55860,9,"""1""",58140,58200
7276,34103,208101,180,55860,9,"""1""",58200,58380
7276,208101,201502,120,55860,9,"""1""",58380,58500
7276,201502,203903,60,55860,9,"""1""",58500,58560
7276,203903,207501,60,55860,9,"""1""",58560,58620
7276,207501,207703,60,55860,9,"""1""",58620,58680
7276,207703,208601,120,55860,9,"""1""",58680,58800
7276,208601,202101,60,55860,9,"""1""",58800,58860
7276,202101,202501,120,55860,9,"""1""",58860,58980
7276,202501,205300,120,55860,9,"""1""",58980,59100
7276,304302,109202,0,59460,9,"""1""",59460,59460
7276,109202,304803,60,59460,9,"""1""",59460,59520
7276,304803,306001,60,59460,9,"""1""",59520,59580
7276,306001,304401,180,59460,9,"""1""",59580,59760
7276,304401,305202,120,59460,9,"""1""",59760,59880
7276,305202,301101,60,59460,9,"""1""",59880,59940
7276,301101,301502,120,59460,9,"""1""",59940,60060
7276,301502,301201,0,59460,9,"""1""",60060,60060
7276,301201,301600,60,59460,9,"""1""",60060,60120
7276,301600,301001,60,59460,9,"""1""",60120,60180
7276,301001,301302,60,59460,9,"""1""",60180,60240
7276,301302,305001,120,59460,9,"""1""",60240,60360
7276,305001,33902,120,59460,9,"""1""",60360,60480
7276,33902,26502,120,59460,9,"""1""",60480,60600
7276,26502,401302,60,59460,9,"""1""",60600,60660
7276,401302,400801,120,59460,9,"""1""",60660,60780
7276,400801,400704,120,59460,9,"""1""",60780,60900
7276,400704,408503,60,59460,9,"""1""",60900,60960
7276,408503,405602,60,59460,9,"""1""",60960,61020
7276,405602,407102,60,59460,9,"""1""",61020,61080
7276,407102,404202,60,59460,9,"""1""",61080,61140
7276,404202,117000,60,59460,9,"""1""",61140,61200
7276,117000,112103,180,59460,9,"""1""",61200,61380
7276,112103,103001,180,59460,9,"""1""",61380,61560
7276,103001,8001,120,59460,9,"""1""",61560,61680
7276,8001,105001,60,59460,9,"""1""",61680,61740
7276,105001,34103,60,59460,9,"""1""",61740,61800
7276,34103,208101,180,59460,9,"""1""",61800,61980
7276,208101,201502,120,59460,9,"""1""",61980,62100
7276,201502,203903,60,59460,9,"""1""",62100,62160
7276,203903,207501,60,59460,9,"""1""",62160,62220
7276,207501,207703,60,59460,9,"""1""",62220,62280
7276,207703,208601,120,59460,9,"""1""",62280,62400
7276,208601,202101,60,59460,9,"""1""",62400,62460
7276,202101,202501,120,59460,9,"""1""",62460,62580
7276,202501,205300,120,59460,9,"""1""",62580,62700
7276,304302,109202,0,61260,9,"""1""",61260,61260
7276,109202,304803,60,61260,9,"""1""",61260,61320
7276,304803,306001,60,61260,9,"""1""",61320,61380
7276,306001,304401,180,61260,9,"""1""",61380,61560
7276,304401,305202,120,61260,9,"""1""",61560,61680
7276,305202,301101,60,61260,9,"""1""",61680,61740
7276,301101,301502,120,61260,9,"""1""",61740,61860
7276,301502,301201,0,61260,9,"""1""",61860,61860
7276,301201,301600,60,61260,9,"""1""",61860,61920
7276,301600,301001,60,61260,9,"""1""",61920,61980
7276,301001,301302,60,61260,9,"""1""",61980,62040
7276,301302,305001,120,61260,9,"""1""",62040,62160
7276,305001,33902,120,61260,9,"""1""",62160,62280
7276,33902,26502,120,61260,9,"""1""",62280,62400
7276,26502,401302,60,61260,9,"""1""",62400,62460
7276,401302,400801,120,61260,9,"""1""",62460,62580
7276,400801,400704,120,61260,9,"""1""",62580,62700
7276,400704,408503,60,61260,9,"""1""",62700,62760
7276,408503,405602,60,61260,9,"""1""",62760,62820
7276,405602,407102,60,61260,9,"""1""",62820,62880
7276,407102,404202,60,61260,9,"""1""",62880,62940
7276,404202,117000,60,61260,9,"""1""",62940,63000
7276,117000,112103,180,61260,9,"""1""",63000,63180
7276,112103,103001,180,61260,9,"""1""",63180,63360
7276,103001,8001,120,61260,9,"""1""",63360,63480
7276,8001,105001,60,61260,9,"""1""",63480,63540
7276,105001,34103,60,61260,9,"""1""",63540,63600
7276,34103,208101,180,61260,9,"""1""",63600,63780
7276,208101,201502,120,61260,9,"""1""",63780,63900
7276,201502,203903,60,61260,9,"""1""",63900,63960
7276,203903,207501,60,61260,9,"""1""",63960,64020
7276,207501,207703,60,61260,9,"""1""",64020,64080
7276,207703,208601,120,61260,9,"""1""",64080,64200
7276,208601,202101,60,61260,9,"""1""",64200,64260
7276,202101,202501,120,61260,9,"""1""",64260,64380
7276,202501,205300,120,61260,9,"""1""",64380,64500
7276,304302,109202,0,63060,9,"""1""",63060,63060
7276,109202,304803,60,63060,9,"""1""",63060,63120
7276,304803,306001,60,63060,9,"""1""",63120,63180
7276,306001,304401,180,63060,9,"""1""",63180,63360
7276,304401,305202,120,63060,9,"""1""",63360,63480
7276,305202,301101,60,63060,9,"""1""",63480,63540
7276,301101,301502,120,63060,9,"""1""",63540,63660
7276,301502,301201,0,63060,9,"""1""",63660,63660
7276,301201,301600,60,63060,9,"""1""",63660,63720
7276,301600,301001,60,63060,9,"""1""",63720,63780
7276,301001,301302,60,63060,9,"""1""",63780,63840
7276,301302,305001,120,63060,9,"""1""",63840,63960
7276,305001,33902,120,63060,9,"""1""",63960,64080
7276,33902,26502,120,63060,9,"""1""",64080,64200
7276,26502,401302,60,63060,9,"""1""",64200,64260
7276,401302,400801,120,63060,9,"""1""",64260,64380
7276,400801,400704,120,63060,9,"""1""",64380,64500
7276,400704,408503,60,63060,9,"""1""",64500,64560
7276,408503,405602,60,63060,9,"""1""",64560,64620
7276,405602,407102,60,63060,9,"""1""",64620,64680
7276,407102,404202,60,63060,9,"""1""",64680,64740
7276,404202,117000,60,63060,9,"""1""",64740,64800
7276,117000,112103,180,63060,9,"""1""",64800,64980
7276,112103,103001,180,63060,9,"""1""",64980,65160
7276,103001,8001,120,63060,9,"""1""",65160,65280
7276,8001,105001,60,63060,9,"""1""",65280,65340
7276,105001,34103,60,63060,9,"""1""",65340,65400
7276,34103,208101,180,63060,9,"""1""",65400,65580
7276,208101,201502,120,63060,9,"""1""",65580,65700
7276,201502,203903,60,63060,9,"""1""",65700,65760
7276,203903,207501,60,63060,9,"""1""",65760,65820
7276,207501,207703,60,63060,9,"""1""",65820,65880
7276,207703,208601,120,63060,9,"""1""",65880,66000
7276,208601,202101,60,63060,9,"""1""",66000,66060
7276,202101,202501,120,63060,9,"""1""",66060,66180
7276,202501,205300,120,63060,9,"""1""",66180,66300
7276,304302,109202,0,68460,9,"""1""",68460,68460
7276,109202,304803,60,68460,9,"""1""",68460,68520
7276,304803,306001,60,68460,9,"""1""",68520,68580
7276,306001,304401,180,68460,9,"""1""",68580,68760
7276,304401,305202,120,68460,9,"""1""",68760,68880
7276,305202,301101,60,68460,9,"""1""",68880,68940
7276,301101,301502,120,68460,9,"""1""",68940,69060
7276,301502,301201,0,68460,9,"""1""",69060,69060
7276,301201,301600,60,68460,9,"""1""",69060,69120
7276,301600,301001,60,68460,9,"""1""",69120,69180
7276,301001,301302,60,68460,9,"""1""",69180,69240
7276,301302,305001,120,68460,9,"""1""",69240,69360
7276,305001,33902,120,68460,9,"""1""",69360,69480
7276,33902,26502,120,68460,9,"""1""",69480,69600
7276,26502,401302,60,68460,9,"""1""",69600,69660
7276,401302,400801,120,68460,9,"""1""",69660,69780
7276,400801,400704,120,68460,9,"""1""",69780,69900
7276,400704,408503,60,68460,9,"""1""",69900,69960
7276,408503,405602,60,68460,9,"""1""",69960,70020
7276,405602,407102,60,68460,9,"""1""",70020,70080
7276,407102,404202,60,68460,9,"""1""",70080,70140
7276,404202,117000,60,68460,9,"""1""",70140,70200
7276,117000,112103,180,68460,9,"""1""",70200,70380
7276,112103,103001,180,68460,9,"""1""",70380,70560
7276,103001,8001,120,68460,9,"""1""",70560,70680
7276,8001,105001,60,68460,9,"""1""",70680,70740
7276,105001,34103,60,68460,9,"""1""",70740,70800
7276,34103,208101,180,68460,9,"""1""",70800,70980
7276,208101,201502,120,68460,9,"""1""",70980,71100
7276,201502,203903,60,68460,9,"""1""",71100,71160
7276,203903,207501,60,68460,9,"""1""",71160,71220
7276,207501,207703,60,68460,9,"""1""",71220,71280
7276,207703,208601,120,68460,9,"""1""",71280,71400
7276,208601,202101,60,68460,9,"""1""",71400,71460
7276,202101,202501,120,68460,9,"""1""",71460,71580
7276,202501,205300,120,68460,9,"""1""",71580,71700
7277,304302,109202,0,21780,9,"""1""",21780,21780
7277,109202,304803,60,21780,9,"""1""",21780,21840
7277,304803,306001,60,21780,9,"""1""",21840,21900
7277,306001,304401,180,21780,9,"""1""",21900,22080
7277,304401,305202,120,21780,9,"""1""",22080,22200
7277,305202,301101,60,21780,9,"""1""",22200,22260
7277,301101,301502,120,21780,9,"""1""",22260,22380
7277,301502,301201,0,21780,9,"""1""",22380,22380
7277,301201,301600,60,21780,9,"""1""",22380,22440
7277,301600,301001,60,21780,9,"""1""",22440,22500
7277,301001,301302,60,21780,9,"""1""",22500,22560
7277,301302,305001,60,21780,9,"""1""",22560,22620
7277,305001,33902,120,21780,9,"""1""",22620,22740
7277,33902,26502,120,21780,9,"""1""",22740,22860
7277,26502,401302,60,21780,9,"""1""",22860,22920
7277,401302,400801,120,21780,9,"""1""",22920,23040
7277,400801,400704,60,21780,9,"""1""",23040,23100
7277,400704,408503,60,21780,9,"""1""",23100,23160
7277,408503,405602,60,21780,9,"""1""",23160,23220
7277,405602,407102,60,21780,9,"""1""",23220,23280
7277,407102,404202,60,21780,9,"""1""",23280,23340
7277,404202,117000,60,21780,9,"""1""",23340,23400
7277,117000,112103,180,21780,9,"""1""",23400,23580
7277,112103,103001,180,21780,9,"""1""",23580,23760
7277,103001,8001,120,21780,9,"""1""",23760,23880
7277,8001,105001,60,21780,9,"""1""",23880,23940
7277,105001,34103,60,21780,9,"""1""",23940,24000
7277,34103,208101,120,21780,9,"""1""",24000,24120
7277,208101,201502,120,21780,9,"""1""",24120,24240
7277,201502,203903,60,21780,9,"""1""",24240,24300
7277,203903,207501,60,21780,9,"""1""",24300,24360
7277,207501,207703,60,21780,9,"""1""",24360,24420
7277,207703,208601,120,21780,9,"""1""",24420,24540
7277,208601,202101,60,21780,9,"""1""",24540,24600
7277,202101,202501,120,21780,9,"""1""",24600,24720
7277,202501,205300,120,21780,9,"""1""",24720,24840
7278,205300,202502,60,21720,9,"""2""",21720,21780
7278,202502,202102,120,21720,9,"""2""",21780,21900
7278,202102,208602,60,21720,9,"""2""",21900,21960
7278,208602,207704,60,21720,9,"""2""",21960,22020
7278,207704,207502,60,21720,9,"""2""",22020,22080
7278,207502,203900,180,21720,9,"""2""",22080,22260
7278,203900,201503,60,21720,9,"""2""",22260,22320
7278,201503,208103,120,21720,9,"""2""",22320,22440
7278,208103,34104,60,21720,9,"""2""",22440,22500
7278,34104,105002,60,21720,9,"""2""",22500,22560
7278,105002,8002,60,21720,9,"""2""",22560,22620
7278,8002,103005,120,21720,9,"""2""",22620,22740
7278,103005,112104,180,21720,9,"""2""",22740,22920
7278,112104,117001,120,21720,9,"""2""",22920,23040
7278,117001,404201,60,21720,9,"""2""",23040,23100
7278,404201,407101,60,21720,9,"""2""",23100,23160
7278,407101,405601,60,21720,9,"""2""",23160,23220
7278,405601,408502,60,21720,9,"""2""",23220,23280
7278,408502,400703,60,21720,9,"""2""",23280,23340
7278,400703,400803,60,21720,9,"""2""",23340,23400
7278,400803,401303,60,21720,9,"""2""",23400,23460
7278,401303,26503,60,21720,9,"""2""",23460,23520
7278,26503,33903,120,21720,9,"""2""",23520,23640
7278,33903,305002,120,21720,9,"""2""",23640,23760
7278,305002,301301,120,21720,9,"""2""",23760,23880
7278,301301,301002,120,21720,9,"""2""",23880,24000
7278,301002,301202,60,21720,9,"""2""",24000,24060
7278,301202,301503,60,21720,9,"""2""",24060,24120
7278,301503,301102,60,21720,9,"""2""",24120,24180
7278,301102,305201,120,21720,9,"""2""",24180,24300
7278,305201,304402,120,21720,9,"""2""",24300,24420
7278,304402,306002,180,21720,9,"""2""",24420,24600
7278,306002,301700,180,21720,9,"""2""",24600,24780
7278,301700,32002,60,21720,9,"""2""",24780,24840
7278,32002,304302,60,21720,9,"""2""",24840,24900
7278,205300,202502,60,23520,9,"""2""",23520,23580
7278,202502,202102,120,23520,9,"""2""",23580,23700
7278,202102,208602,60,23520,9,"""2""",23700,23760
7278,208602,207704,60,23520,9,"""2""",23760,23820
7278,207704,207502,60,23520,9,"""2""",23820,23880
7278,207502,203900,180,23520,9,"""2""",23880,24060
7278,203900,201503,60,23520,9,"""2""",24060,24120
7278,201503,208103,120,23520,9,"""2""",24120,24240
7278,208103,34104,60,23520,9,"""2""",24240,24300
7278,34104,105002,60,23520,9,"""2""",24300,24360
7278,105002,8002,60,23520,9,"""2""",24360,24420
7278,8002,103005,120,23520,9,"""2""",24420,24540
7278,103005,112104,180,23520,9,"""2""",24540,24720
7278,112104,117001,120,23520,9,"""2""",24720,24840
7278,117001,404201,60,23520,9,"""2""",24840,24900
7278,404201,407101,60,23520,9,"""2""",24900,24960
7278,407101,405601,60,23520,9,"""2""",24960,25020
7278,405601,408502,60,23520,9,"""2""",25020,25080
7278,408502,400703,60,23520,9,"""2""",25080,25140
7278,400703,400803,60,23520,9,"""2""",25140,25200
7278,400803,401303,60,23520,9,"""2""",25200,25260
7278,401303,26503,60,23520,9,"""2""",25260,25320
7278,26503,33903,120,23520,9,"""2""",25320,25440
7278,33903,305002,120,23520,9,"""2""",25440,25560
7278,305002,301301,120,23520,9,"""2""",25560,25680
7278,301301,301002,120,23520,9,"""2""",25680,25800
7278,301002,301202,60,23520,9,"""2""",25800,25860
7278,301202,301503,60,23520,9,"""2""",25860,25920
7278,301503,301102,60,23520,9,"""2""",25920,25980
7278,301102,305201,120,23520,9,"""2""",25980,26100
7278,305201,304402,120,23520,9,"""2""",26100,26220
7278,304402,306002,180,23520,9,"""2""",26220,26400
7278,306002,301700,180,23520,9,"""2""",26400,26580
7278,301700,32002,60,23520,9,"""2""",26580,26640
7278,32002,304302,60,23520,9,"""2""",26640,26700
7278,205300,202502,60,25320,9,"""2""",25320,25380
7278,202502,202102,120,25320,9,"""2""",25380,25500
7278,202102,208602,60,25320,9,"""2""",25500,25560
7278,208602,207704,60,25320,9,"""2""",25560,25620
7278,207704,207502,60,25320,9,"""2""",25620,25680
7278,207502,203900,180,25320,9,"""2""",25680,25860
7278,203900,201503,60,25320,9,"""2""",25860,25920
7278,201503,208103,120,25320,9,"""2""",25920,26040
7278,208103,34104,60,25320,9,"""2""",26040,26100
7278,34104,105002,60,25320,9,"""2""",26100,26160
7278,105002,8002,60,25320,9,"""2""",26160,26220
7278,8002,103005,120,25320,9,"""2""",26220,26340
7278,103005,112104,180,25320,9,"""2""",26340,26520
7278,112104,117001,120,25320,9,"""2""",26520,26640
7278,117001,404201,60,25320,9,"""2""",26640,26700
7278,404201,407101,60,25320,9,"""2""",26700,26760
7278,407101,405601,60,25320,9,"""2""",26760,26820
7278,405601,408502,60,25320,9,"""2""",26820,26880
7278,408502,400703,60,25320,9,"""2""",26880,26940
7278,400703,400803,60,25320,9,"""2""",26940,27000
7278,400803,401303,60,25320,9,"""2""",27000,27060
7278,401303,26503,60,25320,9,"""2""",27060,27120
7278,26503,33903,120,25320,9,"""2""",27120,27240
7278,33903,305002,120,25320,9,"""2""",27240,27360
7278,305002,301301,120,25320,9,"""2""",27360,27480
7278,301301,301002,120,25320,9,"""2""",27480,27600
7278,301002,301202,60,25320,9,"""2""",27600,27660
7278,301202,301503,60,25320,9,"""2""",27660,27720
7278,301503,301102,60,25320,9,"""2""",27720,27780
7278,301102,305201,120,25320,9,"""2""",27780,27900
7278,305201,304402,120,25320,9,"""2""",27900,28020
7278,304402,306002,180,25320,9,"""2""",28020,28200
7278,306002,301700,180,25320,9,"""2""",28200,28380
7278,301700,32002,60,25320,9,"""2""",28380,28440
7278,32002,304302,60,25320,9,"""2""",28440,28500
7278,205300,202502,60,28920,9,"""2""",28920,28980
7278,202502,202102,120,28920,9,"""2""",28980,29100
7278,202102,208602,60,28920,9,"""2""",29100,29160
7278,208602,207704,60,28920,9,"""2""",29160,29220
7278,207704,207502,60,28920,9,"""2""",29220,29280
7278,207502,203900,180,28920,9,"""2""",29280,29460
7278,203900,201503,60,28920,9,"""2""",29460,29520
7278,201503,208103,120,28920,9,"""2""",29520,29640
7278,208103,34104,60,28920,9,"""2""",29640,29700
7278,34104,105002,60,28920,9,"""2""",29700,29760
7278,105002,8002,60,28920,9,"""2""",29760,29820
7278,8002,103005,120,28920,9,"""2""",29820,29940
7278,103005,112104,180,28920,9,"""2""",29940,30120
7278,112104,117001,120,28920,9,"""2""",30120,30240
7278,117001,404201,60,28920,9,"""2""",30240,30300
7278,404201,407101,60,28920,9,"""2""",30300,30360
7278,407101,405601,60,28920,9,"""2""",30360,30420
7278,405601,408502,60,28920,9,"""2""",30420,30480
7278,408502,400703,60,28920,9,"""2""",30480,30540
7278,400703,400803,60,28920,9,"""2""",30540,30600
7278,400803,401303,60,28920,9,"""2""",30600,30660
7278,401303,26503,60,28920,9,"""2""",30660,30720
7278,26503,33903,120,28920,9,"""2""",30720,30840
7278,33903,305002,120,28920,9,"""2""",30840,30960
7278,305002,301301,120,28920,9,"""2""",30960,31080
7278,301301,301002,120,28920,9,"""2""",31080,31200
7278,301002,301202,60,28920,9,"""2""",31200,31260
7278,301202,301503,60,28920,9,"""2""",31260,31320
7278,301503,301102,60,28920,9,"""2""",31320,31380
7278,301102,305201,120,28920,9,"""2""",31380,31500
7278,305201,304402,120,28920,9,"""2""",31500,31620
7278,304402,306002,180,28920,9,"""2""",31620,31800
7278,306002,301700,180,28920,9,"""2""",31800,31980
7278,301700,32002,60,28920,9,"""2""",31980,32040
7278,32002,304302,60,28920,9,"""2""",32040,32100
7278,205300,202502,60,30720,9,"""2""",30720,30780
7278,202502,202102,120,30720,9,"""2""",30780,30900
7278,202102,208602,60,30720,9,"""2""",30900,30960
7278,208602,207704,60,30720,9,"""2""",30960,31020
7278,207704,207502,60,30720,9,"""2""",31020,31080
7278,207502,203900,180,30720,9,"""2""",31080,31260
7278,203900,201503,60,30720,9,"""2""",31260,31320
7278,201503,208103,120,30720,9,"""2""",31320,31440
7278,208103,34104,60,30720,9,"""2""",31440,31500
7278,34104,105002,60,30720,9,"""2""",31500,31560
7278,105002,8002,60,30720,9,"""2""",31560,31620
7278,8002,103005,120,30720,9,"""2""",31620,31740
7278,103005,112104,180,30720,9,"""2""",31740,31920
7278,112104,117001,120,30720,9,"""2""",31920,32040
7278,117001,404201,60,30720,9,"""2""",32040,32100
7278,404201,407101,60,30720,9,"""2""",32100,32160
7278,407101,405601,60,30720,9,"""2""",32160,32220
7278,405601,408502,60,30720,9,"""2""",32220,32280
7278,408502,400703,60,30720,9,"""2""",32280,32340
7278,400703,400803,60,30720,9,"""2""",32340,32400
7278,400803,401303,60,30720,9,"""2""",32400,32460
7278,401303,26503,60,30720,9,"""2""",32460,32520
7278,26503,33903,120,30720,9,"""2""",32520,32640
7278,33903,305002,120,30720,9,"""2""",32640,32760
7278,305002,301301,120,30720,9,"""2""",32760,32880
7278,301301,301002,120,30720,9,"""2""",32880,33000
7278,301002,301202,60,30720,9,"""2""",33000,33060
7278,301202,301503,60,30720,9,"""2""",33060,33120
7278,301503,301102,60,30720,9,"""2""",33120,33180
7278,301102,305201,120,30720,9,"""2""",33180,33300
7278,305201,304402,120,30720,9,"""2""",33300,33420
7278,304402,306002,180,30720,9,"""2""",33420,33600
7278,306002,301700,180,30720,9,"""2""",33600,33780
7278,301700,32002,60,30720,9,"""2""",33780,33840
7278,32002,304302,60,30720,9,"""2""",33840,33900
7278,205300,202502,60,34320,9,"""2""",34320,34380
7278,202502,202102,120,34320,9,"""2""",34380,34500
7278,202102,208602,60,34320,9,"""2""",34500,34560
7278,208602,207704,60,34320,9,"""2""",34560,34620
7278,207704,207502,60,34320,9,"""2""",34620,34680
7278,207502,203900,180,34320,9,"""2""",34680,34860
7278,203900,201503,60,34320,9,"""2""",34860,34920
7278,201503,208103,120,34320,9,"""2""",34920,35040
7278,208103,34104,60,34320,9,"""2""",35040,35100
7278,34104,105002,60,34320,9,"""2""",35100,35160
7278,105002,8002,60,34320,9,"""2""",35160,35220
7278,8002,103005,120,34320,9,"""2""",35220,35340
7278,103005,112104,180,34320,9,"""2""",35340,35520
7278,112104,117001,120,34320,9,"""2""",35520,35640
7278,117001,404201,60,34320,9,"""2""",35640,35700
7278,404201,407101,60,34320,9,"""2""",35700,35760
7278,407101,405601,60,34320,9,"""2""",35760,35820
7278,405601,408502,60,34320,9,"""2""",35820,35880
7278,408502,400703,60,34320,9,"""2""",35880,35940
7278,400703,400803,60,34320,9,"""2""",35940,36000
7278,400803,401303,60,34320,9,"""2""",36000,36060
7278,401303,26503,60,34320,9,"""2""",36060,36120
7278,26503,33903,120,34320,9,"""2""",36120,36240
7278,33903,305002,120,34320,9,"""2""",36240,36360
7278,305002,301301,120,34320,9,"""2""",36360,36480
7278,301301,301002,120,34320,9,"""2""",36480,36600
7278,301002,301202,60,34320,9,"""2""",36600,36660
7278,301202,301503,60,34320,9,"""2""",36660,36720
7278,301503,301102,60,34320,9,"""2""",36720,36780
7278,301102,305201,120,34320,9,"""2""",36780,36900
7278,305201,304402,120,34320,9,"""2""",36900,37020
7278,304402,306002,180,34320,9,"""2""",37020,37200
7278,306002,301700,180,34320,9,"""2""",37200,37380
7278,301700,32002,60,34320,9,"""2""",37380,37440
7278,32002,304302,60,34320,9,"""2""",37440,37500
7278,205300,202502,60,37920,9,"""2""",37920,37980
7278,202502,202102,120,37920,9,"""2""",37980,38100
7278,202102,208602,60,37920,9,"""2""",38100,38160
7278,208602,207704,60,37920,9,"""2""",38160,38220
7278,207704,207502,60,37920,9,"""2""",38220,38280
7278,207502,203900,180,37920,9,"""2""",38280,38460
7278,203900,201503,60,37920,9,"""2""",38460,38520
7278,201503,208103,120,37920,9,"""2""",38520,38640
7278,208103,34104,60,37920,9,"""2""",38640,38700
7278,34104,105002,60,37920,9,"""2""",38700,38760
7278,105002,8002,60,37920,9,"""2""",38760,38820
7278,8002,103005,120,37920,9,"""2""",38820,38940
7278,103005,112104,180,37920,9,"""2""",38940,39120
7278,112104,117001,120,37920,9,"""2""",39120,39240
7278,117001,404201,60,37920,9,"""2""",39240,39300
7278,404201,407101,60,37920,9,"""2""",39300,39360
7278,407101,405601,60,37920,9,"""2""",39360,39420
7278,405601,408502,60,37920,9,"""2""",39420,39480
7278,408502,400703,60,37920,9,"""2""",39480,39540
7278,400703,400803,60,37920,9,"""2""",39540,39600
7278,400803,401303,60,37920,9,"""2""",39600,39660
7278,401303,26503,60,37920,9,"""2""",39660,39720
7278,26503,33903,120,37920,9,"""2""",39720,39840
7278,33903,305002,120,37920,9,"""2""",39840,39960
7278,305002,301301,120,37920,9,"""2""",39960,40080
7278,301301,301002,120,37920,9,"""2""",40080,40200
7278,301002,301202,60,37920,9,"""2""",40200,40260
7278,301202,301503,60,37920,9,"""2""",40260,40320
7278,301503,301102,60,37920,9,"""2""",40320,40380
7278,301102,305201,120,37920,9,"""2""",40380,40500
7278,305201,304402,120,37920,9,"""2""",40500,40620
7278,304402,306002,180,37920,9,"""2""",40620,40800
7278,306002,301700,180,37920,9,"""2""",40800,40980
7278,301700,32002,60,37920,9,"""2""",40980,41040
7278,32002,304302,60,37920,9,"""2""",41040,41100
7278,205300,202502,60,41520,9,"""2""",41520,41580
7278,202502,202102,120,41520,9,"""2""",41580,41700
7278,202102,208602,60,41520,9,"""2""",41700,41760
7278,208602,207704,60,41520,9,"""2""",41760,41820
7278,207704,207502,60,41520,9,"""2""",41820,41880
7278,207502,203900,180,41520,9,"""2""",41880,42060
7278,203900,201503,60,41520,9,"""2""",42060,42120
7278,201503,208103,120,41520,9,"""2""",42120,42240
7278,208103,34104,60,41520,9,"""2""",42240,42300
7278,34104,105002,60,41520,9,"""2""",42300,42360
7278,105002,8002,60,41520,9,"""2""",42360,42420
7278,8002,103005,120,41520,9,"""2""",42420,42540
7278,103005,112104,180,41520,9,"""2""",42540,42720
7278,112104,117001,120,41520,9,"""2""",42720,42840
7278,117001,404201,60,41520,9,"""2""",42840,42900
7278,404201,407101,60,41520,9,"""2""",42900,42960
7278,407101,405601,60,41520,9,"""2""",42960,43020
7278,405601,408502,60,41520,9,"""2""",43020,43080
7278,408502,400703,60,41520,9,"""2""",43080,43140
7278,400703,400803,60,41520,9,"""2""",43140,43200
7278,400803,401303,60,41520,9,"""2""",43200,43260
7278,401303,26503,60,41520,9,"""2""",43260,43320
7278,26503,33903,120,41520,9,"""2""",43320,43440
7278,33903,305002,120,41520,9,"""2""",43440,43560
7278,305002,301301,120,41520,9,"""2""",43560,43680
7278,301301,301002,120,41520,9,"""2""",43680,43800
7278,301002,301202,60,41520,9,"""2""",43800,43860
7278,301202,301503,60,41520,9,"""2""",43860,43920
7278,301503,301102,60,41520,9,"""2""",43920,43980
7278,301102,305201,120,41520,9,"""2""",43980,44100
7278,305201,304402,120,41520,9,"""2""",44100,44220
7278,304402,306002,180,41520,9,"""2""",44220,44400
7278,306002,301700,180,41520,9,"""2""",44400,44580
7278,301700,32002,60,41520,9,"""2""",44580,44640
7278,32002,304302,60,41520,9,"""2""",44640,44700
7278,205300,202502,60,45120,9,"""2""",45120,45180
7278,202502,202102,120,45120,9,"""2""",45180,45300
7278,202102,208602,60,45120,9,"""2""",45300,45360
7278,208602,207704,60,45120,9,"""2""",45360,45420
7278,207704,207502,60,45120,9,"""2""",45420,45480
7278,207502,203900,180,45120,9,"""2""",45480,45660
7278,203900,201503,60,45120,9,"""2""",45660,45720
7278,201503,208103,120,45120,9,"""2""",45720,45840
7278,208103,34104,60,45120,9,"""2""",45840,45900
7278,34104,105002,60,45120,9,"""2""",45900,45960
7278,105002,8002,60,45120,9,"""2""",45960,46020
7278,8002,103005,120,45120,9,"""2""",46020,46140
7278,103005,112104,180,45120,9,"""2""",46140,46320
7278,112104,117001,120,45120,9,"""2""",46320,46440
7278,117001,404201,60,45120,9,"""2""",46440,46500
7278,404201,407101,60,45120,9,"""2""",46500,46560
7278,407101,405601,60,45120,9,"""2""",46560,46620
7278,405601,408502,60,45120,9,"""2""",46620,46680
7278,408502,400703,60,45120,9,"""2""",46680,46740
7278,400703,400803,60,45120,9,"""2""",46740,46800
7278,400803,401303,60,45120,9,"""2""",46800,46860
7278,401303,26503,60,45120,9,"""2""",46860,46920
7278,26503,33903,120,45120,9,"""2""",46920,47040
7278,33903,305002,120,45120,9,"""2""",47040,47160
7278,305002,301301,120,45120,9,"""2""",47160,47280
7278,301301,301002,120,45120,9,"""2""",47280,47400
7278,301002,301202,60,45120,9,"""2""",47400,47460
7278,301202,301503,60,45120,9,"""2""",47460,47520
7278,301503,301102,60,45120,9,"""2""",47520,47580
7278,301102,305201,120,45120,9,"""2""",47580,47700
7278,305201,304402,120,45120,9,"""2""",47700,47820
7278,304402,306002,180,45120,9,"""2""",47820,48000
7278,306002,301700,180,45120,9,"""2""",48000,48180
7278,301700,32002,60,45120,9,"""2""",48180,48240
7278,32002,304302,60,45120,9,"""2""",48240,48300
7278,205300,202502,60,48720,9,"""2""",48720,48780
7278,202502,202102,120,48720,9,"""2""",48780,48900
7278,202102,208602,60,48720,9,"""2""",48900,48960
7278,208602,207704,60,48720,9,"""2""",48960,49020
7278,207704,207502,60,48720,9,"""2""",49020,49080
7278,207502,203900,180,48720,9,"""2""",49080,49260
7278,203900,201503,60,48720,9,"""2""",49260,49320
7278,201503,208103,120,48720,9,"""2""",49320,49440
7278,208103,34104,60,48720,9,"""2""",49440,49500
7278,34104,105002,60,48720,9,"""2""",49500,49560
7278,105002,8002,60,48720,9,"""2""",49560,49620
7278,8002,103005,120,48720,9,"""2""",49620,49740
7278,103005,112104,180,48720,9,"""2""",49740,49920
7278,112104,117001,120,48720,9,"""2""",49920,50040
7278,117001,404201,60,48720,9,"""2""",50040,50100
7278,404201,407101,60,48720,9,"""2""",50100,50160
7278,407101,405601,60,48720,9,"""2""",50160,50220
7278,405601,408502,60,48720,9,"""2""",50220,50280
7278,408502,400703,60,48720,9,"""2""",50280,50340
7278,400703,400803,60,48720,9,"""2""",50340,50400
7278,400803,401303,60,48720,9,"""2""",50400,50460
7278,401303,26503,60,48720,9,"""2""",50460,50520
7278,26503,33903,120,48720,9,"""2""",50520,50640
7278,33903,305002,120,48720,9,"""2""",50640,50760
7278,305002,301301,120,48720,9,"""2""",50760,50880
7278,301301,301002,120,48720,9,"""2""",50880,51000
7278,301002,301202,60,48720,9,"""2""",51000,51060
7278,301202,301503,60,48720,9,"""2""",51060,51120
7278,301503,301102,60,48720,9,"""2""",51120,51180
7278,301102,305201,120,48720,9,"""2""",51180,51300
7278,305201,304402,120,48720,9,"""2""",51300,51420
7278,304402,306002,180,48720,9,"""2""",51420,51600
7278,306002,301700,180,48720,9,"""2""",51600,51780
7278,301700,32002,60,48720,9,"""2""",51780,51840
7278,32002,304302,60,48720,9,"""2""",51840,51900
7278,205300,202502,60,52320,9,"""2""",52320,52380
7278,202502,202102,120,52320,9,"""2""",52380,52500
7278,202102,208602,60,52320,9,"""2""",52500,52560
7278,208602,207704,60,52320,9,"""2""",52560,52620
7278,207704,207502,60,52320,9,"""2""",52620,52680
7278,207502,203900,180,52320,9,"""2""",52680,52860
7278,203900,201503,60,52320,9,"""2""",52860,52920
7278,201503,208103,120,52320,9,"""2""",52920,53040
7278,208103,34104,60,52320,9,"""2""",53040,53100
7278,34104,105002,60,52320,9,"""2""",53100,53160
7278,105002,8002,60,52320,9,"""2""",53160,53220
7278,8002,103005,120,52320,9,"""2""",53220,53340
7278,103005,112104,180,52320,9,"""2""",53340,53520
7278,112104,117001,120,52320,9,"""2""",53520,53640
7278,117001,404201,60,52320,9,"""2""",53640,53700
7278,404201,407101,60,52320,9,"""2""",53700,53760
7278,407101,405601,60,52320,9,"""2""",53760,53820
7278,405601,408502,60,52320,9,"""2""",53820,53880
7278,408502,400703,60,52320,9,"""2""",53880,53940
7278,400703,400803,60,52320,9,"""2""",53940,54000
7278,400803,401303,60,52320,9,"""2""",54000,54060
7278,401303,26503,60,52320,9,"""2""",54060,54120
7278,26503,33903,120,52320,9,"""2""",54120,54240
7278,33903,305002,120,52320,9,"""2""",54240,54360
7278,305002,301301,120,52320,9,"""2""",54360,54480
7278,301301,301002,120,52320,9,"""2""",54480,54600
7278,301002,301202,60,52320,9,"""2""",54600,54660
7278,301202,301503,60,52320,9,"""2""",54660,54720
7278,301503,301102,60,52320,9,"""2""",54720,54780
7278,301102,305201,120,52320,9,"""2""",54780,54900
7278,305201,304402,120,52320,9,"""2""",54900,55020
7278,304402,306002,180,52320,9,"""2""",55020,55200
7278,306002,301700,180,52320,9,"""2""",55200,55380
7278,301700,32002,60,52320,9,"""2""",55380,55440
7278,32002,304302,60,52320,9,"""2""",55440,55500
7278,205300,202502,60,55920,9,"""2""",55920,55980
7278,202502,202102,120,55920,9,"""2""",55980,56100
7278,202102,208602,60,55920,9,"""2""",56100,56160
7278,208602,207704,60,55920,9,"""2""",56160,56220
7278,207704,207502,60,55920,9,"""2""",56220,56280
7278,207502,203900,180,55920,9,"""2""",56280,56460
7278,203900,201503,60,55920,9,"""2""",56460,56520
7278,201503,208103,120,55920,9,"""2""",56520,56640
7278,208103,34104,60,55920,9,"""2""",56640,56700
7278,34104,105002,60,55920,9,"""2""",56700,56760
7278,105002,8002,60,55920,9,"""2""",56760,56820
7278,8002,103005,120,55920,9,"""2""",56820,56940
7278,103005,112104,180,55920,9,"""2""",56940,57120
7278,112104,117001,120,55920,9,"""2""",57120,57240
7278,117001,404201,60,55920,9,"""2""",57240,57300
7278,404201,407101,60,55920,9,"""2""",57300,57360
7278,407101,405601,60,55920,9,"""2""",57360,57420
7278,405601,408502,60,55920,9,"""2""",57420,57480
7278,408502,400703,60,55920,9,"""2""",57480,57540
7278,400703,400803,60,55920,9,"""2""",57540,57600
7278,400803,401303,60,55920,9,"""2""",57600,57660
7278,401303,26503,60,55920,9,"""2""",57660,57720
7278,26503,33903,120,55920,9,"""2""",57720,57840
7278,33903,305002,120,55920,9,"""2""",57840,57960
7278,305002,301301,120,55920,9,"""2""",57960,58080
7278,301301,301002,120,55920,9,"""2""",58080,58200
7278,301002,301202,60,55920,9,"""2""",58200,58260
7278,301202,301503,60,55920,9,"""2""",58260,58320
7278,301503,301102,60,55920,9,"""2""",58320,58380
7278,301102,305201,120,55920,9,"""2""",58380,58500
7278,305201,304402,120,55920,9,"""2""",58500,58620
7278,304402,306002,180,55920,9,"""2""",58620,58800
7278,306002,301700,180,55920,9,"""2""",58800,58980
7278,301700,32002,60,55920,9,"""2""",58980,59040
7278,32002,304302,60,55920,9,"""2""",59040,59100
7278,205300,202502,60,57720,9,"""2""",57720,57780
7278,202502,202102,120,57720,9,"""2""",57780,57900
7278,202102,208602,60,57720,9,"""2""",57900,57960
7278,208602,207704,60,57720,9,"""2""",57960,58020
7278,207704,207502,60,57720,9,"""2""",58020,58080
7278,207502,203900,180,57720,9,"""2""",58080,58260
7278,203900,201503,60,57720,9,"""2""",58260,58320
7278,201503,208103,120,57720,9,"""2""",58320,58440
7278,208103,34104,60,57720,9,"""2""",58440,58500
7278,34104,105002,60,57720,9,"""2""",58500,58560
7278,105002,8002,60,57720,9,"""2""",58560,58620
7278,8002,103005,120,57720,9,"""2""",58620,58740
7278,103005,112104,180,57720,9,"""2""",58740,58920
7278,112104,117001,120,57720,9,"""2""",58920,59040
7278,117001,404201,60,57720,9,"""2""",59040,59100
7278,404201,407101,60,57720,9,"""2""",59100,59160
7278,407101,405601,60,57720,9,"""2""",59160,59220
7278,405601,408502,60,57720,9,"""2""",59220,59280
7278,408502,400703,60,57720,9,"""2""",59280,59340
7278,400703,400803,60,57720,9,"""2""",59340,59400
7278,400803,401303,60,57720,9,"""2""",59400,59460
7278,401303,26503,60,57720,9,"""2""",59460,59520
7278,26503,33903,120,57720,9,"""2""",59520,59640
7278,33903,305002,120,57720,9,"""2""",59640,59760
7278,305002,301301,120,57720,9,"""2""",59760,59880
7278,301301,301002,120,57720,9,"""2""",59880,60000
7278,301002,301202,60,57720,9,"""2""",60000,60060
7278,301202,301503,60,57720,9,"""2""",60060,60120
7278,301503,301102,60,57720,9,"""2""",60120,60180
7278,301102,305201,120,57720,9,"""2""",60180,60300
7278,305201,304402,120,57720,9,"""2""",60300,60420
7278,304402,306002,180,57720,9,"""2""",60420,60600
7278,306002,301700,180,57720,9,"""2""",60600,60780
7278,301700,32002,60,57720,9,"""2""",60780,60840
7278,32002,304302,60,57720,9,"""2""",60840,60900
7278,205300,202502,60,59520,9,"""2""",59520,59580
7278,202502,202102,120,59520,9,"""2""",59580,59700
7278,202102,208602,60,59520,9,"""2""",59700,59760
7278,208602,207704,60,59520,9,"""2""",59760,59820
7278,207704,207502,60,59520,9,"""2""",59820,59880
7278,207502,203900,180,59520,9,"""2""",59880,60060
7278,203900,201503,60,59520,9,"""2""",60060,60120
7278,201503,208103,120,59520,9,"""2""",60120,60240
7278,208103,34104,60,59520,9,"""2""",60240,60300
7278,34104,105002,60,59520,9,"""2""",60300,60360
7278,105002,8002,60,59520,9,"""2""",60360,60420
7278,8002,103005,120,59520,9,"""2""",60420,60540
7278,103005,112104,180,59520,9,"""2""",60540,60720
7278,112104,117001,120,59520,9,"""2""",60720,60840
7278,117001,404201,60,59520,9,"""2""",60840,60900
7278,404201,407101,60,59520,9,"""2""",60900,60960
7278,407101,405601,60,59520,9,"""2""",60960,61020
7278,405601,408502,60,59520,9,"""2""",61020,61080
7278,408502,400703,60,59520,9,"""2""",61080,61140
7278,400703,400803,60,59520,9,"""2""",61140,61200
7278,400803,401303,60,59520,9,"""2""",61200,61260
7278,401303,26503,60,59520,9,"""2""",61260,61320
7278,26503,33903,120,59520,9,"""2""",61320,61440
7278,33903,305002,120,59520,9,"""2""",61440,61560
7278,305002,301301,120,59520,9,"""2""",61560,61680
7278,301301,301002,120,59520,9,"""2""",61680,61800
7278,301002,301202,60,59520,9,"""2""",61800,61860
7278,301202,301503,60,59520,9,"""2""",61860,61920
7278,301503,301102,60,59520,9,"""2""",61920,61980
7278,301102,305201,120,59520,9,"""2""",61980,62100
7278,305201,304402,120,59520,9,"""2""",62100,62220
7278,304402,306002,180,59520,9,"""2""",62220,62400
7278,306002,301700,180,59520,9,"""2""",62400,62580
7278,301700,32002,60,59520,9,"""2""",62580,62640
7278,32002,304302,60,59520,9,"""2""",62640,62700
7278,205300,202502,60,63120,9,"""2""",63120,63180
7278,202502,202102,120,63120,9,"""2""",63180,63300
7278,202102,208602,60,63120,9,"""2""",63300,63360
7278,208602,207704,60,63120,9,"""2""",63360,63420
7278,207704,207502,60,63120,9,"""2""",63420,63480
7278,207502,203900,180,63120,9,"""2""",63480,63660
7278,203900,201503,60,63120,9,"""2""",63660,63720
7278,201503,208103,120,63120,9,"""2""",63720,63840
7278,208103,34104,60,63120,9,"""2""",63840,63900
7278,34104,105002,60,63120,9,"""2""",63900,63960
7278,105002,8002,60,63120,9,"""2""",63960,64020
7278,8002,103005,120,63120,9,"""2""",64020,64140
7278,103005,112104,180,63120,9,"""2""",64140,64320
7278,112104,117001,120,63120,9,"""2""",64320,64440
7278,117001,404201,60,63120,9,"""2""",64440,64500
7278,404201,407101,60,63120,9,"""2""",64500,64560
7278,407101,405601,60,63120,9,"""2""",64560,64620
7278,405601,408502,60,63120,9,"""2""",64620,64680
7278,408502,400703,60,63120,9,"""2""",64680,64740
7278,400703,400803,60,63120,9,"""2""",64740,64800
7278,400803,401303,60,63120,9,"""2""",64800,64860
7278,401303,26503,60,63120,9,"""2""",64860,64920
7278,26503,33903,120,63120,9,"""2""",64920,65040
7278,33903,305002,120,63120,9,"""2""",65040,65160
7278,305002,301301,120,63120,9,"""2""",65160,65280
7278,301301,301002,120,63120,9,"""2""",65280,65400
7278,301002,301202,60,63120,9,"""2""",65400,65460
7278,301202,301503,60,63120,9,"""2""",65460,65520
7278,301503,301102,60,63120,9,"""2""",65520,65580
7278,301102,305201,120,63120,9,"""2""",65580,65700
7278,305201,304402,120,63120,9,"""2""",65700,65820
7278,304402,306002,180,63120,9,"""2""",65820,66000
7278,306002,301700,180,63120,9,"""2""",66000,66180
7278,301700,32002,60,63120,9,"""2""",66180,66240
7278,32002,304302,60,63120,9,"""2""",66240,66300
7278,205300,202502,60,66720,9,"""2""",66720,66780
7278,202502,202102,120,66720,9,"""2""",66780,66900
7278,202102,208602,60,66720,9,"""2""",66900,66960
7278,208602,207704,60,66720,9,"""2""",66960,67020
7278,207704,207502,60,66720,9,"""2""",67020,67080
7278,207502,203900,180,66720,9,"""2""",67080,67260
7278,203900,201503,60,66720,9,"""2""",67260,67320
7278,201503,208103,120,66720,9,"""2""",67320,67440
7278,208103,34104,60,66720,9,"""2""",67440,67500
7278,34104,105002,60,66720,9,"""2""",67500,67560
7278,105002,8002,60,66720,9,"""2""",67560,67620
7278,8002,103005,120,66720,9,"""2""",67620,67740
7278,103005,112104,180,66720,9,"""2""",67740,67920
7278,112104,117001,120,66720,9,"""2""",67920,68040
7278,117001,404201,60,66720,9,"""2""",68040,68100
7278,404201,407101,60,66720,9,"""2""",68100,68160
7278,407101,405601,60,66720,9,"""2""",68160,68220
7278,405601,408502,60,66720,9,"""2""",68220,68280
7278,408502,400703,60,66720,9,"""2""",68280,68340
7278,400703,400803,60,66720,9,"""2""",68340,68400
7278,400803,401303,60,66720,9,"""2""",68400,68460
7278,401303,26503,60,66720,9,"""2""",68460,68520
7278,26503,33903,120,66720,9,"""2""",68520,68640
7278,33903,305002,120,66720,9,"""2""",68640,68760
7278,305002,301301,120,66720,9,"""2""",68760,68880
7278,301301,301002,120,66720,9,"""2""",68880,69000
7278,301002,301202,60,66720,9,"""2""",69000,69060
7278,301202,301503,60,66720,9,"""2""",69060,69120
7278,301503,301102,60,66720,9,"""2""",69120,69180
7278,301102,305201,120,66720,9,"""2""",69180,69300
7278,305201,304402,120,66720,9,"""2""",69300,69420
7278,304402,306002,180,66720,9,"""2""",69420,69600
7278,306002,301700,180,66720,9,"""2""",69600,69780
7278,301700,32002,60,66720,9,"""2""",69780,69840
7278,32002,304302,60,66720,9,"""2""",69840,69900
7279,112104,117001,120,66180,9,"""4""",66180,66300
7279,117001,404201,60,66180,9,"""4""",66300,66360
7279,404201,407101,60,66180,9,"""4""",66360,66420
7279,407101,405601,60,66180,9,"""4""",66420,66480
7279,405601,408502,60,66180,9,"""4""",66480,66540
7279,408502,400703,60,66180,9,"""4""",66540,66600
7279,400703,400803,60,66180,9,"""4""",66600,66660
7279,400803,401303,60,66180,9,"""4""",66660,66720
7279,401303,26503,60,66180,9,"""4""",66720,66780
7279,26503,33903,120,66180,9,"""4""",66780,66900
7279,33903,305002,120,66180,9,"""4""",66900,67020
7279,305002,301301,120,66180,9,"""4""",67020,67140
7279,301301,301002,120,66180,9,"""4""",67140,67260
7279,301002,301202,60,66180,9,"""4""",67260,67320
7279,301202,301503,60,66180,9,"""4""",67320,67380
7279,301503,301102,60,66180,9,"""4""",67380,67440
7279,301102,305201,120,66180,9,"""4""",67440,67560
7279,305201,304402,120,66180,9,"""4""",67560,67680
7279,304402,306002,180,66180,9,"""4""",67680,67860
7279,306002,301700,180,66180,9,"""4""",67860,68040
7279,301700,32002,60,66180,9,"""4""",68040,68100
7279,32002,304302,60,66180,9,"""4""",68100,68160
7279,112104,117001,120,74700,9,"""4""",74700,74820
7279,117001,404201,60,74700,9,"""4""",74820,74880
7279,404201,407101,60,74700,9,"""4""",74880,74940
7279,407101,405601,60,74700,9,"""4""",74940,75000
7279,405601,408502,60,74700,9,"""4""",75000,75060
7279,408502,400703,60,74700,9,"""4""",75060,75120
7279,400703,400803,60,74700,9,"""4""",75120,75180
7279,400803,401303,60,74700,9,"""4""",75180,75240
7279,401303,26503,60,74700,9,"""4""",75240,75300
7279,26503,33903,120,74700,9,"""4""",75300,75420
7279,33903,305002,120,74700,9,"""4""",75420,75540
7279,305002,301301,120,74700,9,"""4""",75540,75660
7279,301301,301002,120,74700,9,"""4""",75660,75780
7279,301002,301202,60,74700,9,"""4""",75780,75840
7279,301202,301503,60,74700,9,"""4""",75840,75900
7279,301503,301102,60,74700,9,"""4""",75900,75960
7279,301102,305201,120,74700,9,"""4""",75960,76080
7279,305201,304402,120,74700,9,"""4""",76080,76200
7279,304402,306002,180,74700,9,"""4""",76200,76380
7279,306002,301700,180,74700,9,"""4""",76380,76560
7279,301700,32002,60,74700,9,"""4""",76560,76620
7279,32002,304302,60,74700,9,"""4""",76620,76680
7279,112104,117001,120,81900,9,"""4""",81900,82020
7279,117001,404201,60,81900,9,"""4""",82020,82080
7279,404201,407101,60,81900,9,"""4""",82080,82140
7279,407101,405601,60,81900,9,"""4""",82140,82200
7279,405601,408502,60,81900,9,"""4""",82200,82260
7279,408502,400703,60,81900,9,"""4""",82260,82320
7279,400703,400803,60,81900,9,"""4""",82320,82380
7279,400803,401303,60,81900,9,"""4""",82380,82440
7279,401303,26503,60,81900,9,"""4""",82440,82500
7279,26503,33903,120,81900,9,"""4""",82500,82620
7279,33903,305002,120,81900,9,"""4""",82620,82740
7279,305002,301301,120,81900,9,"""4""",82740,82860
7279,301301,301002,120,81900,9,"""4""",82860,82980
7279,301002,301202,60,81900,9,"""4""",82980,83040
7279,301202,301503,60,81900,9,"""4""",83040,83100
7279,301503,301102,60,81900,9,"""4""",83100,83160
7279,301102,305201,120,81900,9,"""4""",83160,83280
7279,305201,304402,120,81900,9,"""4""",83280,83400
7279,304402,306002,180,81900,9,"""4""",83400,83580
7279,306002,301700,180,81900,9,"""4""",83580,83760
7279,301700,32002,60,81900,9,"""4""",83760,83820
7279,32002,304302,60,81900,9,"""4""",83820,83880
7280,112104,117001,120,47580,9,"""12""",47580,47700
7280,117001,404201,60,47580,9,"""12""",47700,47760
7280,404201,407101,60,47580,9,"""12""",47760,47820
7280,407101,405601,60,47580,9,"""12""",47820,47880
7280,405601,408502,60,47580,9,"""12""",47880,47940
7280,408502,400703,60,47580,9,"""12""",47940,48000
7280,400703,400803,60,47580,9,"""12""",48000,48060
7280,400803,401303,60,47580,9,"""12""",48060,48120
7280,401303,26503,60,47580,9,"""12""",48120,48180
7280,26503,33903,120,47580,9,"""12""",48180,48300
7280,33903,305002,120,47580,9,"""12""",48300,48420
7280,305002,301301,120,47580,9,"""12""",48420,48540
7280,301301,301002,120,47580,9,"""12""",48540,48660
7280,301002,301202,60,47580,9,"""12""",48660,48720
7280,301202,301503,60,47580,9,"""12""",48720,48780
7282,16301,501001,60,47400,211,"""1""",47400,47460
7282,501001,502201,120,47400,211,"""1""",47460,47580
7282,502201,102002,240,47400,211,"""1""",47580,47820
7282,102002,101101,120,47400,211,"""1""",47820,47940
7282,101101,407101,420,47400,211,"""1""",47940,48360
7282,407101,400703,180,47400,211,"""1""",48360,48540
7282,400703,400803,60,47400,211,"""1""",48540,48600
7282,400803,401303,60,47400,211,"""1""",48600,48660
7282,401303,26503,60,47400,211,"""1""",48660,48720
7282,26503,401502,120,47400,211,"""1""",48720,48840
7282,401502,401901,60,47400,211,"""1""",48840,48900
7282,401901,401401,60,47400,211,"""1""",48900,48960
7282,401401,403301,60,47400,211,"""1""",48960,49020
7282,403301,410202,120,47400,211,"""1""",49020,49140
7283,8101,404803,60,26280,211,"""2""",26280,26340
7283,404803,403401,60,26280,211,"""2""",26340,26400
7283,403401,502401,60,26280,211,"""2""",26400,26460
7283,502401,117000,480,26280,211,"""2""",26460,26940
7283,117000,101104,240,26280,211,"""2""",26940,27180
7283,101104,102001,180,26280,211,"""2""",27180,27360
7283,102001,502202,180,26280,211,"""2""",27360,27540
7283,502202,501003,60,26280,211,"""2""",27540,27600
7283,501003,16302,120,26280,211,"""2""",27600,27720
7284,403300,401402,60,26100,76,"""1""",26100,26160
7284,401402,401902,60,26100,76,"""1""",26160,26220
7284,401902,401503,60,26100,76,"""1""",26220,26280
7284,401503,26502,120,26100,76,"""1""",26280,26400
7284,26502,401302,60,26100,76,"""1""",26400,26460
7284,401302,502402,60,26100,76,"""1""",26460,26520
7284,502402,403402,60,26100,76,"""1""",26520,26580
7284,403402,404801,60,26100,76,"""1""",26580,26640
7284,404801,8102,60,26100,76,"""1""",26640,26700
7284,8102,406903,300,26100,76,"""1""",26700,27000
7284,406903,406702,60,26100,76,"""1""",27000,27060
7284,406702,302603,60,26100,76,"""1""",27060,27120
7284,302603,406002,60,26100,76,"""1""",27120,27180
7284,406002,404700,180,26100,76,"""1""",27180,27360
7284,404700,403601,60,26100,76,"""1""",27360,27420
7284,403601,406401,480,26100,76,"""1""",27420,27900
7287,8101,404803,60,25800,80,"""2""",25800,25860
7287,404803,403401,60,25800,80,"""2""",25860,25920
7287,403401,502401,60,25800,80,"""2""",25920,25980
7287,502401,401303,120,25800,80,"""2""",25980,26100
7287,401303,26503,60,25800,80,"""2""",26100,26160
7287,26503,403300,120,25800,80,"""2""",26160,26280
7287,403300,401402,60,25800,80,"""2""",26280,26340
7287,401402,401902,60,25800,80,"""2""",26340,26400
7287,401902,401503,60,25800,80,"""2""",26400,26460
7287,401503,33903,180,25800,80,"""2""",26460,26640
7287,33903,305002,120,25800,80,"""2""",26640,26760
7287,305002,301301,120,25800,80,"""2""",26760,26880
7287,301301,301002,120,25800,80,"""2""",26880,27000
7287,301002,301202,60,25800,80,"""2""",27000,27060
7287,301202,301503,60,25800,80,"""2""",27060,27120
7287,301503,301102,60,25800,80,"""2""",27120,27180
7287,301102,305201,120,25800,80,"""2""",27180,27300
7287,305201,304402,120,25800,80,"""2""",27300,27420
7287,304402,306002,180,25800,80,"""2""",27420,27600
7287,306002,301700,180,25800,80,"""2""",27600,27780
7287,301700,32002,60,25800,80,"""2""",27780,27840
7287,32002,304302,60,25800,80,"""2""",27840,27900
7294,300200,301201,180,22020,204,"""2""",22020,22200
7294,301201,301600,60,22020,204,"""2""",22200,22260
7294,301600,301302,120,22020,204,"""2""",22260,22380
7294,301302,33904,120,22020,204,"""2""",22380,22500
7294,33904,26502,120,22020,204,"""2""",22500,22620
7294,26502,407907,360,22020,204,"""2""",22620,22980
7294,407907,409601,180,22020,204,"""2""",22980,23160
7294,409601,405200,120,22020,204,"""2""",23160,23280
7294,405200,408000,180,22020,204,"""2""",23280,23460
7294,408000,402502,60,22020,204,"""2""",23460,23520
7294,402502,403104,240,22020,204,"""2""",23520,23760
7294,403104,112101,180,22020,204,"""2""",23760,23940
7294,300200,301201,180,23220,204,"""2""",23220,23400
7294,301201,301600,60,23220,204,"""2""",23400,23460
7294,301600,301302,120,23220,204,"""2""",23460,23580
7294,301302,33904,120,23220,204,"""2""",23580,23700
7294,33904,26502,120,23220,204,"""2""",23700,23820
7294,26502,407907,360,23220,204,"""2""",23820,24180
7294,407907,409601,180,23220,204,"""2""",24180,24360
7294,409601,405200,120,23220,204,"""2""",24360,24480
7294,405200,408000,180,23220,204,"""2""",24480,24660
7294,408000,402502,60,23220,204,"""2""",24660,24720
7294,402502,403104,240,23220,204,"""2""",24720,24960
7294,403104,112101,180,23220,204,"""2""",24960,25140
7294,300200,301201,180,24420,204,"""2""",24420,24600
7294,301201,301600,60,24420,204,"""2""",24600,24660
7294,301600,301302,120,24420,204,"""2""",24660,24780
7294,301302,33904,120,24420,204,"""2""",24780,24900
7294,33904,26502,120,24420,204,"""2""",24900,25020
7294,26502,407907,360,24420,204,"""2""",25020,25380
7294,407907,409601,180,24420,204,"""2""",25380,25560
7294,409601,405200,120,24420,204,"""2""",25560,25680
7294,405200,408000,180,24420,204,"""2""",25680,25860
7294,408000,402502,60,24420,204,"""2""",25860,25920
7294,402502,403104,240,24420,204,"""2""",25920,26160
7294,403104,112101,180,24420,204,"""2""",26160,26340
7294,300200,301201,180,25620,204,"""2""",25620,25800
7294,301201,301600,60,25620,204,"""2""",25800,25860
7294,301600,301302,120,25620,204,"""2""",25860,25980
7294,301302,33904,120,25620,204,"""2""",25980,26100
7294,33904,26502,120,25620,204,"""2""",26100,26220
7294,26502,407907,360,25620,204,"""2""",26220,26580
7294,407907,409601,180,25620,204,"""2""",26580,26760
7294,409601,405200,120,25620,204,"""2""",26760,26880
7294,405200,408000,180,25620,204,"""2""",26880,27060
7294,408000,402502,60,25620,204,"""2""",27060,27120
7294,402502,403104,240,25620,204,"""2""",27120,27360
7294,403104,112101,180,25620,204,"""2""",27360,27540
7294,300200,301201,180,26820,204,"""2""",26820,27000
7294,301201,301600,60,26820,204,"""2""",27000,27060
7294,301600,301302,120,26820,204,"""2""",27060,27180
7294,301302,33904,120,26820,204,"""2""",27180,27300
7294,33904,26502,120,26820,204,"""2""",27300,27420
7294,26502,407907,360,26820,204,"""2""",27420,27780
7294,407907,409601,180,26820,204,"""2""",27780,27960
7294,409601,405200,120,26820,204,"""2""",27960,28080
7294,405200,408000,180,26820,204,"""2""",28080,28260
7294,408000,402502,60,26820,204,"""2""",28260,28320
7294,402502,403104,240,26820,204,"""2""",28320,28560
7294,403104,112101,180,26820,204,"""2""",28560,28740
7294,300200,301201,180,28020,204,"""2""",28020,28200
7294,301201,301600,60,28020,204,"""2""",28200,28260
7294,301600,301302,120,28020,204,"""2""",28260,28380
7294,301302,33904,120,28020,204,"""2""",28380,28500
7294,33904,26502,120,28020,204,"""2""",28500,28620
7294,26502,407907,360,28020,204,"""2""",28620,28980
7294,407907,409601,180,28020,204,"""2""",28980,29160
7294,409601,405200,120,28020,204,"""2""",29160,29280
7294,405200,408000,180,28020,204,"""2""",29280,29460
7294,408000,402502,60,28020,204,"""2""",29460,29520
7294,402502,403104,240,28020,204,"""2""",29520,29760
7294,403104,112101,180,28020,204,"""2""",29760,29940
7294,300200,301201,180,29220,204,"""2""",29220,29400
7294,301201,301600,60,29220,204,"""2""",29400,29460
7294,301600,301302,120,29220,204,"""2""",29460,29580
7294,301302,33904,120,29220,204,"""2""",29580,29700
7294,33904,26502,120,29220,204,"""2""",29700,29820
7294,26502,407907,360,29220,204,"""2""",29820,30180
7294,407907,409601,180,29220,204,"""2""",30180,30360
7294,409601,405200,120,29220,204,"""2""",30360,30480
7294,405200,408000,180,29220,204,"""2""",30480,30660
7294,408000,402502,60,29220,204,"""2""",30660,30720
7294,402502,403104,240,29220,204,"""2""",30720,30960
7294,403104,112101,180,29220,204,"""2""",30960,31140
7294,300200,301201,180,30420,204,"""2""",30420,30600
7294,301201,301600,60,30420,204,"""2""",30600,30660
7294,301600,301302,120,30420,204,"""2""",30660,30780
7294,301302,33904,120,30420,204,"""2""",30780,30900
7294,33904,26502,120,30420,204,"""2""",30900,31020
7294,26502,407907,360,30420,204,"""2""",31020,31380
7294,407907,409601,180,30420,204,"""2""",31380,31560
7294,409601,405200,120,30420,204,"""2""",31560,31680
7294,405200,408000,180,30420,204,"""2""",31680,31860
7294,408000,402502,60,30420,204,"""2""",31860,31920
7294,402502,403104,240,30420,204,"""2""",31920,32160
7294,403104,112101,180,30420,204,"""2""",32160,32340
7294,300200,301201,180,31620,204,"""2""",31620,31800
7294,301201,301600,60,31620,204,"""2""",31800,31860
7294,301600,301302,120,31620,204,"""2""",31860,31980
7294,301302,33904,120,31620,204,"""2""",31980,32100
7294,33904,26502,120,31620,204,"""2""",32100,32220
7294,26502,407907,360,31620,204,"""2""",32220,32580
7294,407907,409601,180,31620,204,"""2""",32580,32760
7294,409601,405200,120,31620,204,"""2""",32760,32880
7294,405200,408000,180,31620,204,"""2""",32880,33060
7294,408000,402502,60,31620,204,"""2""",33060,33120
7294,402502,403104,240,31620,204,"""2""",33120,33360
7294,403104,112101,180,31620,204,"""2""",33360,33540
7294,300200,301201,180,32820,204,"""2""",32820,33000
7294,301201,301600,60,32820,204,"""2""",33000,33060
7294,301600,301302,120,32820,204,"""2""",33060,33180
7294,301302,33904,120,32820,204,"""2""",33180,33300
7294,33904,26502,120,32820,204,"""2""",33300,33420
7294,26502,407907,360,32820,204,"""2""",33420,33780
7294,407907,409601,180,32820,204,"""2""",33780,33960
7294,409601,405200,120,32820,204,"""2""",33960,34080
7294,405200,408000,180,32820,204,"""2""",34080,34260
7294,408000,402502,60,32820,204,"""2""",34260,34320
7294,402502,403104,240,32820,204,"""2""",34320,34560
7294,403104,112101,180,32820,204,"""2""",34560,34740
7295,33904,26502,120,21600,204,"""4""",21600,21720
7295,26502,407907,360,21600,204,"""4""",21720,22080
7295,407907,409601,180,21600,204,"""4""",22080,22260
7295,409601,405200,120,21600,204,"""4""",22260,22380
7295,405200,408000,180,21600,204,"""4""",22380,22560
7295,408000,402502,60,21600,204,"""4""",22560,22620
7295,402502,403104,240,21600,204,"""4""",22620,22860
7295,403104,112101,180,21600,204,"""4""",22860,23040
7483,404400,408603,60,72060,3,"""3""",72060,72120
7483,408603,407801,60,72060,3,"""3""",72120,72180
7483,407801,400301,60,72060,3,"""3""",72180,72240
7483,400301,401202,60,72060,3,"""3""",72240,72300
7483,401202,400101,60,72060,3,"""3""",72300,72360
7483,400101,407302,60,72060,3,"""3""",72360,72420
7483,407302,408202,60,72060,3,"""3""",72420,72480
7483,408202,403104,120,72060,3,"""3""",72480,72600
7483,403104,112103,120,72060,3,"""3""",72600,72720
7483,112103,103001,180,72060,3,"""3""",72720,72900
7483,103001,8001,120,72060,3,"""3""",72900,73020
7483,8001,105001,60,72060,3,"""3""",73020,73080
7483,105001,34103,60,72060,3,"""3""",73080,73140
7483,34103,208102,120,72060,3,"""3""",73140,73260
7483,208102,201502,120,72060,3,"""3""",73260,73380
7483,201502,203904,120,72060,3,"""3""",73380,73500
7483,203904,204802,60,72060,3,"""3""",73500,73560
7483,204802,204702,60,72060,3,"""3""",73560,73620
7483,204702,202801,60,72060,3,"""3""",73620,73680
7483,202801,205201,60,72060,3,"""3""",73680,73740
7483,205201,205102,60,72060,3,"""3""",73740,73800
7483,205102,201401,60,72060,3,"""3""",73800,73860
7483,201401,203301,60,72060,3,"""3""",73860,73920
7483,203301,205701,120,72060,3,"""3""",73920,74040
7483,205701,200301,60,72060,3,"""3""",74040,74100
7483,200301,208700,180,72060,3,"""3""",74100,74280
7691,404702,32100,0,76860,3,"""41""",76860,76860
7691,32100,406001,60,76860,3,"""41""",76860,76920
7691,406001,302602,60,76860,3,"""41""",76920,76980
7691,302602,406701,60,76860,3,"""41""",76980,77040
7691,406701,406902,60,76860,3,"""41""",77040,77100
7691,406902,407909,60,76860,3,"""41""",77100,77160
7691,407909,405001,180,76860,3,"""41""",77160,77340
7691,405001,33604,60,76860,3,"""41""",77340,77400
7691,33604,408602,120,76860,3,"""41""",77400,77520
7691,408602,404400,60,76860,3,"""41""",77520,77580
7691,404400,408603,60,76860,3,"""41""",77580,77640
7691,408603,407801,60,76860,3,"""41""",77640,77700
7691,407801,400301,60,76860,3,"""41""",77700,77760
7691,400301,401202,0,76860,3,"""41""",77760,77760
7691,401202,400101,60,76860,3,"""41""",77760,77820
7691,400101,407302,60,76860,3,"""41""",77820,77880
7691,407302,408202,60,76860,3,"""41""",77880,77940
7691,408202,403104,60,76860,3,"""41""",77940,78000
7691,403104,112103,120,76860,3,"""41""",78000,78120
7691,112103,103001,180,76860,3,"""41""",78120,78300
7691,103001,8001,120,76860,3,"""41""",78300,78420
7691,8001,105001,60,76860,3,"""41""",78420,78480
7691,105001,34103,60,76860,3,"""41""",78480,78540
7691,34103,208102,120,76860,3,"""41""",78540,78660
7691,208102,201502,120,76860,3,"""41""",78660,78780
7691,201502,203904,120,76860,3,"""41""",78780,78900
7691,203904,204802,60,76860,3,"""41""",78900,78960
7691,204802,204702,60,76860,3,"""41""",78960,79020
7691,204702,202801,60,76860,3,"""41""",79020,79080
7691,202801,205201,60,76860,3,"""41""",79080,79140
7691,205201,205105,60,76860,3,"""41""",79140,79200
7691,205105,207704,60,76860,3,"""41""",79200,79260
7691,207704,207502,60,76860,3,"""41""",79260,79320
7691,207502,202501,60,76860,3,"""41""",79320,79380
7691,202501,205300,120,76860,3,"""41""",79380,79500
7691,404702,32100,0,80460,3,"""41""",80460,80460
7691,32100,406001,60,80460,3,"""41""",80460,80520
7691,406001,302602,60,80460,3,"""41""",80520,80580
7691,302602,406701,60,80460,3,"""41""",80580,80640
7691,406701,406902,60,80460,3,"""41""",80640,80700
7691,406902,407909,60,80460,3,"""41""",80700,80760
7691,407909,405001,180,80460,3,"""41""",80760,80940
7691,405001,33604,60,80460,3,"""41""",80940,81000
7691,33604,408602,120,80460,3,"""41""",81000,81120
7691,408602,404400,60,80460,3,"""41""",81120,81180
7691,404400,408603,60,80460,3,"""41""",81180,81240
7691,408603,407801,60,80460,3,"""41""",81240,81300
7691,407801,400301,60,80460,3,"""41""",81300,81360
7691,400301,401202,0,80460,3,"""41""",81360,81360
7691,401202,400101,60,80460,3,"""41""",81360,81420
7691,400101,407302,60,80460,3,"""41""",81420,81480
7691,407302,408202,60,80460,3,"""41""",81480,81540
7691,408202,403104,60,80460,3,"""41""",81540,81600
7691,403104,112103,120,80460,3,"""41""",81600,81720
7691,112103,103001,180,80460,3,"""41""",81720,81900
7691,103001,8001,120,80460,3,"""41""",81900,82020
7691,8001,105001,60,80460,3,"""41""",82020,82080
7691,105001,34103,60,80460,3,"""41""",82080,82140
7691,34103,208102,120,80460,3,"""41""",82140,82260
7691,208102,201502,120,80460,3,"""41""",82260,82380
7691,201502,203904,120,80460,3,"""41""",82380,82500
7691,203904,204802,60,80460,3,"""41""",82500,82560
7691,204802,204702,60,80460,3,"""41""",82560,82620
7691,204702,202801,60,80460,3,"""41""",82620,82680
7691,202801,205201,60,80460,3,"""41""",82680,82740
7691,205201,205105,60,80460,3,"""41""",82740,82800
7691,205105,207704,60,80460,3,"""41""",82800,82860
7691,207704,207502,60,80460,3,"""41""",82860,82920
7691,207502,202501,60,80460,3,"""41""",82920,82980
7691,202501,205300,120,80460,3,"""41""",82980,83100
7695,208700,200302,60,72300,3,"""2""",72300,72360
7695,200302,205702,60,72300,3,"""2""",72360,72420
7695,205702,203302,60,72300,3,"""2""",72420,72480
7695,203302,201402,60,72300,3,"""2""",72480,72540
7695,201402,205103,120,72300,3,"""2""",72540,72660
7695,205103,205202,60,72300,3,"""2""",72660,72720
7695,205202,202802,60,72300,3,"""2""",72720,72780
7695,202802,204700,60,72300,3,"""2""",72780,72840
7695,204700,204801,60,72300,3,"""2""",72840,72900
7695,204801,203900,120,72300,3,"""2""",72900,73020
7695,203900,201503,60,72300,3,"""2""",73020,73080
7695,201503,208103,60,72300,3,"""2""",73080,73140
7695,208103,34104,60,72300,3,"""2""",73140,73200
7695,34104,105002,60,72300,3,"""2""",73200,73260
7695,105002,8002,60,72300,3,"""2""",73260,73320
7695,8002,103005,120,72300,3,"""2""",73320,73440
7695,103005,112104,180,72300,3,"""2""",73440,73620
7695,112104,403101,120,72300,3,"""2""",73620,73740
7695,403101,408203,60,72300,3,"""2""",73740,73800
7695,408203,407303,60,72300,3,"""2""",73800,73860
7695,407303,400102,60,72300,3,"""2""",73860,73920
7695,400102,401203,60,72300,3,"""2""",73920,73980
7695,401203,400302,0,72300,3,"""2""",73980,73980
7695,400302,407802,60,72300,3,"""2""",73980,74040
7695,407802,408602,60,72300,3,"""2""",74040,74100
7695,408602,404400,60,72300,3,"""2""",74100,74160
7695,404400,408603,60,72300,3,"""2""",74160,74220
7695,408603,33603,60,72300,3,"""2""",74220,74280
7695,33603,33606,60,72300,3,"""2""",74280,74340
7695,33606,405002,60,72300,3,"""2""",74340,74400
7695,405002,407908,180,72300,3,"""2""",74400,74580
7695,407908,406903,60,72300,3,"""2""",74580,74640
7695,406903,406702,60,72300,3,"""2""",74640,74700
7695,406702,302603,60,72300,3,"""2""",74700,74760
7695,302603,406002,60,72300,3,"""2""",74760,74820
7695,406002,404702,180,72300,3,"""2""",74820,75000
7695,208700,200302,60,75900,3,"""2""",75900,75960
7695,200302,205702,60,75900,3,"""2""",75960,76020
7695,205702,203302,60,75900,3,"""2""",76020,76080
7695,203302,201402,60,75900,3,"""2""",76080,76140
7695,201402,205103,120,75900,3,"""2""",76140,76260
7695,205103,205202,60,75900,3,"""2""",76260,76320
7695,205202,202802,60,75900,3,"""2""",76320,76380
7695,202802,204700,60,75900,3,"""2""",76380,76440
7695,204700,204801,60,75900,3,"""2""",76440,76500
7695,204801,203900,120,75900,3,"""2""",76500,76620
7695,203900,201503,60,75900,3,"""2""",76620,76680
7695,201503,208103,60,75900,3,"""2""",76680,76740
7695,208103,34104,60,75900,3,"""2""",76740,76800
7695,34104,105002,60,75900,3,"""2""",76800,76860
7695,105002,8002,60,75900,3,"""2""",76860,76920
7695,8002,103005,120,75900,3,"""2""",76920,77040
7695,103005,112104,180,75900,3,"""2""",77040,77220
7695,112104,403101,120,75900,3,"""2""",77220,77340
7695,403101,408203,60,75900,3,"""2""",77340,77400
7695,408203,407303,60,75900,3,"""2""",77400,77460
7695,407303,400102,60,75900,3,"""2""",77460,77520
7695,400102,401203,60,75900,3,"""2""",77520,77580
7695,401203,400302,0,75900,3,"""2""",77580,77580
7695,400302,407802,60,75900,3,"""2""",77580,77640
7695,407802,408602,60,75900,3,"""2""",77640,77700
7695,408602,404400,60,75900,3,"""2""",77700,77760
7695,404400,408603,60,75900,3,"""2""",77760,77820
7695,408603,33603,60,75900,3,"""2""",77820,77880
7695,33603,33606,60,75900,3,"""2""",77880,77940
7695,33606,405002,60,75900,3,"""2""",77940,78000
7695,405002,407908,180,75900,3,"""2""",78000,78180
7695,407908,406903,60,75900,3,"""2""",78180,78240
7695,406903,406702,60,75900,3,"""2""",78240,78300
7695,406702,302603,60,75900,3,"""2""",78300,78360
7695,302603,406002,60,75900,3,"""2""",78360,78420
7695,406002,404702,180,75900,3,"""2""",78420,78600
7695,208700,200302,60,79500,3,"""2""",79500,79560
7695,200302,205702,60,79500,3,"""2""",79560,79620
7695,205702,203302,60,79500,3,"""2""",79620,79680
7695,203302,201402,60,79500,3,"""2""",79680,79740
7695,201402,205103,120,79500,3,"""2""",79740,79860
7695,205103,205202,60,79500,3,"""2""",79860,79920
7695,205202,202802,60,79500,3,"""2""",79920,79980
7695,202802,204700,60,79500,3,"""2""",79980,80040
7695,204700,204801,60,79500,3,"""2""",80040,80100
7695,204801,203900,120,79500,3,"""2""",80100,80220
7695,203900,201503,60,79500,3,"""2""",80220,80280
7695,201503,208103,60,79500,3,"""2""",80280,80340
7695,208103,34104,60,79500,3,"""2""",80340,80400
7695,34104,105002,60,79500,3,"""2""",80400,80460
7695,105002,8002,60,79500,3,"""2""",80460,80520
7695,8002,103005,120,79500,3,"""2""",80520,80640
7695,103005,112104,180,79500,3,"""2""",80640,80820
7695,112104,403101,120,79500,3,"""2""",80820,80940
7695,403101,408203,60,79500,3,"""2""",80940,81000
7695,408203,407303,60,79500,3,"""2""",81000,81060
7695,407303,400102,60,79500,3,"""2""",81060,81120
7695,400102,401203,60,79500,3,"""2""",81120,81180
7695,401203,400302,0,79500,3,"""2""",81180,81180
7695,400302,407802,60,79500,3,"""2""",81180,81240
7695,407802,408602,60,79500,3,"""2""",81240,81300
7695,408602,404400,60,79500,3,"""2""",81300,81360
7695,404400,408603,60,79500,3,"""2""",81360,81420
7695,408603,33603,60,79500,3,"""2""",81420,81480
7695,33603,33606,60,79500,3,"""2""",81480,81540
7695,33606,405002,60,79500,3,"""2""",81540,81600
7695,405002,407908,180,79500,3,"""2""",81600,81780
7695,407908,406903,60,79500,3,"""2""",81780,81840
7695,406903,406702,60,79500,3,"""2""",81840,81900
7695,406702,302603,60,79500,3,"""2""",81900,81960
7695,302603,406002,60,79500,3,"""2""",81960,82020
7695,406002,404702,180,79500,3,"""2""",82020,82200
7695,208700,200302,60,83100,3,"""2""",83100,83160
7695,200302,205702,60,83100,3,"""2""",83160,83220
7695,205702,203302,60,83100,3,"""2""",83220,83280
7695,203302,201402,60,83100,3,"""2""",83280,83340
7695,201402,205103,120,83100,3,"""2""",83340,83460
7695,205103,205202,60,83100,3,"""2""",83460,83520
7695,205202,202802,60,83100,3,"""2""",83520,83580
7695,202802,204700,60,83100,3,"""2""",83580,83640
7695,204700,204801,60,83100,3,"""2""",83640,83700
7695,204801,203900,120,83100,3,"""2""",83700,83820
7695,203900,201503,60,83100,3,"""2""",83820,83880
7695,201503,208103,60,83100,3,"""2""",83880,83940
7695,208103,34104,60,83100,3,"""2""",83940,84000
7695,34104,105002,60,83100,3,"""2""",84000,84060
7695,105002,8002,60,83100,3,"""2""",84060,84120
7695,8002,103005,120,83100,3,"""2""",84120,84240
7695,103005,112104,180,83100,3,"""2""",84240,84420
7695,112104,403101,120,83100,3,"""2""",84420,84540
7695,403101,408203,60,83100,3,"""2""",84540,84600
7695,408203,407303,60,83100,3,"""2""",84600,84660
7695,407303,400102,60,83100,3,"""2""",84660,84720
7695,400102,401203,60,83100,3,"""2""",84720,84780
7695,401203,400302,0,83100,3,"""2""",84780,84780
7695,400302,407802,60,83100,3,"""2""",84780,84840
7695,407802,408602,60,83100,3,"""2""",84840,84900
7695,408602,404400,60,83100,3,"""2""",84900,84960
7695,404400,408603,60,83100,3,"""2""",84960,85020
7695,408603,33603,60,83100,3,"""2""",85020,85080
7695,33603,33606,60,83100,3,"""2""",85080,85140
7695,33606,405002,60,83100,3,"""2""",85140,85200
7695,405002,407908,180,83100,3,"""2""",85200,85380
7695,407908,406903,60,83100,3,"""2""",85380,85440
7695,406903,406702,60,83100,3,"""2""",85440,85500
7695,406702,302603,60,83100,3,"""2""",85500,85560
7695,302603,406002,60,83100,3,"""2""",85560,85620
7695,406002,404702,180,83100,3,"""2""",85620,85800
7702,404702,32100,0,20880,3,"""1""",20880,20880
7702,32100,406001,60,20880,3,"""1""",20880,20940
7702,406001,302602,60,20880,3,"""1""",20940,21000
7702,302602,406701,60,20880,3,"""1""",21000,21060
7702,406701,406902,60,20880,3,"""1""",21060,21120
7702,406902,407909,120,20880,3,"""1""",21120,21240
7702,407909,405001,180,20880,3,"""1""",21240,21420
7702,405001,33604,120,20880,3,"""1""",21420,21540
7702,33604,408602,120,20880,3,"""1""",21540,21660
7702,408602,404400,60,20880,3,"""1""",21660,21720
7702,404400,408603,60,20880,3,"""1""",21720,21780
7702,408603,407801,60,20880,3,"""1""",21780,21840
7702,407801,400301,60,20880,3,"""1""",21840,21900
7702,400301,401202,60,20880,3,"""1""",21900,21960
7702,401202,400101,60,20880,3,"""1""",21960,22020
7702,400101,407302,60,20880,3,"""1""",22020,22080
7702,407302,408202,60,20880,3,"""1""",22080,22140
7702,408202,403104,120,20880,3,"""1""",22140,22260
7702,403104,112103,120,20880,3,"""1""",22260,22380
7702,112103,103001,180,20880,3,"""1""",22380,22560
7702,103001,8001,120,20880,3,"""1""",22560,22680
7702,8001,105001,60,20880,3,"""1""",22680,22740
7702,105001,34103,60,20880,3,"""1""",22740,22800
7702,34103,208102,120,20880,3,"""1""",22800,22920
7702,208102,201502,120,20880,3,"""1""",22920,23040
7702,201502,203904,120,20880,3,"""1""",23040,23160
7702,203904,204802,60,20880,3,"""1""",23160,23220
7702,204802,204702,60,20880,3,"""1""",23220,23280
7702,204702,202801,60,20880,3,"""1""",23280,23340
7702,202801,205201,60,20880,3,"""1""",23340,23400
7702,205201,205102,60,20880,3,"""1""",23400,23460
7702,205102,201401,120,20880,3,"""1""",23460,23580
7702,201401,203301,60,20880,3,"""1""",23580,23640
7702,203301,205701,120,20880,3,"""1""",23640,23760
7702,205701,200301,60,20880,3,"""1""",23760,23820
7702,200301,208700,180,20880,3,"""1""",23820,24000
7702,404702,32100,0,22080,3,"""1""",22080,22080
7702,32100,406001,60,22080,3,"""1""",22080,22140
7702,406001,302602,60,22080,3,"""1""",22140,22200
7702,302602,406701,60,22080,3,"""1""",22200,22260
7702,406701,406902,60,22080,3,"""1""",22260,22320
7702,406902,407909,120,22080,3,"""1""",22320,22440
7702,407909,405001,180,22080,3,"""1""",22440,22620
7702,405001,33604,120,22080,3,"""1""",22620,22740
7702,33604,408602,120,22080,3,"""1""",22740,22860
7702,408602,404400,60,22080,3,"""1""",22860,22920
7702,404400,408603,60,22080,3,"""1""",22920,22980
7702,408603,407801,60,22080,3,"""1""",22980,23040
7702,407801,400301,60,22080,3,"""1""",23040,23100
7702,400301,401202,60,22080,3,"""1""",23100,23160
7702,401202,400101,60,22080,3,"""1""",23160,23220
7702,400101,407302,60,22080,3,"""1""",23220,23280
7702,407302,408202,60,22080,3,"""1""",23280,23340
7702,408202,403104,120,22080,3,"""1""",23340,23460
7702,403104,112103,120,22080,3,"""1""",23460,23580
7702,112103,103001,180,22080,3,"""1""",23580,23760
7702,103001,8001,120,22080,3,"""1""",23760,23880
7702,8001,105001,60,22080,3,"""1""",23880,23940
7702,105001,34103,60,22080,3,"""1""",23940,24000
7702,34103,208102,120,22080,3,"""1""",24000,24120
7702,208102,201502,120,22080,3,"""1""",24120,24240
7702,201502,203904,120,22080,3,"""1""",24240,24360
7702,203904,204802,60,22080,3,"""1""",24360,24420
7702,204802,204702,60,22080,3,"""1""",24420,24480
7702,204702,202801,60,22080,3,"""1""",24480,24540
7702,202801,205201,60,22080,3,"""1""",24540,24600
7702,205201,205102,60,22080,3,"""1""",24600,24660
7702,205102,201401,120,22080,3,"""1""",24660,24780
7702,201401,203301,60,22080,3,"""1""",24780,24840
7702,203301,205701,120,22080,3,"""1""",24840,24960
7702,205701,200301,60,22080,3,"""1""",24960,25020
7702,200301,208700,180,22080,3,"""1""",25020,25200
7702,404702,32100,0,23280,3,"""1""",23280,23280
7702,32100,406001,60,23280,3,"""1""",23280,23340
7702,406001,302602,60,23280,3,"""1""",23340,23400
7702,302602,406701,60,23280,3,"""1""",23400,23460
7702,406701,406902,60,23280,3,"""1""",23460,23520
7702,406902,407909,120,23280,3,"""1""",23520,23640
7702,407909,405001,180,23280,3,"""1""",23640,23820
7702,405001,33604,120,23280,3,"""1""",23820,23940
7702,33604,408602,120,23280,3,"""1""",23940,24060
7702,408602,404400,60,23280,3,"""1""",24060,24120
7702,404400,408603,60,23280,3,"""1""",24120,24180
7702,408603,407801,60,23280,3,"""1""",24180,24240
7702,407801,400301,60,23280,3,"""1""",24240,24300
7702,400301,401202,60,23280,3,"""1""",24300,24360
7702,401202,400101,60,23280,3,"""1""",24360,24420
7702,400101,407302,60,23280,3,"""1""",24420,24480
7702,407302,408202,60,23280,3,"""1""",24480,24540
7702,408202,403104,120,23280,3,"""1""",24540,24660
7702,403104,112103,120,23280,3,"""1""",24660,24780
7702,112103,103001,180,23280,3,"""1""",24780,24960
7702,103001,8001,120,23280,3,"""1""",24960,25080
7702,8001,105001,60,23280,3,"""1""",25080,25140
7702,105001,34103,60,23280,3,"""1""",25140,25200
7702,34103,208102,120,23280,3,"""1""",25200,25320
7702,208102,201502,120,23280,3,"""1""",25320,25440
7702,201502,203904,120,23280,3,"""1""",25440,25560
7702,203904,204802,60,23280,3,"""1""",25560,25620
7702,204802,204702,60,23280,3,"""1""",25620,25680
7702,204702,202801,60,23280,3,"""1""",25680,25740
7702,202801,205201,60,23280,3,"""1""",25740,25800
7702,205201,205102,60,23280,3,"""1""",25800,25860
7702,205102,201401,120,23280,3,"""1""",25860,25980
7702,201401,203301,60,23280,3,"""1""",25980,26040
7702,203301,205701,120,23280,3,"""1""",26040,26160
7702,205701,200301,60,23280,3,"""1""",26160,26220
7702,200301,208700,180,23280,3,"""1""",26220,26400
7702,404702,32100,0,24480,3,"""1""",24480,24480
7702,32100,406001,60,24480,3,"""1""",24480,24540
7702,406001,302602,60,24480,3,"""1""",24540,24600
7702,302602,406701,60,24480,3,"""1""",24600,24660
7702,406701,406902,60,24480,3,"""1""",24660,24720
7702,406902,407909,120,24480,3,"""1""",24720,24840
7702,407909,405001,180,24480,3,"""1""",24840,25020
7702,405001,33604,120,24480,3,"""1""",25020,25140
7702,33604,408602,120,24480,3,"""1""",25140,25260
7702,408602,404400,60,24480,3,"""1""",25260,25320
7702,404400,408603,60,24480,3,"""1""",25320,25380
7702,408603,407801,60,24480,3,"""1""",25380,25440
7702,407801,400301,60,24480,3,"""1""",25440,25500
7702,400301,401202,60,24480,3,"""1""",25500,25560
7702,401202,400101,60,24480,3,"""1""",25560,25620
7702,400101,407302,60,24480,3,"""1""",25620,25680
7702,407302,408202,60,24480,3,"""1""",25680,25740
7702,408202,403104,120,24480,3,"""1""",25740,25860
7702,403104,112103,120,24480,3,"""1""",25860,25980
7702,112103,103001,180,24480,3,"""1""",25980,26160
7702,103001,8001,120,24480,3,"""1""",26160,26280
7702,8001,105001,60,24480,3,"""1""",26280,26340
7702,105001,34103,60,24480,3,"""1""",26340,26400
7702,34103,208102,120,24480,3,"""1""",26400,26520
7702,208102,201502,120,24480,3,"""1""",26520,26640
7702,201502,203904,120,24480,3,"""1""",26640,26760
7702,203904,204802,60,24480,3,"""1""",26760,26820
7702,204802,204702,60,24480,3,"""1""",26820,26880
7702,204702,202801,60,24480,3,"""1""",26880,26940
7702,202801,205201,60,24480,3,"""1""",26940,27000
7702,205201,205102,60,24480,3,"""1""",27000,27060
7702,205102,201401,120,24480,3,"""1""",27060,27180
7702,201401,203301,60,24480,3,"""1""",27180,27240
7702,203301,205701,120,24480,3,"""1""",27240,27360
7702,205701,200301,60,24480,3,"""1""",27360,27420
7702,200301,208700,180,24480,3,"""1""",27420,27600
7702,404702,32100,0,25680,3,"""1""",25680,25680
7702,32100,406001,60,25680,3,"""1""",25680,25740
7702,406001,302602,60,25680,3,"""1""",25740,25800
7702,302602,406701,60,25680,3,"""1""",25800,25860
7702,406701,406902,60,25680,3,"""1""",25860,25920
7702,406902,407909,120,25680,3,"""1""",25920,26040
7702,407909,405001,180,25680,3,"""1""",26040,26220
7702,405001,33604,120,25680,3,"""1""",26220,26340
7702,33604,408602,120,25680,3,"""1""",26340,26460
7702,408602,404400,60,25680,3,"""1""",26460,26520
7702,404400,408603,60,25680,3,"""1""",26520,26580
7702,408603,407801,60,25680,3,"""1""",26580,26640
7702,407801,400301,60,25680,3,"""1""",26640,26700
7702,400301,401202,60,25680,3,"""1""",26700,26760
7702,401202,400101,60,25680,3,"""1""",26760,26820
7702,400101,407302,60,25680,3,"""1""",26820,26880
7702,407302,408202,60,25680,3,"""1""",26880,26940
7702,408202,403104,120,25680,3,"""1""",26940,27060
7702,403104,112103,120,25680,3,"""1""",27060,27180
7702,112103,103001,180,25680,3,"""1""",27180,27360
7702,103001,8001,120,25680,3,"""1""",27360,27480
7702,8001,105001,60,25680,3,"""1""",27480,27540
7702,105001,34103,60,25680,3,"""1""",27540,27600
7702,34103,208102,120,25680,3,"""1""",27600,27720
7702,208102,201502,120,25680,3,"""1""",27720,27840
7702,201502,203904,120,25680,3,"""1""",27840,27960
7702,203904,204802,60,25680,3,"""1""",27960,28020
7702,204802,204702,60,25680,3,"""1""",28020,28080
7702,204702,202801,60,25680,3,"""1""",28080,28140
7702,202801,205201,60,25680,3,"""1""",28140,28200
7702,205201,205102,60,25680,3,"""1""",28200,28260
7702,205102,201401,120,25680,3,"""1""",28260,28380
7702,201401,203301,60,25680,3,"""1""",28380,28440
7702,203301,205701,120,25680,3,"""1""",28440,28560
7702,205701,200301,60,25680,3,"""1""",28560,28620
7702,200301,208700,180,25680,3,"""1""",28620,28800
7702,404702,32100,0,26880,3,"""1""",26880,26880
7702,32100,406001,60,26880,3,"""1""",26880,26940
7702,406001,302602,60,26880,3,"""1""",26940,27000
7702,302602,406701,60,26880,3,"""1""",27000,27060
7702,406701,406902,60,26880,3,"""1""",27060,27120
7702,406902,407909,120,26880,3,"""1""",27120,27240
7702,407909,405001,180,26880,3,"""1""",27240,27420
7702,405001,33604,120,26880,3,"""1""",27420,27540
7702,33604,408602,120,26880,3,"""1""",27540,27660
7702,408602,404400,60,26880,3,"""1""",27660,27720
7702,404400,408603,60,26880,3,"""1""",27720,27780
7702,408603,407801,60,26880,3,"""1""",27780,27840
7702,407801,400301,60,26880,3,"""1""",27840,27900
7702,400301,401202,60,26880,3,"""1""",27900,27960
7702,401202,400101,60,26880,3,"""1""",27960,28020
7702,400101,407302,60,26880,3,"""1""",28020,28080
7702,407302,408202,60,26880,3,"""1""",28080,28140
7702,408202,403104,120,26880,3,"""1""",28140,28260
7702,403104,112103,120,26880,3,"""1""",28260,28380
7702,112103,103001,180,26880,3,"""1""",28380,28560
7702,103001,8001,120,26880,3,"""1""",28560,28680
7702,8001,105001,60,26880,3,"""1""",28680,28740
7702,105001,34103,60,26880,3,"""1""",28740,28800
7702,34103,208102,120,26880,3,"""1""",28800,28920
7702,208102,201502,120,26880,3,"""1""",28920,29040
7702,201502,203904,120,26880,3,"""1""",29040,29160
7702,203904,204802,60,26880,3,"""1""",29160,29220
7702,204802,204702,60,26880,3,"""1""",29220,29280
7702,204702,202801,60,26880,3,"""1""",29280,29340
7702,202801,205201,60,26880,3,"""1""",29340,29400
7702,205201,205102,60,26880,3,"""1""",29400,29460
7702,205102,201401,120,26880,3,"""1""",29460,29580
7702,201401,203301,60,26880,3,"""1""",29580,29640
7702,203301,205701,120,26880,3,"""1""",29640,29760
7702,205701,200301,60,26880,3,"""1""",29760,29820
7702,200301,208700,180,26880,3,"""1""",29820,30000
7702,404702,32100,0,28080,3,"""1""",28080,28080
7702,32100,406001,60,28080,3,"""1""",28080,28140
7702,406001,302602,60,28080,3,"""1""",28140,28200
7702,302602,406701,60,28080,3,"""1""",28200,28260
7702,406701,406902,60,28080,3,"""1""",28260,28320
7702,406902,407909,120,28080,3,"""1""",28320,28440
7702,407909,405001,180,28080,3,"""1""",28440,28620
7702,405001,33604,120,28080,3,"""1""",28620,28740
7702,33604,408602,120,28080,3,"""1""",28740,28860
7702,408602,404400,60,28080,3,"""1""",28860,28920
7702,404400,408603,60,28080,3,"""1""",28920,28980
7702,408603,407801,60,28080,3,"""1""",28980,29040
7702,407801,400301,60,28080,3,"""1""",29040,29100
7702,400301,401202,60,28080,3,"""1""",29100,29160
7702,401202,400101,60,28080,3,"""1""",29160,29220
7702,400101,407302,60,28080,3,"""1""",29220,29280
7702,407302,408202,60,28080,3,"""1""",29280,29340
7702,408202,403104,120,28080,3,"""1""",29340,29460
7702,403104,112103,120,28080,3,"""1""",29460,29580
7702,112103,103001,180,28080,3,"""1""",29580,29760
7702,103001,8001,120,28080,3,"""1""",29760,29880
7702,8001,105001,60,28080,3,"""1""",29880,29940
7702,105001,34103,60,28080,3,"""1""",29940,30000
7702,34103,208102,120,28080,3,"""1""",30000,30120
7702,208102,201502,120,28080,3,"""1""",30120,30240
7702,201502,203904,120,28080,3,"""1""",30240,30360
7702,203904,204802,60,28080,3,"""1""",30360,30420
7702,204802,204702,60,28080,3,"""1""",30420,30480
7702,204702,202801,60,28080,3,"""1""",30480,30540
7702,202801,205201,60,28080,3,"""1""",30540,30600
7702,205201,205102,60,28080,3,"""1""",30600,30660
7702,205102,201401,120,28080,3,"""1""",30660,30780
7702,201401,203301,60,28080,3,"""1""",30780,30840
7702,203301,205701,120,28080,3,"""1""",30840,30960
7702,205701,200301,60,28080,3,"""1""",30960,31020
7702,200301,208700,180,28080,3,"""1""",31020,31200
7702,404702,32100,0,29280,3,"""1""",29280,29280
7702,32100,406001,60,29280,3,"""1""",29280,29340
7702,406001,302602,60,29280,3,"""1""",29340,29400
7702,302602,406701,60,29280,3,"""1""",29400,29460
7702,406701,406902,60,29280,3,"""1""",29460,29520
7702,406902,407909,120,29280,3,"""1""",29520,29640
7702,407909,405001,180,29280,3,"""1""",29640,29820
7702,405001,33604,120,29280,3,"""1""",29820,29940
7702,33604,408602,120,29280,3,"""1""",29940,30060
7702,408602,404400,60,29280,3,"""1""",30060,30120
7702,404400,408603,60,29280,3,"""1""",30120,30180
7702,408603,407801,60,29280,3,"""1""",30180,30240
7702,407801,400301,60,29280,3,"""1""",30240,30300
7702,400301,401202,60,29280,3,"""1""",30300,30360
7702,401202,400101,60,29280,3,"""1""",30360,30420
7702,400101,407302,60,29280,3,"""1""",30420,30480
7702,407302,408202,60,29280,3,"""1""",30480,30540
7702,408202,403104,120,29280,3,"""1""",30540,30660
7702,403104,112103,120,29280,3,"""1""",30660,30780
7702,112103,103001,180,29280,3,"""1""",30780,30960
7702,103001,8001,120,29280,3,"""1""",30960,31080
7702,8001,105001,60,29280,3,"""1""",31080,31140
7702,105001,34103,60,29280,3,"""1""",31140,31200
7702,34103,208102,120,29280,3,"""1""",31200,31320
7702,208102,201502,120,29280,3,"""1""",31320,31440
7702,201502,203904,120,29280,3,"""1""",31440,31560
7702,203904,204802,60,29280,3,"""1""",31560,31620
7702,204802,204702,60,29280,3,"""1""",31620,31680
7702,204702,202801,60,29280,3,"""1""",31680,31740
7702,202801,205201,60,29280,3,"""1""",31740,31800
7702,205201,205102,60,29280,3,"""1""",31800,31860
7702,205102,201401,120,29280,3,"""1""",31860,31980
7702,201401,203301,60,29280,3,"""1""",31980,32040
7702,203301,205701,120,29280,3,"""1""",32040,32160
7702,205701,200301,60,29280,3,"""1""",32160,32220
7702,200301,208700,180,29280,3,"""1""",32220,32400
7702,404702,32100,0,30480,3,"""1""",30480,30480
7702,32100,406001,60,30480,3,"""1""",30480,30540
7702,406001,302602,60,30480,3,"""1""",30540,30600
7702,302602,406701,60,30480,3,"""1""",30600,30660
7702,406701,406902,60,30480,3,"""1""",30660,30720
7702,406902,407909,120,30480,3,"""1""",30720,30840
7702,407909,405001,180,30480,3,"""1""",30840,31020
7702,405001,33604,120,30480,3,"""1""",31020,31140
7702,33604,408602,120,30480,3,"""1""",31140,31260
7702,408602,404400,60,30480,3,"""1""",31260,31320
7702,404400,408603,60,30480,3,"""1""",31320,31380
7702,408603,407801,60,30480,3,"""1""",31380,31440
7702,407801,400301,60,30480,3,"""1""",31440,31500
7702,400301,401202,60,30480,3,"""1""",31500,31560
7702,401202,400101,60,30480,3,"""1""",31560,31620
7702,400101,407302,60,30480,3,"""1""",31620,31680
7702,407302,408202,60,30480,3,"""1""",31680,31740
7702,408202,403104,120,30480,3,"""1""",31740,31860
7702,403104,112103,120,30480,3,"""1""",31860,31980
7702,112103,103001,180,30480,3,"""1""",31980,32160
7702,103001,8001,120,30480,3,"""1""",32160,32280
7702,8001,105001,60,30480,3,"""1""",32280,32340
7702,105001,34103,60,30480,3,"""1""",32340,32400
7702,34103,208102,120,30480,3,"""1""",32400,32520
7702,208102,201502,120,30480,3,"""1""",32520,32640
7702,201502,203904,120,30480,3,"""1""",32640,32760
7702,203904,204802,60,30480,3,"""1""",32760,32820
7702,204802,204702,60,30480,3,"""1""",32820,32880
7702,204702,202801,60,30480,3,"""1""",32880,32940
7702,202801,205201,60,30480,3,"""1""",32940,33000
7702,205201,205102,60,30480,3,"""1""",33000,33060
7702,205102,201401,120,30480,3,"""1""",33060,33180
7702,201401,203301,60,30480,3,"""1""",33180,33240
7702,203301,205701,120,30480,3,"""1""",33240,33360
7702,205701,200301,60,30480,3,"""1""",33360,33420
7702,200301,208700,180,30480,3,"""1""",33420,33600
7702,404702,32100,0,31680,3,"""1""",31680,31680
7702,32100,406001,60,31680,3,"""1""",31680,31740
7702,406001,302602,60,31680,3,"""1""",31740,31800
7702,302602,406701,60,31680,3,"""1""",31800,31860
7702,406701,406902,60,31680,3,"""1""",31860,31920
7702,406902,407909,120,31680,3,"""1""",31920,32040
7702,407909,405001,180,31680,3,"""1""",32040,32220
7702,405001,33604,120,31680,3,"""1""",32220,32340
7702,33604,408602,120,31680,3,"""1""",32340,32460
7702,408602,404400,60,31680,3,"""1""",32460,32520
7702,404400,408603,60,31680,3,"""1""",32520,32580
7702,408603,407801,60,31680,3,"""1""",32580,32640
7702,407801,400301,60,31680,3,"""1""",32640,32700
7702,400301,401202,60,31680,3,"""1""",32700,32760
7702,401202,400101,60,31680,3,"""1""",32760,32820
7702,400101,407302,60,31680,3,"""1""",32820,32880
7702,407302,408202,60,31680,3,"""1""",32880,32940
7702,408202,403104,120,31680,3,"""1""",32940,33060
7702,403104,112103,120,31680,3,"""1""",33060,33180
7702,112103,103001,180,31680,3,"""1""",33180,33360
7702,103001,8001,120,31680,3,"""1""",33360,33480
7702,8001,105001,60,31680,3,"""1""",33480,33540
7702,105001,34103,60,31680,3,"""1""",33540,33600
7702,34103,208102,120,31680,3,"""1""",33600,33720
7702,208102,201502,120,31680,3,"""1""",33720,33840
7702,201502,203904,120,31680,3,"""1""",33840,33960
7702,203904,204802,60,31680,3,"""1""",33960,34020
7702,204802,204702,60,31680,3,"""1""",34020,34080
7702,204702,202801,60,31680,3,"""1""",34080,34140
7702,202801,205201,60,31680,3,"""1""",34140,34200
7702,205201,205102,60,31680,3,"""1""",34200,34260
7702,205102,201401,120,31680,3,"""1""",34260,34380
7702,201401,203301,60,31680,3,"""1""",34380,34440
7702,203301,205701,120,31680,3,"""1""",34440,34560
7702,205701,200301,60,31680,3,"""1""",34560,34620
7702,200301,208700,180,31680,3,"""1""",34620,34800
7702,404702,32100,0,32880,3,"""1""",32880,32880
7702,32100,406001,60,32880,3,"""1""",32880,32940
7702,406001,302602,60,32880,3,"""1""",32940,33000
7702,302602,406701,60,32880,3,"""1""",33000,33060
7702,406701,406902,60,32880,3,"""1""",33060,33120
7702,406902,407909,120,32880,3,"""1""",33120,33240
7702,407909,405001,180,32880,3,"""1""",33240,33420
7702,405001,33604,120,32880,3,"""1""",33420,33540
7702,33604,408602,120,32880,3,"""1""",33540,33660
7702,408602,404400,60,32880,3,"""1""",33660,33720
7702,404400,408603,60,32880,3,"""1""",33720,33780
7702,408603,407801,60,32880,3,"""1""",33780,33840
7702,407801,400301,60,32880,3,"""1""",33840,33900
7702,400301,401202,60,32880,3,"""1""",33900,33960
7702,401202,400101,60,32880,3,"""1""",33960,34020
7702,400101,407302,60,32880,3,"""1""",34020,34080
7702,407302,408202,60,32880,3,"""1""",34080,34140
7702,408202,403104,120,32880,3,"""1""",34140,34260
7702,403104,112103,120,32880,3,"""1""",34260,34380
7702,112103,103001,180,32880,3,"""1""",34380,34560
7702,103001,8001,120,32880,3,"""1""",34560,34680
7702,8001,105001,60,32880,3,"""1""",34680,34740
7702,105001,34103,60,32880,3,"""1""",34740,34800
7702,34103,208102,120,32880,3,"""1""",34800,34920
7702,208102,201502,120,32880,3,"""1""",34920,35040
7702,201502,203904,120,32880,3,"""1""",35040,35160
7702,203904,204802,60,32880,3,"""1""",35160,35220
7702,204802,204702,60,32880,3,"""1""",35220,35280
7702,204702,202801,60,32880,3,"""1""",35280,35340
7702,202801,205201,60,32880,3,"""1""",35340,35400
7702,205201,205102,60,32880,3,"""1""",35400,35460
7702,205102,201401,120,32880,3,"""1""",35460,35580
7702,201401,203301,60,32880,3,"""1""",35580,35640
7702,203301,205701,120,32880,3,"""1""",35640,35760
7702,205701,200301,60,32880,3,"""1""",35760,35820
7702,200301,208700,180,32880,3,"""1""",35820,36000
7702,404702,32100,0,34080,3,"""1""",34080,34080
7702,32100,406001,60,34080,3,"""1""",34080,34140
7702,406001,302602,60,34080,3,"""1""",34140,34200
7702,302602,406701,60,34080,3,"""1""",34200,34260
7702,406701,406902,60,34080,3,"""1""",34260,34320
7702,406902,407909,120,34080,3,"""1""",34320,34440
7702,407909,405001,180,34080,3,"""1""",34440,34620
7702,405001,33604,120,34080,3,"""1""",34620,34740
7702,33604,408602,120,34080,3,"""1""",34740,34860
7702,408602,404400,60,34080,3,"""1""",34860,34920
7702,404400,408603,60,34080,3,"""1""",34920,34980
7702,408603,407801,60,34080,3,"""1""",34980,35040
7702,407801,400301,60,34080,3,"""1""",35040,35100
7702,400301,401202,60,34080,3,"""1""",35100,35160
7702,401202,400101,60,34080,3,"""1""",35160,35220
7702,400101,407302,60,34080,3,"""1""",35220,35280
7702,407302,408202,60,34080,3,"""1""",35280,35340
7702,408202,403104,120,34080,3,"""1""",35340,35460
7702,403104,112103,120,34080,3,"""1""",35460,35580
7702,112103,103001,180,34080,3,"""1""",35580,35760
7702,103001,8001,120,34080,3,"""1""",35760,35880
7702,8001,105001,60,34080,3,"""1""",35880,35940
7702,105001,34103,60,34080,3,"""1""",35940,36000
7702,34103,208102,120,34080,3,"""1""",36000,36120
7702,208102,201502,120,34080,3,"""1""",36120,36240
7702,201502,203904,120,34080,3,"""1""",36240,36360
7702,203904,204802,60,34080,3,"""1""",36360,36420
7702,204802,204702,60,34080,3,"""1""",36420,36480
7702,204702,202801,60,34080,3,"""1""",36480,36540
7702,202801,205201,60,34080,3,"""1""",36540,36600
7702,205201,205102,60,34080,3,"""1""",36600,36660
7702,205102,201401,120,34080,3,"""1""",36660,36780
7702,201401,203301,60,34080,3,"""1""",36780,36840
7702,203301,205701,120,34080,3,"""1""",36840,36960
7702,205701,200301,60,34080,3,"""1""",36960,37020
7702,200301,208700,180,34080,3,"""1""",37020,37200
7702,404702,32100,0,35280,3,"""1""",35280,35280
7702,32100,406001,60,35280,3,"""1""",35280,35340
7702,406001,302602,60,35280,3,"""1""",35340,35400
7702,302602,406701,60,35280,3,"""1""",35400,35460
7702,406701,406902,60,35280,3,"""1""",35460,35520
7702,406902,407909,120,35280,3,"""1""",35520,35640
7702,407909,405001,180,35280,3,"""1""",35640,35820
7702,405001,33604,120,35280,3,"""1""",35820,35940
7702,33604,408602,120,35280,3,"""1""",35940,36060
7702,408602,404400,60,35280,3,"""1""",36060,36120
7702,404400,408603,60,35280,3,"""1""",36120,36180
7702,408603,407801,60,35280,3,"""1""",36180,36240
7702,407801,400301,60,35280,3,"""1""",36240,36300
7702,400301,401202,60,35280,3,"""1""",36300,36360
7702,401202,400101,60,35280,3,"""1""",36360,36420
7702,400101,407302,60,35280,3,"""1""",36420,36480
7702,407302,408202,60,35280,3,"""1""",36480,36540
7702,408202,403104,120,35280,3,"""1""",36540,36660
7702,403104,112103,120,35280,3,"""1""",36660,36780
7702,112103,103001,180,35280,3,"""1""",36780,36960
7702,103001,8001,120,35280,3,"""1""",36960,37080
7702,8001,105001,60,35280,3,"""1""",37080,37140
7702,105001,34103,60,35280,3,"""1""",37140,37200
7702,34103,208102,120,35280,3,"""1""",37200,37320
7702,208102,201502,120,35280,3,"""1""",37320,37440
7702,201502,203904,120,35280,3,"""1""",37440,37560
7702,203904,204802,60,35280,3,"""1""",37560,37620
7702,204802,204702,60,35280,3,"""1""",37620,37680
7702,204702,202801,60,35280,3,"""1""",37680,37740
7702,202801,205201,60,35280,3,"""1""",37740,37800
7702,205201,205102,60,35280,3,"""1""",37800,37860
7702,205102,201401,120,35280,3,"""1""",37860,37980
7702,201401,203301,60,35280,3,"""1""",37980,38040
7702,203301,205701,120,35280,3,"""1""",38040,38160
7702,205701,200301,60,35280,3,"""1""",38160,38220
7702,200301,208700,180,35280,3,"""1""",38220,38400
7702,404702,32100,0,36480,3,"""1""",36480,36480
7702,32100,406001,60,36480,3,"""1""",36480,36540
7702,406001,302602,60,36480,3,"""1""",36540,36600
7702,302602,406701,60,36480,3,"""1""",36600,36660
7702,406701,406902,60,36480,3,"""1""",36660,36720
7702,406902,407909,120,36480,3,"""1""",36720,36840
7702,407909,405001,180,36480,3,"""1""",36840,37020
7702,405001,33604,120,36480,3,"""1""",37020,37140
7702,33604,408602,120,36480,3,"""1""",37140,37260
7702,408602,404400,60,36480,3,"""1""",37260,37320
7702,404400,408603,60,36480,3,"""1""",37320,37380
7702,408603,407801,60,36480,3,"""1""",37380,37440
7702,407801,400301,60,36480,3,"""1""",37440,37500
7702,400301,401202,60,36480,3,"""1""",37500,37560
7702,401202,400101,60,36480,3,"""1""",37560,37620
7702,400101,407302,60,36480,3,"""1""",37620,37680
7702,407302,408202,60,36480,3,"""1""",37680,37740
7702,408202,403104,120,36480,3,"""1""",37740,37860
7702,403104,112103,120,36480,3,"""1""",37860,37980
7702,112103,103001,180,36480,3,"""1""",37980,38160
7702,103001,8001,120,36480,3,"""1""",38160,38280
7702,8001,105001,60,36480,3,"""1""",38280,38340
7702,105001,34103,60,36480,3,"""1""",38340,38400
7702,34103,208102,120,36480,3,"""1""",38400,38520
7702,208102,201502,120,36480,3,"""1""",38520,38640
7702,201502,203904,120,36480,3,"""1""",38640,38760
7702,203904,204802,60,36480,3,"""1""",38760,38820
7702,204802,204702,60,36480,3,"""1""",38820,38880
7702,204702,202801,60,36480,3,"""1""",38880,38940
7702,202801,205201,60,36480,3,"""1""",38940,39000
7702,205201,205102,60,36480,3,"""1""",39000,39060
7702,205102,201401,120,36480,3,"""1""",39060,39180
7702,201401,203301,60,36480,3,"""1""",39180,39240
7702,203301,205701,120,36480,3,"""1""",39240,39360
7702,205701,200301,60,36480,3,"""1""",39360,39420
7702,200301,208700,180,36480,3,"""1""",39420,39600
7702,404702,32100,0,37680,3,"""1""",37680,37680
7702,32100,406001,60,37680,3,"""1""",37680,37740
7702,406001,302602,60,37680,3,"""1""",37740,37800
7702,302602,406701,60,37680,3,"""1""",37800,37860
7702,406701,406902,60,37680,3,"""1""",37860,37920
7702,406902,407909,120,37680,3,"""1""",37920,38040
7702,407909,405001,180,37680,3,"""1""",38040,38220
7702,405001,33604,120,37680,3,"""1""",38220,38340
7702,33604,408602,120,37680,3,"""1""",38340,38460
7702,408602,404400,60,37680,3,"""1""",38460,38520
7702,404400,408603,60,37680,3,"""1""",38520,38580
7702,408603,407801,60,37680,3,"""1""",38580,38640
7702,407801,400301,60,37680,3,"""1""",38640,38700
7702,400301,401202,60,37680,3,"""1""",38700,38760
7702,401202,400101,60,37680,3,"""1""",38760,38820
7702,400101,407302,60,37680,3,"""1""",38820,38880
7702,407302,408202,60,37680,3,"""1""",38880,38940
7702,408202,403104,120,37680,3,"""1""",38940,39060
7702,403104,112103,120,37680,3,"""1""",39060,39180
7702,112103,103001,180,37680,3,"""1""",39180,39360
7702,103001,8001,120,37680,3,"""1""",39360,39480
7702,8001,105001,60,37680,3,"""1""",39480,39540
7702,105001,34103,60,37680,3,"""1""",39540,39600
7702,34103,208102,120,37680,3,"""1""",39600,39720
7702,208102,201502,120,37680,3,"""1""",39720,39840
7702,201502,203904,120,37680,3,"""1""",39840,39960
7702,203904,204802,60,37680,3,"""1""",39960,40020
7702,204802,204702,60,37680,3,"""1""",40020,40080
7702,204702,202801,60,37680,3,"""1""",40080,40140
7702,202801,205201,60,37680,3,"""1""",40140,40200
7702,205201,205102,60,37680,3,"""1""",40200,40260
7702,205102,201401,120,37680,3,"""1""",40260,40380
7702,201401,203301,60,37680,3,"""1""",40380,40440
7702,203301,205701,120,37680,3,"""1""",40440,40560
7702,205701,200301,60,37680,3,"""1""",40560,40620
7702,200301,208700,180,37680,3,"""1""",40620,40800
7702,404702,32100,0,38880,3,"""1""",38880,38880
7702,32100,406001,60,38880,3,"""1""",38880,38940
7702,406001,302602,60,38880,3,"""1""",38940,39000
7702,302602,406701,60,38880,3,"""1""",39000,39060
7702,406701,406902,60,38880,3,"""1""",39060,39120
7702,406902,407909,120,38880,3,"""1""",39120,39240
7702,407909,405001,180,38880,3,"""1""",39240,39420
7702,405001,33604,120,38880,3,"""1""",39420,39540
7702,33604,408602,120,38880,3,"""1""",39540,39660
7702,408602,404400,60,38880,3,"""1""",39660,39720
7702,404400,408603,60,38880,3,"""1""",39720,39780
7702,408603,407801,60,38880,3,"""1""",39780,39840
7702,407801,400301,60,38880,3,"""1""",39840,39900
7702,400301,401202,60,38880,3,"""1""",39900,39960
7702,401202,400101,60,38880,3,"""1""",39960,40020
7702,400101,407302,60,38880,3,"""1""",40020,40080
7702,407302,408202,60,38880,3,"""1""",40080,40140
7702,408202,403104,120,38880,3,"""1""",40140,40260
7702,403104,112103,120,38880,3,"""1""",40260,40380
7702,112103,103001,180,38880,3,"""1""",40380,40560
7702,103001,8001,120,38880,3,"""1""",40560,40680
7702,8001,105001,60,38880,3,"""1""",40680,40740
7702,105001,34103,60,38880,3,"""1""",40740,40800
7702,34103,208102,120,38880,3,"""1""",40800,40920
7702,208102,201502,120,38880,3,"""1""",40920,41040
7702,201502,203904,120,38880,3,"""1""",41040,41160
7702,203904,204802,60,38880,3,"""1""",41160,41220
7702,204802,204702,60,38880,3,"""1""",41220,41280
7702,204702,202801,60,38880,3,"""1""",41280,41340
7702,202801,205201,60,38880,3,"""1""",41340,41400
7702,205201,205102,60,38880,3,"""1""",41400,41460
7702,205102,201401,120,38880,3,"""1""",41460,41580
7702,201401,203301,60,38880,3,"""1""",41580,41640
7702,203301,205701,120,38880,3,"""1""",41640,41760
7702,205701,200301,60,38880,3,"""1""",41760,41820
7702,200301,208700,180,38880,3,"""1""",41820,42000
7702,404702,32100,0,40080,3,"""1""",40080,40080
7702,32100,406001,60,40080,3,"""1""",40080,40140
7702,406001,302602,60,40080,3,"""1""",40140,40200
7702,302602,406701,60,40080,3,"""1""",40200,40260
7702,406701,406902,60,40080,3,"""1""",40260,40320
7702,406902,407909,120,40080,3,"""1""",40320,40440
7702,407909,405001,180,40080,3,"""1""",40440,40620
7702,405001,33604,120,40080,3,"""1""",40620,40740
7702,33604,408602,120,40080,3,"""1""",40740,40860
7702,408602,404400,60,40080,3,"""1""",40860,40920
7702,404400,408603,60,40080,3,"""1""",40920,40980
7702,408603,407801,60,40080,3,"""1""",40980,41040
7702,407801,400301,60,40080,3,"""1""",41040,41100
7702,400301,401202,60,40080,3,"""1""",41100,41160
7702,401202,400101,60,40080,3,"""1""",41160,41220
7702,400101,407302,60,40080,3,"""1""",41220,41280
7702,407302,408202,60,40080,3,"""1""",41280,41340
7702,408202,403104,120,40080,3,"""1""",41340,41460
7702,403104,112103,120,40080,3,"""1""",41460,41580
7702,112103,103001,180,40080,3,"""1""",41580,41760
7702,103001,8001,120,40080,3,"""1""",41760,41880
7702,8001,105001,60,40080,3,"""1""",41880,41940
7702,105001,34103,60,40080,3,"""1""",41940,42000
7702,34103,208102,120,40080,3,"""1""",42000,42120
7702,208102,201502,120,40080,3,"""1""",42120,42240
7702,201502,203904,120,40080,3,"""1""",42240,42360
7702,203904,204802,60,40080,3,"""1""",42360,42420
7702,204802,204702,60,40080,3,"""1""",42420,42480
7702,204702,202801,60,40080,3,"""1""",42480,42540
7702,202801,205201,60,40080,3,"""1""",42540,42600
7702,205201,205102,60,40080,3,"""1""",42600,42660
7702,205102,201401,120,40080,3,"""1""",42660,42780
7702,201401,203301,60,40080,3,"""1""",42780,42840
7702,203301,205701,120,40080,3,"""1""",42840,42960
7702,205701,200301,60,40080,3,"""1""",42960,43020
7702,200301,208700,180,40080,3,"""1""",43020,43200
7702,404702,32100,0,41280,3,"""1""",41280,41280
7702,32100,406001,60,41280,3,"""1""",41280,41340
7702,406001,302602,60,41280,3,"""1""",41340,41400
7702,302602,406701,60,41280,3,"""1""",41400,41460
7702,406701,406902,60,41280,3,"""1""",41460,41520
7702,406902,407909,120,41280,3,"""1""",41520,41640
7702,407909,405001,180,41280,3,"""1""",41640,41820
7702,405001,33604,120,41280,3,"""1""",41820,41940
7702,33604,408602,120,41280,3,"""1""",41940,42060
7702,408602,404400,60,41280,3,"""1""",42060,42120
7702,404400,408603,60,41280,3,"""1""",42120,42180
7702,408603,407801,60,41280,3,"""1""",42180,42240
7702,407801,400301,60,41280,3,"""1""",42240,42300
7702,400301,401202,60,41280,3,"""1""",42300,42360
7702,401202,400101,60,41280,3,"""1""",42360,42420
7702,400101,407302,60,41280,3,"""1""",42420,42480
7702,407302,408202,60,41280,3,"""1""",42480,42540
7702,408202,403104,120,41280,3,"""1""",42540,42660
7702,403104,112103,120,41280,3,"""1""",42660,42780
7702,112103,103001,180,41280,3,"""1""",42780,42960
7702,103001,8001,120,41280,3,"""1""",42960,43080
7702,8001,105001,60,41280,3,"""1""",43080,43140
7702,105001,34103,60,41280,3,"""1""",43140,43200
7702,34103,208102,120,41280,3,"""1""",43200,43320
7702,208102,201502,120,41280,3,"""1""",43320,43440
7702,201502,203904,120,41280,3,"""1""",43440,43560
7702,203904,204802,60,41280,3,"""1""",43560,43620
7702,204802,204702,60,41280,3,"""1""",43620,43680
7702,204702,202801,60,41280,3,"""1""",43680,43740
7702,202801,205201,60,41280,3,"""1""",43740,43800
7702,205201,205102,60,41280,3,"""1""",43800,43860
7702,205102,201401,120,41280,3,"""1""",43860,43980
7702,201401,203301,60,41280,3,"""1""",43980,44040
7702,203301,205701,120,41280,3,"""1""",44040,44160
7702,205701,200301,60,41280,3,"""1""",44160,44220
7702,200301,208700,180,41280,3,"""1""",44220,44400
7702,404702,32100,0,42480,3,"""1""",42480,42480
7702,32100,406001,60,42480,3,"""1""",42480,42540
7702,406001,302602,60,42480,3,"""1""",42540,42600
7702,302602,406701,60,42480,3,"""1""",42600,42660
7702,406701,406902,60,42480,3,"""1""",42660,42720
7702,406902,407909,120,42480,3,"""1""",42720,42840
7702,407909,405001,180,42480,3,"""1""",42840,43020
7702,405001,33604,120,42480,3,"""1""",43020,43140
7702,33604,408602,120,42480,3,"""1""",43140,43260
7702,408602,404400,60,42480,3,"""1""",43260,43320
7702,404400,408603,60,42480,3,"""1""",43320,43380
7702,408603,407801,60,42480,3,"""1""",43380,43440
7702,407801,400301,60,42480,3,"""1""",43440,43500
7702,400301,401202,60,42480,3,"""1""",43500,43560
7702,401202,400101,60,42480,3,"""1""",43560,43620
7702,400101,407302,60,42480,3,"""1""",43620,43680
7702,407302,408202,60,42480,3,"""1""",43680,43740
7702,408202,403104,120,42480,3,"""1""",43740,43860
7702,403104,112103,120,42480,3,"""1""",43860,43980
7702,112103,103001,180,42480,3,"""1""",43980,44160
7702,103001,8001,120,42480,3,"""1""",44160,44280
7702,8001,105001,60,42480,3,"""1""",44280,44340
7702,105001,34103,60,42480,3,"""1""",44340,44400
7702,34103,208102,120,42480,3,"""1""",44400,44520
7702,208102,201502,120,42480,3,"""1""",44520,44640
7702,201502,203904,120,42480,3,"""1""",44640,44760
7702,203904,204802,60,42480,3,"""1""",44760,44820
7702,204802,204702,60,42480,3,"""1""",44820,44880
7702,204702,202801,60,42480,3,"""1""",44880,44940
7702,202801,205201,60,42480,3,"""1""",44940,45000
7702,205201,205102,60,42480,3,"""1""",45000,45060
7702,205102,201401,120,42480,3,"""1""",45060,45180
7702,201401,203301,60,42480,3,"""1""",45180,45240
7702,203301,205701,120,42480,3,"""1""",45240,45360
7702,205701,200301,60,42480,3,"""1""",45360,45420
7702,200301,208700,180,42480,3,"""1""",45420,45600
7702,404702,32100,0,43680,3,"""1""",43680,43680
7702,32100,406001,60,43680,3,"""1""",43680,43740
7702,406001,302602,60,43680,3,"""1""",43740,43800
7702,302602,406701,60,43680,3,"""1""",43800,43860
7702,406701,406902,60,43680,3,"""1""",43860,43920
7702,406902,407909,120,43680,3,"""1""",43920,44040
7702,407909,405001,180,43680,3,"""1""",44040,44220
7702,405001,33604,120,43680,3,"""1""",44220,44340
7702,33604,408602,120,43680,3,"""1""",44340,44460
7702,408602,404400,60,43680,3,"""1""",44460,44520
7702,404400,408603,60,43680,3,"""1""",44520,44580
7702,408603,407801,60,43680,3,"""1""",44580,44640
7702,407801,400301,60,43680,3,"""1""",44640,44700
7702,400301,401202,60,43680,3,"""1""",44700,44760
7702,401202,400101,60,43680,3,"""1""",44760,44820
7702,400101,407302,60,43680,3,"""1""",44820,44880
7702,407302,408202,60,43680,3,"""1""",44880,44940
7702,408202,403104,120,43680,3,"""1""",44940,45060
7702,403104,112103,120,43680,3,"""1""",45060,45180
7702,112103,103001,180,43680,3,"""1""",45180,45360
7702,103001,8001,120,43680,3,"""1""",45360,45480
7702,8001,105001,60,43680,3,"""1""",45480,45540
7702,105001,34103,60,43680,3,"""1""",45540,45600
7702,34103,208102,120,43680,3,"""1""",45600,45720
7702,208102,201502,120,43680,3,"""1""",45720,45840
7702,201502,203904,120,43680,3,"""1""",45840,45960
7702,203904,204802,60,43680,3,"""1""",45960,46020
7702,204802,204702,60,43680,3,"""1""",46020,46080
7702,204702,202801,60,43680,3,"""1""",46080,46140
7702,202801,205201,60,43680,3,"""1""",46140,46200
7702,205201,205102,60,43680,3,"""1""",46200,46260
7702,205102,201401,120,43680,3,"""1""",46260,46380
7702,201401,203301,60,43680,3,"""1""",46380,46440
7702,203301,205701,120,43680,3,"""1""",46440,46560
7702,205701,200301,60,43680,3,"""1""",46560,46620
7702,200301,208700,180,43680,3,"""1""",46620,46800
7702,404702,32100,0,44880,3,"""1""",44880,44880
7702,32100,406001,60,44880,3,"""1""",44880,44940
7702,406001,302602,60,44880,3,"""1""",44940,45000
7702,302602,406701,60,44880,3,"""1""",45000,45060
7702,406701,406902,60,44880,3,"""1""",45060,45120
7702,406902,407909,120,44880,3,"""1""",45120,45240
7702,407909,405001,180,44880,3,"""1""",45240,45420
7702,405001,33604,120,44880,3,"""1""",45420,45540
7702,33604,408602,120,44880,3,"""1""",45540,45660
7702,408602,404400,60,44880,3,"""1""",45660,45720
7702,404400,408603,60,44880,3,"""1""",45720,45780
7702,408603,407801,60,44880,3,"""1""",45780,45840
7702,407801,400301,60,44880,3,"""1""",45840,45900
7702,400301,401202,60,44880,3,"""1""",45900,45960
7702,401202,400101,60,44880,3,"""1""",45960,46020
7702,400101,407302,60,44880,3,"""1""",46020,46080
7702,407302,408202,60,44880,3,"""1""",46080,46140
7702,408202,403104,120,44880,3,"""1""",46140,46260
7702,403104,112103,120,44880,3,"""1""",46260,46380
7702,112103,103001,180,44880,3,"""1""",46380,46560
7702,103001,8001,120,44880,3,"""1""",46560,46680
7702,8001,105001,60,44880,3,"""1""",46680,46740
7702,105001,34103,60,44880,3,"""1""",46740,46800
7702,34103,208102,120,44880,3,"""1""",46800,46920
7702,208102,201502,120,44880,3,"""1""",46920,47040
7702,201502,203904,120,44880,3,"""1""",47040,47160
7702,203904,204802,60,44880,3,"""1""",47160,47220
7702,204802,204702,60,44880,3,"""1""",47220,47280
7702,204702,202801,60,44880,3,"""1""",47280,47340
7702,202801,205201,60,44880,3,"""1""",47340,47400
7702,205201,205102,60,44880,3,"""1""",47400,47460
7702,205102,201401,120,44880,3,"""1""",47460,47580
7702,201401,203301,60,44880,3,"""1""",47580,47640
7702,203301,205701,120,44880,3,"""1""",47640,47760
7702,205701,200301,60,44880,3,"""1""",47760,47820
7702,200301,208700,180,44880,3,"""1""",47820,48000
7702,404702,32100,0,46080,3,"""1""",46080,46080
7702,32100,406001,60,46080,3,"""1""",46080,46140
7702,406001,302602,60,46080,3,"""1""",46140,46200
7702,302602,406701,60,46080,3,"""1""",46200,46260
7702,406701,406902,60,46080,3,"""1""",46260,46320
7702,406902,407909,120,46080,3,"""1""",46320,46440
7702,407909,405001,180,46080,3,"""1""",46440,46620
7702,405001,33604,120,46080,3,"""1""",46620,46740
7702,33604,408602,120,46080,3,"""1""",46740,46860
7702,408602,404400,60,46080,3,"""1""",46860,46920
7702,404400,408603,60,46080,3,"""1""",46920,46980
7702,408603,407801,60,46080,3,"""1""",46980,47040
7702,407801,400301,60,46080,3,"""1""",47040,47100
7702,400301,401202,60,46080,3,"""1""",47100,47160
7702,401202,400101,60,46080,3,"""1""",47160,47220
7702,400101,407302,60,46080,3,"""1""",47220,47280
7702,407302,408202,60,46080,3,"""1""",47280,47340
7702,408202,403104,120,46080,3,"""1""",47340,47460
7702,403104,112103,120,46080,3,"""1""",47460,47580
7702,112103,103001,180,46080,3,"""1""",47580,47760
7702,103001,8001,120,46080,3,"""1""",47760,47880
7702,8001,105001,60,46080,3,"""1""",47880,47940
7702,105001,34103,60,46080,3,"""1""",47940,48000
7702,34103,208102,120,46080,3,"""1""",48000,48120
7702,208102,201502,120,46080,3,"""1""",48120,48240
7702,201502,203904,120,46080,3,"""1""",48240,48360
7702,203904,204802,60,46080,3,"""1""",48360,48420
7702,204802,204702,60,46080,3,"""1""",48420,48480
7702,204702,202801,60,46080,3,"""1""",48480,48540
7702,202801,205201,60,46080,3,"""1""",48540,48600
7702,205201,205102,60,46080,3,"""1""",48600,48660
7702,205102,201401,120,46080,3,"""1""",48660,48780
7702,201401,203301,60,46080,3,"""1""",48780,48840
7702,203301,205701,120,46080,3,"""1""",48840,48960
7702,205701,200301,60,46080,3,"""1""",48960,49020
7702,200301,208700,180,46080,3,"""1""",49020,49200
7702,404702,32100,0,47280,3,"""1""",47280,47280
7702,32100,406001,60,47280,3,"""1""",47280,47340
7702,406001,302602,60,47280,3,"""1""",47340,47400
7702,302602,406701,60,47280,3,"""1""",47400,47460
7702,406701,406902,60,47280,3,"""1""",47460,47520
7702,406902,407909,120,47280,3,"""1""",47520,47640
7702,407909,405001,180,47280,3,"""1""",47640,47820
7702,405001,33604,120,47280,3,"""1""",47820,47940
7702,33604,408602,120,47280,3,"""1""",47940,48060
7702,408602,404400,60,47280,3,"""1""",48060,48120
7702,404400,408603,60,47280,3,"""1""",48120,48180
7702,408603,407801,60,47280,3,"""1""",48180,48240
7702,407801,400301,60,47280,3,"""1""",48240,48300
7702,400301,401202,60,47280,3,"""1""",48300,48360
7702,401202,400101,60,47280,3,"""1""",48360,48420
7702,400101,407302,60,47280,3,"""1""",48420,48480
7702,407302,408202,60,47280,3,"""1""",48480,48540
7702,408202,403104,120,47280,3,"""1""",48540,48660
7702,403104,112103,120,47280,3,"""1""",48660,48780
7702,112103,103001,180,47280,3,"""1""",48780,48960
7702,103001,8001,120,47280,3,"""1""",48960,49080
7702,8001,105001,60,47280,3,"""1""",49080,49140
7702,105001,34103,60,47280,3,"""1""",49140,49200
7702,34103,208102,120,47280,3,"""1""",49200,49320
7702,208102,201502,120,47280,3,"""1""",49320,49440
7702,201502,203904,120,47280,3,"""1""",49440,49560
7702,203904,204802,60,47280,3,"""1""",49560,49620
7702,204802,204702,60,47280,3,"""1""",49620,49680
7702,204702,202801,60,47280,3,"""1""",49680,49740
7702,202801,205201,60,47280,3,"""1""",49740,49800
7702,205201,205102,60,47280,3,"""1""",49800,49860
7702,205102,201401,120,47280,3,"""1""",49860,49980
7702,201401,203301,60,47280,3,"""1""",49980,50040
7702,203301,205701,120,47280,3,"""1""",50040,50160
7702,205701,200301,60,47280,3,"""1""",50160,50220
7702,200301,208700,180,47280,3,"""1""",50220,50400
7702,404702,32100,0,48480,3,"""1""",48480,48480
7702,32100,406001,60,48480,3,"""1""",48480,48540
7702,406001,302602,60,48480,3,"""1""",48540,48600
7702,302602,406701,60,48480,3,"""1""",48600,48660
7702,406701,406902,60,48480,3,"""1""",48660,48720
7702,406902,407909,120,48480,3,"""1""",48720,48840
7702,407909,405001,180,48480,3,"""1""",48840,49020
7702,405001,33604,120,48480,3,"""1""",49020,49140
7702,33604,408602,120,48480,3,"""1""",49140,49260
7702,408602,404400,60,48480,3,"""1""",49260,49320
7702,404400,408603,60,48480,3,"""1""",49320,49380
7702,408603,407801,60,48480,3,"""1""",49380,49440
7702,407801,400301,60,48480,3,"""1""",49440,49500
7702,400301,401202,60,48480,3,"""1""",49500,49560
7702,401202,400101,60,48480,3,"""1""",49560,49620
7702,400101,407302,60,48480,3,"""1""",49620,49680
7702,407302,408202,60,48480,3,"""1""",49680,49740
7702,408202,403104,120,48480,3,"""1""",49740,49860
7702,403104,112103,120,48480,3,"""1""",49860,49980
7702,112103,103001,180,48480,3,"""1""",49980,50160
7702,103001,8001,120,48480,3,"""1""",50160,50280
7702,8001,105001,60,48480,3,"""1""",50280,50340
7702,105001,34103,60,48480,3,"""1""",50340,50400
7702,34103,208102,120,48480,3,"""1""",50400,50520
7702,208102,201502,120,48480,3,"""1""",50520,50640
7702,201502,203904,120,48480,3,"""1""",50640,50760
7702,203904,204802,60,48480,3,"""1""",50760,50820
7702,204802,204702,60,48480,3,"""1""",50820,50880
7702,204702,202801,60,48480,3,"""1""",50880,50940
7702,202801,205201,60,48480,3,"""1""",50940,51000
7702,205201,205102,60,48480,3,"""1""",51000,51060
7702,205102,201401,120,48480,3,"""1""",51060,51180
7702,201401,203301,60,48480,3,"""1""",51180,51240
7702,203301,205701,120,48480,3,"""1""",51240,51360
7702,205701,200301,60,48480,3,"""1""",51360,51420
7702,200301,208700,180,48480,3,"""1""",51420,51600
7702,404702,32100,0,49680,3,"""1""",49680,49680
7702,32100,406001,60,49680,3,"""1""",49680,49740
7702,406001,302602,60,49680,3,"""1""",49740,49800
7702,302602,406701,60,49680,3,"""1""",49800,49860
7702,406701,406902,60,49680,3,"""1""",49860,49920
7702,406902,407909,120,49680,3,"""1""",49920,50040
7702,407909,405001,180,49680,3,"""1""",50040,50220
7702,405001,33604,120,49680,3,"""1""",50220,50340
7702,33604,408602,120,49680,3,"""1""",50340,50460
7702,408602,404400,60,49680,3,"""1""",50460,50520
7702,404400,408603,60,49680,3,"""1""",50520,50580
7702,408603,407801,60,49680,3,"""1""",50580,50640
7702,407801,400301,60,49680,3,"""1""",50640,50700
7702,400301,401202,60,49680,3,"""1""",50700,50760
7702,401202,400101,60,49680,3,"""1""",50760,50820
7702,400101,407302,60,49680,3,"""1""",50820,50880
7702,407302,408202,60,49680,3,"""1""",50880,50940
7702,408202,403104,120,49680,3,"""1""",50940,51060
7702,403104,112103,120,49680,3,"""1""",51060,51180
7702,112103,103001,180,49680,3,"""1""",51180,51360
7702,103001,8001,120,49680,3,"""1""",51360,51480
7702,8001,105001,60,49680,3,"""1""",51480,51540
7702,105001,34103,60,49680,3,"""1""",51540,51600
7702,34103,208102,120,49680,3,"""1""",51600,51720
7702,208102,201502,120,49680,3,"""1""",51720,51840
7702,201502,203904,120,49680,3,"""1""",51840,51960
7702,203904,204802,60,49680,3,"""1""",51960,52020
7702,204802,204702,60,49680,3,"""1""",52020,52080
7702,204702,202801,60,49680,3,"""1""",52080,52140
7702,202801,205201,60,49680,3,"""1""",52140,52200
7702,205201,205102,60,49680,3,"""1""",52200,52260
7702,205102,201401,120,49680,3,"""1""",52260,52380
7702,201401,203301,60,49680,3,"""1""",52380,52440
7702,203301,205701,120,49680,3,"""1""",52440,52560
7702,205701,200301,60,49680,3,"""1""",52560,52620
7702,200301,208700,180,49680,3,"""1""",52620,52800
7702,404702,32100,0,50880,3,"""1""",50880,50880
7702,32100,406001,60,50880,3,"""1""",50880,50940
7702,406001,302602,60,50880,3,"""1""",50940,51000
7702,302602,406701,60,50880,3,"""1""",51000,51060
7702,406701,406902,60,50880,3,"""1""",51060,51120
7702,406902,407909,120,50880,3,"""1""",51120,51240
7702,407909,405001,180,50880,3,"""1""",51240,51420
7702,405001,33604,120,50880,3,"""1""",51420,51540
7702,33604,408602,120,50880,3,"""1""",51540,51660
7702,408602,404400,60,50880,3,"""1""",51660,51720
7702,404400,408603,60,50880,3,"""1""",51720,51780
7702,408603,407801,60,50880,3,"""1""",51780,51840
7702,407801,400301,60,50880,3,"""1""",51840,51900
7702,400301,401202,60,50880,3,"""1""",51900,51960
7702,401202,400101,60,50880,3,"""1""",51960,52020
7702,400101,407302,60,50880,3,"""1""",52020,52080
7702,407302,408202,60,50880,3,"""1""",52080,52140
7702,408202,403104,120,50880,3,"""1""",52140,52260
7702,403104,112103,120,50880,3,"""1""",52260,52380
7702,112103,103001,180,50880,3,"""1""",52380,52560
7702,103001,8001,120,50880,3,"""1""",52560,52680
7702,8001,105001,60,50880,3,"""1""",52680,52740
7702,105001,34103,60,50880,3,"""1""",52740,52800
7702,34103,208102,120,50880,3,"""1""",52800,52920
7702,208102,201502,120,50880,3,"""1""",52920,53040
7702,201502,203904,120,50880,3,"""1""",53040,53160
7702,203904,204802,60,50880,3,"""1""",53160,53220
7702,204802,204702,60,50880,3,"""1""",53220,53280
7702,204702,202801,60,50880,3,"""1""",53280,53340
7702,202801,205201,60,50880,3,"""1""",53340,53400
7702,205201,205102,60,50880,3,"""1""",53400,53460
7702,205102,201401,120,50880,3,"""1""",53460,53580
7702,201401,203301,60,50880,3,"""1""",53580,53640
7702,203301,205701,120,50880,3,"""1""",53640,53760
7702,205701,200301,60,50880,3,"""1""",53760,53820
7702,200301,208700,180,50880,3,"""1""",53820,54000
7702,404702,32100,0,52080,3,"""1""",52080,52080
7702,32100,406001,60,52080,3,"""1""",52080,52140
7702,406001,302602,60,52080,3,"""1""",52140,52200
7702,302602,406701,60,52080,3,"""1""",52200,52260
7702,406701,406902,60,52080,3,"""1""",52260,52320
7702,406902,407909,120,52080,3,"""1""",52320,52440
7702,407909,405001,180,52080,3,"""1""",52440,52620
7702,405001,33604,120,52080,3,"""1""",52620,52740
7702,33604,408602,120,52080,3,"""1""",52740,52860
7702,408602,404400,60,52080,3,"""1""",52860,52920
7702,404400,408603,60,52080,3,"""1""",52920,52980
7702,408603,407801,60,52080,3,"""1""",52980,53040
7702,407801,400301,60,52080,3,"""1""",53040,53100
7702,400301,401202,60,52080,3,"""1""",53100,53160
7702,401202,400101,60,52080,3,"""1""",53160,53220
7702,400101,407302,60,52080,3,"""1""",53220,53280
7702,407302,408202,60,52080,3,"""1""",53280,53340
7702,408202,403104,120,52080,3,"""1""",53340,53460
7702,403104,112103,120,52080,3,"""1""",53460,53580
7702,112103,103001,180,52080,3,"""1""",53580,53760
7702,103001,8001,120,52080,3,"""1""",53760,53880
7702,8001,105001,60,52080,3,"""1""",53880,53940
7702,105001,34103,60,52080,3,"""1""",53940,54000
7702,34103,208102,120,52080,3,"""1""",54000,54120
7702,208102,201502,120,52080,3,"""1""",54120,54240
7702,201502,203904,120,52080,3,"""1""",54240,54360
7702,203904,204802,60,52080,3,"""1""",54360,54420
7702,204802,204702,60,52080,3,"""1""",54420,54480
7702,204702,202801,60,52080,3,"""1""",54480,54540
7702,202801,205201,60,52080,3,"""1""",54540,54600
7702,205201,205102,60,52080,3,"""1""",54600,54660
7702,205102,201401,120,52080,3,"""1""",54660,54780
7702,201401,203301,60,52080,3,"""1""",54780,54840
7702,203301,205701,120,52080,3,"""1""",54840,54960
7702,205701,200301,60,52080,3,"""1""",54960,55020
7702,200301,208700,180,52080,3,"""1""",55020,55200
7702,404702,32100,0,53280,3,"""1""",53280,53280
7702,32100,406001,60,53280,3,"""1""",53280,53340
7702,406001,302602,60,53280,3,"""1""",53340,53400
7702,302602,406701,60,53280,3,"""1""",53400,53460
7702,406701,406902,60,53280,3,"""1""",53460,53520
7702,406902,407909,120,53280,3,"""1""",53520,53640
7702,407909,405001,180,53280,3,"""1""",53640,53820
7702,405001,33604,120,53280,3,"""1""",53820,53940
7702,33604,408602,120,53280,3,"""1""",53940,54060
7702,408602,404400,60,53280,3,"""1""",54060,54120
7702,404400,408603,60,53280,3,"""1""",54120,54180
7702,408603,407801,60,53280,3,"""1""",54180,54240
7702,407801,400301,60,53280,3,"""1""",54240,54300
7702,400301,401202,60,53280,3,"""1""",54300,54360
7702,401202,400101,60,53280,3,"""1""",54360,54420
7702,400101,407302,60,53280,3,"""1""",54420,54480
7702,407302,408202,60,53280,3,"""1""",54480,54540
7702,408202,403104,120,53280,3,"""1""",54540,54660
7702,403104,112103,120,53280,3,"""1""",54660,54780
7702,112103,103001,180,53280,3,"""1""",54780,54960
7702,103001,8001,120,53280,3,"""1""",54960,55080
7702,8001,105001,60,53280,3,"""1""",55080,55140
7702,105001,34103,60,53280,3,"""1""",55140,55200
7702,34103,208102,120,53280,3,"""1""",55200,55320
7702,208102,201502,120,53280,3,"""1""",55320,55440
7702,201502,203904,120,53280,3,"""1""",55440,55560
7702,203904,204802,60,53280,3,"""1""",55560,55620
7702,204802,204702,60,53280,3,"""1""",55620,55680
7702,204702,202801,60,53280,3,"""1""",55680,55740
7702,202801,205201,60,53280,3,"""1""",55740,55800
7702,205201,205102,60,53280,3,"""1""",55800,55860
7702,205102,201401,120,53280,3,"""1""",55860,55980
7702,201401,203301,60,53280,3,"""1""",55980,56040
7702,203301,205701,120,53280,3,"""1""",56040,56160
7702,205701,200301,60,53280,3,"""1""",56160,56220
7702,200301,208700,180,53280,3,"""1""",56220,56400
7702,404702,32100,0,54480,3,"""1""",54480,54480
7702,32100,406001,60,54480,3,"""1""",54480,54540
7702,406001,302602,60,54480,3,"""1""",54540,54600
7702,302602,406701,60,54480,3,"""1""",54600,54660
7702,406701,406902,60,54480,3,"""1""",54660,54720
7702,406902,407909,120,54480,3,"""1""",54720,54840
7702,407909,405001,180,54480,3,"""1""",54840,55020
7702,405001,33604,120,54480,3,"""1""",55020,55140
7702,33604,408602,120,54480,3,"""1""",55140,55260
7702,408602,404400,60,54480,3,"""1""",55260,55320
7702,404400,408603,60,54480,3,"""1""",55320,55380
7702,408603,407801,60,54480,3,"""1""",55380,55440
7702,407801,400301,60,54480,3,"""1""",55440,55500
7702,400301,401202,60,54480,3,"""1""",55500,55560
7702,401202,400101,60,54480,3,"""1""",55560,55620
7702,400101,407302,60,54480,3,"""1""",55620,55680
7702,407302,408202,60,54480,3,"""1""",55680,55740
7702,408202,403104,120,54480,3,"""1""",55740,55860
7702,403104,112103,120,54480,3,"""1""",55860,55980
7702,112103,103001,180,54480,3,"""1""",55980,56160
7702,103001,8001,120,54480,3,"""1""",56160,56280
7702,8001,105001,60,54480,3,"""1""",56280,56340
7702,105001,34103,60,54480,3,"""1""",56340,56400
7702,34103,208102,120,54480,3,"""1""",56400,56520
7702,208102,201502,120,54480,3,"""1""",56520,56640
7702,201502,203904,120,54480,3,"""1""",56640,56760
7702,203904,204802,60,54480,3,"""1""",56760,56820
7702,204802,204702,60,54480,3,"""1""",56820,56880
7702,204702,202801,60,54480,3,"""1""",56880,56940
7702,202801,205201,60,54480,3,"""1""",56940,57000
7702,205201,205102,60,54480,3,"""1""",57000,57060
7702,205102,201401,120,54480,3,"""1""",57060,57180
7702,201401,203301,60,54480,3,"""1""",57180,57240
7702,203301,205701,120,54480,3,"""1""",57240,57360
7702,205701,200301,60,54480,3,"""1""",57360,57420
7702,200301,208700,180,54480,3,"""1""",57420,57600
7702,404702,32100,0,55680,3,"""1""",55680,55680
7702,32100,406001,60,55680,3,"""1""",55680,55740
7702,406001,302602,60,55680,3,"""1""",55740,55800
7702,302602,406701,60,55680,3,"""1""",55800,55860
7702,406701,406902,60,55680,3,"""1""",55860,55920
7702,406902,407909,120,55680,3,"""1""",55920,56040
7702,407909,405001,180,55680,3,"""1""",56040,56220
7702,405001,33604,120,55680,3,"""1""",56220,56340
7702,33604,408602,120,55680,3,"""1""",56340,56460
7702,408602,404400,60,55680,3,"""1""",56460,56520
7702,404400,408603,60,55680,3,"""1""",56520,56580
7702,408603,407801,60,55680,3,"""1""",56580,56640
7702,407801,400301,60,55680,3,"""1""",56640,56700
7702,400301,401202,60,55680,3,"""1""",56700,56760
7702,401202,400101,60,55680,3,"""1""",56760,56820
7702,400101,407302,60,55680,3,"""1""",56820,56880
7702,407302,408202,60,55680,3,"""1""",56880,56940
7702,408202,403104,120,55680,3,"""1""",56940,57060
7702,403104,112103,120,55680,3,"""1""",57060,57180
7702,112103,103001,180,55680,3,"""1""",57180,57360
7702,103001,8001,120,55680,3,"""1""",57360,57480
7702,8001,105001,60,55680,3,"""1""",57480,57540
7702,105001,34103,60,55680,3,"""1""",57540,57600
7702,34103,208102,120,55680,3,"""1""",57600,57720
7702,208102,201502,120,55680,3,"""1""",57720,57840
7702,201502,203904,120,55680,3,"""1""",57840,57960
7702,203904,204802,60,55680,3,"""1""",57960,58020
7702,204802,204702,60,55680,3,"""1""",58020,58080
7702,204702,202801,60,55680,3,"""1""",58080,58140
7702,202801,205201,60,55680,3,"""1""",58140,58200
7702,205201,205102,60,55680,3,"""1""",58200,58260
7702,205102,201401,120,55680,3,"""1""",58260,58380
7702,201401,203301,60,55680,3,"""1""",58380,58440
7702,203301,205701,120,55680,3,"""1""",58440,58560
7702,205701,200301,60,55680,3,"""1""",58560,58620
7702,200301,208700,180,55680,3,"""1""",58620,58800
7702,404702,32100,0,56880,3,"""1""",56880,56880
7702,32100,406001,60,56880,3,"""1""",56880,56940
7702,406001,302602,60,56880,3,"""1""",56940,57000
7702,302602,406701,60,56880,3,"""1""",57000,57060
7702,406701,406902,60,56880,3,"""1""",57060,57120
7702,406902,407909,120,56880,3,"""1""",57120,57240
7702,407909,405001,180,56880,3,"""1""",57240,57420
7702,405001,33604,120,56880,3,"""1""",57420,57540
7702,33604,408602,120,56880,3,"""1""",57540,57660
7702,408602,404400,60,56880,3,"""1""",57660,57720
7702,404400,408603,60,56880,3,"""1""",57720,57780
7702,408603,407801,60,56880,3,"""1""",57780,57840
7702,407801,400301,60,56880,3,"""1""",57840,57900
7702,400301,401202,60,56880,3,"""1""",57900,57960
7702,401202,400101,60,56880,3,"""1""",57960,58020
7702,400101,407302,60,56880,3,"""1""",58020,58080
7702,407302,408202,60,56880,3,"""1""",58080,58140
7702,408202,403104,120,56880,3,"""1""",58140,58260
7702,403104,112103,120,56880,3,"""1""",58260,58380
7702,112103,103001,180,56880,3,"""1""",58380,58560
7702,103001,8001,120,56880,3,"""1""",58560,58680
7702,8001,105001,60,56880,3,"""1""",58680,58740
7702,105001,34103,60,56880,3,"""1""",58740,58800
7702,34103,208102,120,56880,3,"""1""",58800,58920
7702,208102,201502,120,56880,3,"""1""",58920,59040
7702,201502,203904,120,56880,3,"""1""",59040,59160
7702,203904,204802,60,56880,3,"""1""",59160,59220
7702,204802,204702,60,56880,3,"""1""",59220,59280
7702,204702,202801,60,56880,3,"""1""",59280,59340
7702,202801,205201,60,56880,3,"""1""",59340,59400
7702,205201,205102,60,56880,3,"""1""",59400,59460
7702,205102,201401,120,56880,3,"""1""",59460,59580
7702,201401,203301,60,56880,3,"""1""",59580,59640
7702,203301,205701,120,56880,3,"""1""",59640,59760
7702,205701,200301,60,56880,3,"""1""",59760,59820
7702,200301,208700,180,56880,3,"""1""",59820,60000
7702,404702,32100,0,58080,3,"""1""",58080,58080
7702,32100,406001,60,58080,3,"""1""",58080,58140
7702,406001,302602,60,58080,3,"""1""",58140,58200
7702,302602,406701,60,58080,3,"""1""",58200,58260
7702,406701,406902,60,58080,3,"""1""",58260,58320
7702,406902,407909,120,58080,3,"""1""",58320,58440
7702,407909,405001,180,58080,3,"""1""",58440,58620
7702,405001,33604,120,58080,3,"""1""",58620,58740
7702,33604,408602,120,58080,3,"""1""",58740,58860
7702,408602,404400,60,58080,3,"""1""",58860,58920
7702,404400,408603,60,58080,3,"""1""",58920,58980
7702,408603,407801,60,58080,3,"""1""",58980,59040
7702,407801,400301,60,58080,3,"""1""",59040,59100
7702,400301,401202,60,58080,3,"""1""",59100,59160
7702,401202,400101,60,58080,3,"""1""",59160,59220
7702,400101,407302,60,58080,3,"""1""",59220,59280
7702,407302,408202,60,58080,3,"""1""",59280,59340
7702,408202,403104,120,58080,3,"""1""",59340,59460
7702,403104,112103,120,58080,3,"""1""",59460,59580
7702,112103,103001,180,58080,3,"""1""",59580,59760
7702,103001,8001,120,58080,3,"""1""",59760,59880
7702,8001,105001,60,58080,3,"""1""",59880,59940
7702,105001,34103,60,58080,3,"""1""",59940,60000
7702,34103,208102,120,58080,3,"""1""",60000,60120
7702,208102,201502,120,58080,3,"""1""",60120,60240
7702,201502,203904,120,58080,3,"""1""",60240,60360
7702,203904,204802,60,58080,3,"""1""",60360,60420
7702,204802,204702,60,58080,3,"""1""",60420,60480
7702,204702,202801,60,58080,3,"""1""",60480,60540
7702,202801,205201,60,58080,3,"""1""",60540,60600
7702,205201,205102,60,58080,3,"""1""",60600,60660
7702,205102,201401,120,58080,3,"""1""",60660,60780
7702,201401,203301,60,58080,3,"""1""",60780,60840
7702,203301,205701,120,58080,3,"""1""",60840,60960
7702,205701,200301,60,58080,3,"""1""",60960,61020
7702,200301,208700,180,58080,3,"""1""",61020,61200
7702,404702,32100,0,59280,3,"""1""",59280,59280
7702,32100,406001,60,59280,3,"""1""",59280,59340
7702,406001,302602,60,59280,3,"""1""",59340,59400
7702,302602,406701,60,59280,3,"""1""",59400,59460
7702,406701,406902,60,59280,3,"""1""",59460,59520
7702,406902,407909,120,59280,3,"""1""",59520,59640
7702,407909,405001,180,59280,3,"""1""",59640,59820
7702,405001,33604,120,59280,3,"""1""",59820,59940
7702,33604,408602,120,59280,3,"""1""",59940,60060
7702,408602,404400,60,59280,3,"""1""",60060,60120
7702,404400,408603,60,59280,3,"""1""",60120,60180
7702,408603,407801,60,59280,3,"""1""",60180,60240
7702,407801,400301,60,59280,3,"""1""",60240,60300
7702,400301,401202,60,59280,3,"""1""",60300,60360
7702,401202,400101,60,59280,3,"""1""",60360,60420
7702,400101,407302,60,59280,3,"""1""",60420,60480
7702,407302,408202,60,59280,3,"""1""",60480,60540
7702,408202,403104,120,59280,3,"""1""",60540,60660
7702,403104,112103,120,59280,3,"""1""",60660,60780
7702,112103,103001,180,59280,3,"""1""",60780,60960
7702,103001,8001,120,59280,3,"""1""",60960,61080
7702,8001,105001,60,59280,3,"""1""",61080,61140
7702,105001,34103,60,59280,3,"""1""",61140,61200
7702,34103,208102,120,59280,3,"""1""",61200,61320
7702,208102,201502,120,59280,3,"""1""",61320,61440
7702,201502,203904,120,59280,3,"""1""",61440,61560
7702,203904,204802,60,59280,3,"""1""",61560,61620
7702,204802,204702,60,59280,3,"""1""",61620,61680
7702,204702,202801,60,59280,3,"""1""",61680,61740
7702,202801,205201,60,59280,3,"""1""",61740,61800
7702,205201,205102,60,59280,3,"""1""",61800,61860
7702,205102,201401,120,59280,3,"""1""",61860,61980
7702,201401,203301,60,59280,3,"""1""",61980,62040
7702,203301,205701,120,59280,3,"""1""",62040,62160
7702,205701,200301,60,59280,3,"""1""",62160,62220
7702,200301,208700,180,59280,3,"""1""",62220,62400
7702,404702,32100,0,60480,3,"""1""",60480,60480
7702,32100,406001,60,60480,3,"""1""",60480,60540
7702,406001,302602,60,60480,3,"""1""",60540,60600
7702,302602,406701,60,60480,3,"""1""",60600,60660
7702,406701,406902,60,60480,3,"""1""",60660,60720
7702,406902,407909,120,60480,3,"""1""",60720,60840
7702,407909,405001,180,60480,3,"""1""",60840,61020
7702,405001,33604,120,60480,3,"""1""",61020,61140
7702,33604,408602,120,60480,3,"""1""",61140,61260
7702,408602,404400,60,60480,3,"""1""",61260,61320
7702,404400,408603,60,60480,3,"""1""",61320,61380
7702,408603,407801,60,60480,3,"""1""",61380,61440
7702,407801,400301,60,60480,3,"""1""",61440,61500
7702,400301,401202,60,60480,3,"""1""",61500,61560
7702,401202,400101,60,60480,3,"""1""",61560,61620
7702,400101,407302,60,60480,3,"""1""",61620,61680
7702,407302,408202,60,60480,3,"""1""",61680,61740
7702,408202,403104,120,60480,3,"""1""",61740,61860
7702,403104,112103,120,60480,3,"""1""",61860,61980
7702,112103,103001,180,60480,3,"""1""",61980,62160
7702,103001,8001,120,60480,3,"""1""",62160,62280
7702,8001,105001,60,60480,3,"""1""",62280,62340
7702,105001,34103,60,60480,3,"""1""",62340,62400
7702,34103,208102,120,60480,3,"""1""",62400,62520
7702,208102,201502,120,60480,3,"""1""",62520,62640
7702,201502,203904,120,60480,3,"""1""",62640,62760
7702,203904,204802,60,60480,3,"""1""",62760,62820
7702,204802,204702,60,60480,3,"""1""",62820,62880
7702,204702,202801,60,60480,3,"""1""",62880,62940
7702,202801,205201,60,60480,3,"""1""",62940,63000
7702,205201,205102,60,60480,3,"""1""",63000,63060
7702,205102,201401,120,60480,3,"""1""",63060,63180
7702,201401,203301,60,60480,3,"""1""",63180,63240
7702,203301,205701,120,60480,3,"""1""",63240,63360
7702,205701,200301,60,60480,3,"""1""",63360,63420
7702,200301,208700,180,60480,3,"""1""",63420,63600
7702,404702,32100,0,61680,3,"""1""",61680,61680
7702,32100,406001,60,61680,3,"""1""",61680,61740
7702,406001,302602,60,61680,3,"""1""",61740,61800
7702,302602,406701,60,61680,3,"""1""",61800,61860
7702,406701,406902,60,61680,3,"""1""",61860,61920
7702,406902,407909,120,61680,3,"""1""",61920,62040
7702,407909,405001,180,61680,3,"""1""",62040,62220
7702,405001,33604,120,61680,3,"""1""",62220,62340
7702,33604,408602,120,61680,3,"""1""",62340,62460
7702,408602,404400,60,61680,3,"""1""",62460,62520
7702,404400,408603,60,61680,3,"""1""",62520,62580
7702,408603,407801,60,61680,3,"""1""",62580,62640
7702,407801,400301,60,61680,3,"""1""",62640,62700
7702,400301,401202,60,61680,3,"""1""",62700,62760
7702,401202,400101,60,61680,3,"""1""",62760,62820
7702,400101,407302,60,61680,3,"""1""",62820,62880
7702,407302,408202,60,61680,3,"""1""",62880,62940
7702,408202,403104,120,61680,3,"""1""",62940,63060
7702,403104,112103,120,61680,3,"""1""",63060,63180
7702,112103,103001,180,61680,3,"""1""",63180,63360
7702,103001,8001,120,61680,3,"""1""",63360,63480
7702,8001,105001,60,61680,3,"""1""",63480,63540
7702,105001,34103,60,61680,3,"""1""",63540,63600
7702,34103,208102,120,61680,3,"""1""",63600,63720
7702,208102,201502,120,61680,3,"""1""",63720,63840
7702,201502,203904,120,61680,3,"""1""",63840,63960
7702,203904,204802,60,61680,3,"""1""",63960,64020
7702,204802,204702,60,61680,3,"""1""",64020,64080
7702,204702,202801,60,61680,3,"""1""",64080,64140
7702,202801,205201,60,61680,3,"""1""",64140,64200
7702,205201,205102,60,61680,3,"""1""",64200,64260
7702,205102,201401,120,61680,3,"""1""",64260,64380
7702,201401,203301,60,61680,3,"""1""",64380,64440
7702,203301,205701,120,61680,3,"""1""",64440,64560
7702,205701,200301,60,61680,3,"""1""",64560,64620
7702,200301,208700,180,61680,3,"""1""",64620,64800
7702,404702,32100,0,62880,3,"""1""",62880,62880
7702,32100,406001,60,62880,3,"""1""",62880,62940
7702,406001,302602,60,62880,3,"""1""",62940,63000
7702,302602,406701,60,62880,3,"""1""",63000,63060
7702,406701,406902,60,62880,3,"""1""",63060,63120
7702,406902,407909,120,62880,3,"""1""",63120,63240
7702,407909,405001,180,62880,3,"""1""",63240,63420
7702,405001,33604,120,62880,3,"""1""",63420,63540
7702,33604,408602,120,62880,3,"""1""",63540,63660
7702,408602,404400,60,62880,3,"""1""",63660,63720
7702,404400,408603,60,62880,3,"""1""",63720,63780
7702,408603,407801,60,62880,3,"""1""",63780,63840
7702,407801,400301,60,62880,3,"""1""",63840,63900
7702,400301,401202,60,62880,3,"""1""",63900,63960
7702,401202,400101,60,62880,3,"""1""",63960,64020
7702,400101,407302,60,62880,3,"""1""",64020,64080
7702,407302,408202,60,62880,3,"""1""",64080,64140
7702,408202,403104,120,62880,3,"""1""",64140,64260
7702,403104,112103,120,62880,3,"""1""",64260,64380
7702,112103,103001,180,62880,3,"""1""",64380,64560
7702,103001,8001,120,62880,3,"""1""",64560,64680
7702,8001,105001,60,62880,3,"""1""",64680,64740
7702,105001,34103,60,62880,3,"""1""",64740,64800
7702,34103,208102,120,62880,3,"""1""",64800,64920
7702,208102,201502,120,62880,3,"""1""",64920,65040
7702,201502,203904,120,62880,3,"""1""",65040,65160
7702,203904,204802,60,62880,3,"""1""",65160,65220
7702,204802,204702,60,62880,3,"""1""",65220,65280
7702,204702,202801,60,62880,3,"""1""",65280,65340
7702,202801,205201,60,62880,3,"""1""",65340,65400
7702,205201,205102,60,62880,3,"""1""",65400,65460
7702,205102,201401,120,62880,3,"""1""",65460,65580
7702,201401,203301,60,62880,3,"""1""",65580,65640
7702,203301,205701,120,62880,3,"""1""",65640,65760
7702,205701,200301,60,62880,3,"""1""",65760,65820
7702,200301,208700,180,62880,3,"""1""",65820,66000
7702,404702,32100,0,64080,3,"""1""",64080,64080
7702,32100,406001,60,64080,3,"""1""",64080,64140
7702,406001,302602,60,64080,3,"""1""",64140,64200
7702,302602,406701,60,64080,3,"""1""",64200,64260
7702,406701,406902,60,64080,3,"""1""",64260,64320
7702,406902,407909,120,64080,3,"""1""",64320,64440
7702,407909,405001,180,64080,3,"""1""",64440,64620
7702,405001,33604,120,64080,3,"""1""",64620,64740
7702,33604,408602,120,64080,3,"""1""",64740,64860
7702,408602,404400,60,64080,3,"""1""",64860,64920
7702,404400,408603,60,64080,3,"""1""",64920,64980
7702,408603,407801,60,64080,3,"""1""",64980,65040
7702,407801,400301,60,64080,3,"""1""",65040,65100
7702,400301,401202,60,64080,3,"""1""",65100,65160
7702,401202,400101,60,64080,3,"""1""",65160,65220
7702,400101,407302,60,64080,3,"""1""",65220,65280
7702,407302,408202,60,64080,3,"""1""",65280,65340
7702,408202,403104,120,64080,3,"""1""",65340,65460
7702,403104,112103,120,64080,3,"""1""",65460,65580
7702,112103,103001,180,64080,3,"""1""",65580,65760
7702,103001,8001,120,64080,3,"""1""",65760,65880
7702,8001,105001,60,64080,3,"""1""",65880,65940
7702,105001,34103,60,64080,3,"""1""",65940,66000
7702,34103,208102,120,64080,3,"""1""",66000,66120
7702,208102,201502,120,64080,3,"""1""",66120,66240
7702,201502,203904,120,64080,3,"""1""",66240,66360
7702,203904,204802,60,64080,3,"""1""",66360,66420
7702,204802,204702,60,64080,3,"""1""",66420,66480
7702,204702,202801,60,64080,3,"""1""",66480,66540
7702,202801,205201,60,64080,3,"""1""",66540,66600
7702,205201,205102,60,64080,3,"""1""",66600,66660
7702,205102,201401,120,64080,3,"""1""",66660,66780
7702,201401,203301,60,64080,3,"""1""",66780,66840
7702,203301,205701,120,64080,3,"""1""",66840,66960
7702,205701,200301,60,64080,3,"""1""",66960,67020
7702,200301,208700,180,64080,3,"""1""",67020,67200
7702,404702,32100,0,65280,3,"""1""",65280,65280
7702,32100,406001,60,65280,3,"""1""",65280,65340
7702,406001,302602,60,65280,3,"""1""",65340,65400
7702,302602,406701,60,65280,3,"""1""",65400,65460
7702,406701,406902,60,65280,3,"""1""",65460,65520
7702,406902,407909,120,65280,3,"""1""",65520,65640
7702,407909,405001,180,65280,3,"""1""",65640,65820
7702,405001,33604,120,65280,3,"""1""",65820,65940
7702,33604,408602,120,65280,3,"""1""",65940,66060
7702,408602,404400,60,65280,3,"""1""",66060,66120
7702,404400,408603,60,65280,3,"""1""",66120,66180
7702,408603,407801,60,65280,3,"""1""",66180,66240
7702,407801,400301,60,65280,3,"""1""",66240,66300
7702,400301,401202,60,65280,3,"""1""",66300,66360
7702,401202,400101,60,65280,3,"""1""",66360,66420
7702,400101,407302,60,65280,3,"""1""",66420,66480
7702,407302,408202,60,65280,3,"""1""",66480,66540
7702,408202,403104,120,65280,3,"""1""",66540,66660
7702,403104,112103,120,65280,3,"""1""",66660,66780
7702,112103,103001,180,65280,3,"""1""",66780,66960
7702,103001,8001,120,65280,3,"""1""",66960,67080
7702,8001,105001,60,65280,3,"""1""",67080,67140
7702,105001,34103,60,65280,3,"""1""",67140,67200
7702,34103,208102,120,65280,3,"""1""",67200,67320
7702,208102,201502,120,65280,3,"""1""",67320,67440
7702,201502,203904,120,65280,3,"""1""",67440,67560
7702,203904,204802,60,65280,3,"""1""",67560,67620
7702,204802,204702,60,65280,3,"""1""",67620,67680
7702,204702,202801,60,65280,3,"""1""",67680,67740
7702,202801,205201,60,65280,3,"""1""",67740,67800
7702,205201,205102,60,65280,3,"""1""",67800,67860
7702,205102,201401,120,65280,3,"""1""",67860,67980
7702,201401,203301,60,65280,3,"""1""",67980,68040
7702,203301,205701,120,65280,3,"""1""",68040,68160
7702,205701,200301,60,65280,3,"""1""",68160,68220
7702,200301,208700,180,65280,3,"""1""",68220,68400
7702,404702,32100,0,67680,3,"""1""",67680,67680
7702,32100,406001,60,67680,3,"""1""",67680,67740
7702,406001,302602,60,67680,3,"""1""",67740,67800
7702,302602,406701,60,67680,3,"""1""",67800,67860
7702,406701,406902,60,67680,3,"""1""",67860,67920
7702,406902,407909,120,67680,3,"""1""",67920,68040
7702,407909,405001,180,67680,3,"""1""",68040,68220
7702,405001,33604,120,67680,3,"""1""",68220,68340
7702,33604,408602,120,67680,3,"""1""",68340,68460
7702,408602,404400,60,67680,3,"""1""",68460,68520
7702,404400,408603,60,67680,3,"""1""",68520,68580
7702,408603,407801,60,67680,3,"""1""",68580,68640
7702,407801,400301,60,67680,3,"""1""",68640,68700
7702,400301,401202,60,67680,3,"""1""",68700,68760
7702,401202,400101,60,67680,3,"""1""",68760,68820
7702,400101,407302,60,67680,3,"""1""",68820,68880
7702,407302,408202,60,67680,3,"""1""",68880,68940
7702,408202,403104,120,67680,3,"""1""",68940,69060
7702,403104,112103,120,67680,3,"""1""",69060,69180
7702,112103,103001,180,67680,3,"""1""",69180,69360
7702,103001,8001,120,67680,3,"""1""",69360,69480
7702,8001,105001,60,67680,3,"""1""",69480,69540
7702,105001,34103,60,67680,3,"""1""",69540,69600
7702,34103,208102,120,67680,3,"""1""",69600,69720
7702,208102,201502,120,67680,3,"""1""",69720,69840
7702,201502,203904,120,67680,3,"""1""",69840,69960
7702,203904,204802,60,67680,3,"""1""",69960,70020
7702,204802,204702,60,67680,3,"""1""",70020,70080
7702,204702,202801,60,67680,3,"""1""",70080,70140
7702,202801,205201,60,67680,3,"""1""",70140,70200
7702,205201,205102,60,67680,3,"""1""",70200,70260
7702,205102,201401,120,67680,3,"""1""",70260,70380
7702,201401,203301,60,67680,3,"""1""",70380,70440
7702,203301,205701,120,67680,3,"""1""",70440,70560
7702,205701,200301,60,67680,3,"""1""",70560,70620
7702,200301,208700,180,67680,3,"""1""",70620,70800
7702,404702,32100,0,69480,3,"""1""",69480,69480
7702,32100,406001,60,69480,3,"""1""",69480,69540
7702,406001,302602,60,69480,3,"""1""",69540,69600
7702,302602,406701,60,69480,3,"""1""",69600,69660
7702,406701,406902,60,69480,3,"""1""",69660,69720
7702,406902,407909,120,69480,3,"""1""",69720,69840
7702,407909,405001,180,69480,3,"""1""",69840,70020
7702,405001,33604,120,69480,3,"""1""",70020,70140
7702,33604,408602,120,69480,3,"""1""",70140,70260
7702,408602,404400,60,69480,3,"""1""",70260,70320
7702,404400,408603,60,69480,3,"""1""",70320,70380
7702,408603,407801,60,69480,3,"""1""",70380,70440
7702,407801,400301,60,69480,3,"""1""",70440,70500
7702,400301,401202,60,69480,3,"""1""",70500,70560
7702,401202,400101,60,69480,3,"""1""",70560,70620
7702,400101,407302,60,69480,3,"""1""",70620,70680
7702,407302,408202,60,69480,3,"""1""",70680,70740
7702,408202,403104,120,69480,3,"""1""",70740,70860
7702,403104,112103,120,69480,3,"""1""",70860,70980
7702,112103,103001,180,69480,3,"""1""",70980,71160
7702,103001,8001,120,69480,3,"""1""",71160,71280
7702,8001,105001,60,69480,3,"""1""",71280,71340
7702,105001,34103,60,69480,3,"""1""",71340,71400
7702,34103,208102,120,69480,3,"""1""",71400,71520
7702,208102,201502,120,69480,3,"""1""",71520,71640
7702,201502,203904,120,69480,3,"""1""",71640,71760
7702,203904,204802,60,69480,3,"""1""",71760,71820
7702,204802,204702,60,69480,3,"""1""",71820,71880
7702,204702,202801,60,69480,3,"""1""",71880,71940
7702,202801,205201,60,69480,3,"""1""",71940,72000
7702,205201,205102,60,69480,3,"""1""",72000,72060
7702,205102,201401,120,69480,3,"""1""",72060,72180
7702,201401,203301,60,69480,3,"""1""",72180,72240
7702,203301,205701,120,69480,3,"""1""",72240,72360
7702,205701,200301,60,69480,3,"""1""",72360,72420
7702,200301,208700,180,69480,3,"""1""",72420,72600
7703,404702,32100,0,18480,3,"""1""",18480,18480
7703,32100,406001,60,18480,3,"""1""",18480,18540
7703,406001,302602,60,18480,3,"""1""",18540,18600
7703,302602,406701,60,18480,3,"""1""",18600,18660
7703,406701,406902,60,18480,3,"""1""",18660,18720
7703,406902,407909,60,18480,3,"""1""",18720,18780
7703,407909,405001,180,18480,3,"""1""",18780,18960
7703,405001,33604,60,18480,3,"""1""",18960,19020
7703,33604,408602,120,18480,3,"""1""",19020,19140
7703,408602,404400,60,18480,3,"""1""",19140,19200
7703,404400,408603,60,18480,3,"""1""",19200,19260
7703,408603,407801,60,18480,3,"""1""",19260,19320
7703,407801,400301,60,18480,3,"""1""",19320,19380
7703,400301,401202,60,18480,3,"""1""",19380,19440
7703,401202,400101,60,18480,3,"""1""",19440,19500
7703,400101,407302,60,18480,3,"""1""",19500,19560
7703,407302,408202,60,18480,3,"""1""",19560,19620
7703,408202,403104,120,18480,3,"""1""",19620,19740
7703,403104,112103,120,18480,3,"""1""",19740,19860
7703,112103,103001,180,18480,3,"""1""",19860,20040
7703,103001,8001,120,18480,3,"""1""",20040,20160
7703,8001,105001,60,18480,3,"""1""",20160,20220
7703,105001,34103,60,18480,3,"""1""",20220,20280
7703,34103,208102,120,18480,3,"""1""",20280,20400
7703,208102,201502,120,18480,3,"""1""",20400,20520
7703,201502,203904,120,18480,3,"""1""",20520,20640
7703,203904,204802,60,18480,3,"""1""",20640,20700
7703,204802,204702,60,18480,3,"""1""",20700,20760
7703,204702,202801,60,18480,3,"""1""",20760,20820
7703,202801,205201,60,18480,3,"""1""",20820,20880
7703,205201,205102,60,18480,3,"""1""",20880,20940
7703,205102,201401,60,18480,3,"""1""",20940,21000
7703,201401,203301,60,18480,3,"""1""",21000,21060
7703,203301,205701,120,18480,3,"""1""",21060,21180
7703,205701,200301,60,18480,3,"""1""",21180,21240
7703,200301,208700,180,18480,3,"""1""",21240,21420
7703,404702,32100,0,19680,3,"""1""",19680,19680
7703,32100,406001,60,19680,3,"""1""",19680,19740
7703,406001,302602,60,19680,3,"""1""",19740,19800
7703,302602,406701,60,19680,3,"""1""",19800,19860
7703,406701,406902,60,19680,3,"""1""",19860,19920
7703,406902,407909,60,19680,3,"""1""",19920,19980
7703,407909,405001,180,19680,3,"""1""",19980,20160
7703,405001,33604,60,19680,3,"""1""",20160,20220
7703,33604,408602,120,19680,3,"""1""",20220,20340
7703,408602,404400,60,19680,3,"""1""",20340,20400
7703,404400,408603,60,19680,3,"""1""",20400,20460
7703,408603,407801,60,19680,3,"""1""",20460,20520
7703,407801,400301,60,19680,3,"""1""",20520,20580
7703,400301,401202,60,19680,3,"""1""",20580,20640
7703,401202,400101,60,19680,3,"""1""",20640,20700
7703,400101,407302,60,19680,3,"""1""",20700,20760
7703,407302,408202,60,19680,3,"""1""",20760,20820
7703,408202,403104,120,19680,3,"""1""",20820,20940
7703,403104,112103,120,19680,3,"""1""",20940,21060
7703,112103,103001,180,19680,3,"""1""",21060,21240
7703,103001,8001,120,19680,3,"""1""",21240,21360
7703,8001,105001,60,19680,3,"""1""",21360,21420
7703,105001,34103,60,19680,3,"""1""",21420,21480
7703,34103,208102,120,19680,3,"""1""",21480,21600
7703,208102,201502,120,19680,3,"""1""",21600,21720
7703,201502,203904,120,19680,3,"""1""",21720,21840
7703,203904,204802,60,19680,3,"""1""",21840,21900
7703,204802,204702,60,19680,3,"""1""",21900,21960
7703,204702,202801,60,19680,3,"""1""",21960,22020
7703,202801,205201,60,19680,3,"""1""",22020,22080
7703,205201,205102,60,19680,3,"""1""",22080,22140
7703,205102,201401,60,19680,3,"""1""",22140,22200
7703,201401,203301,60,19680,3,"""1""",22200,22260
7703,203301,205701,120,19680,3,"""1""",22260,22380
7703,205701,200301,60,19680,3,"""1""",22380,22440
7703,200301,208700,180,19680,3,"""1""",22440,22620
7704,404702,32100,0,73140,3,"""41""",73140,73140
7704,32100,406001,60,73140,3,"""41""",73140,73200
7704,406001,302602,60,73140,3,"""41""",73200,73260
7704,302602,406701,60,73140,3,"""41""",73260,73320
7704,406701,406902,60,73140,3,"""41""",73320,73380
7704,406902,407909,60,73140,3,"""41""",73380,73440
7704,407909,405001,180,73140,3,"""41""",73440,73620
7704,405001,33604,60,73140,3,"""41""",73620,73680
7704,33604,408602,120,73140,3,"""41""",73680,73800
7704,408602,404400,60,73140,3,"""41""",73800,73860
7704,404400,408603,60,73140,3,"""41""",73860,73920
7704,408603,407801,60,73140,3,"""41""",73920,73980
7704,407801,400301,60,73140,3,"""41""",73980,74040
7704,400301,401202,60,73140,3,"""41""",74040,74100
7704,401202,400101,60,73140,3,"""41""",74100,74160
7704,400101,407302,60,73140,3,"""41""",74160,74220
7704,407302,408202,60,73140,3,"""41""",74220,74280
7704,408202,403104,120,73140,3,"""41""",74280,74400
7704,403104,112103,120,73140,3,"""41""",74400,74520
7704,112103,103001,180,73140,3,"""41""",74520,74700
7704,103001,8001,120,73140,3,"""41""",74700,74820
7704,8001,105001,60,73140,3,"""41""",74820,74880
7704,105001,34103,60,73140,3,"""41""",74880,74940
7704,34103,208102,120,73140,3,"""41""",74940,75060
7704,208102,201502,120,73140,3,"""41""",75060,75180
7704,201502,203904,120,73140,3,"""41""",75180,75300
7704,203904,204802,60,73140,3,"""41""",75300,75360
7704,204802,204702,60,73140,3,"""41""",75360,75420
7704,204702,202801,60,73140,3,"""41""",75420,75480
7704,202801,205201,60,73140,3,"""41""",75480,75540
7704,205201,205105,60,73140,3,"""41""",75540,75600
7704,205105,207704,60,73140,3,"""41""",75600,75660
7704,207704,207502,60,73140,3,"""41""",75660,75720
7704,207502,202501,60,73140,3,"""41""",75720,75780
7704,202501,205300,120,73140,3,"""41""",75780,75900
7706,208700,200302,60,20220,3,"""2""",20220,20280
7706,200302,205702,60,20220,3,"""2""",20280,20340
7706,205702,203302,60,20220,3,"""2""",20340,20400
7706,203302,201402,60,20220,3,"""2""",20400,20460
7706,201402,205103,180,20220,3,"""2""",20460,20640
7706,205103,205202,60,20220,3,"""2""",20640,20700
7706,205202,202802,60,20220,3,"""2""",20700,20760
7706,202802,204700,60,20220,3,"""2""",20760,20820
7706,204700,204801,120,20220,3,"""2""",20820,20940
7706,204801,203900,120,20220,3,"""2""",20940,21060
7706,203900,201503,60,20220,3,"""2""",21060,21120
7706,201503,208103,120,20220,3,"""2""",21120,21240
7706,208103,34104,60,20220,3,"""2""",21240,21300
7706,34104,105002,60,20220,3,"""2""",21300,21360
7706,105002,8002,60,20220,3,"""2""",21360,21420
7706,8002,103005,120,20220,3,"""2""",21420,21540
7706,103005,112104,180,20220,3,"""2""",21540,21720
7706,112104,403101,120,20220,3,"""2""",21720,21840
7706,403101,408203,60,20220,3,"""2""",21840,21900
7706,408203,407303,60,20220,3,"""2""",21900,21960
7706,407303,400102,60,20220,3,"""2""",21960,22020
7706,400102,401203,60,20220,3,"""2""",22020,22080
7706,401203,400302,60,20220,3,"""2""",22080,22140
7706,400302,407802,60,20220,3,"""2""",22140,22200
7706,407802,408602,60,20220,3,"""2""",22200,22260
7706,408602,404400,60,20220,3,"""2""",22260,22320
7706,404400,408603,60,20220,3,"""2""",22320,22380
7706,408603,33603,60,20220,3,"""2""",22380,22440
7706,33603,33606,60,20220,3,"""2""",22440,22500
7706,33606,405002,120,20220,3,"""2""",22500,22620
7706,405002,407908,180,20220,3,"""2""",22620,22800
7706,407908,406903,60,20220,3,"""2""",22800,22860
7706,406903,406702,60,20220,3,"""2""",22860,22920
7706,406702,302603,60,20220,3,"""2""",22920,22980
7706,302603,406002,60,20220,3,"""2""",22980,23040
7706,406002,404702,180,20220,3,"""2""",23040,23220
7706,208700,200302,60,21420,3,"""2""",21420,21480
7706,200302,205702,60,21420,3,"""2""",21480,21540
7706,205702,203302,60,21420,3,"""2""",21540,21600
7706,203302,201402,60,21420,3,"""2""",21600,21660
7706,201402,205103,180,21420,3,"""2""",21660,21840
7706,205103,205202,60,21420,3,"""2""",21840,21900
7706,205202,202802,60,21420,3,"""2""",21900,21960
7706,202802,204700,60,21420,3,"""2""",21960,22020
7706,204700,204801,120,21420,3,"""2""",22020,22140
7706,204801,203900,120,21420,3,"""2""",22140,22260
7706,203900,201503,60,21420,3,"""2""",22260,22320
7706,201503,208103,120,21420,3,"""2""",22320,22440
7706,208103,34104,60,21420,3,"""2""",22440,22500
7706,34104,105002,60,21420,3,"""2""",22500,22560
7706,105002,8002,60,21420,3,"""2""",22560,22620
7706,8002,103005,120,21420,3,"""2""",22620,22740
7706,103005,112104,180,21420,3,"""2""",22740,22920
7706,112104,403101,120,21420,3,"""2""",22920,23040
7706,403101,408203,60,21420,3,"""2""",23040,23100
7706,408203,407303,60,21420,3,"""2""",23100,23160
7706,407303,400102,60,21420,3,"""2""",23160,23220
7706,400102,401203,60,21420,3,"""2""",23220,23280
7706,401203,400302,60,21420,3,"""2""",23280,23340
7706,400302,407802,60,21420,3,"""2""",23340,23400
7706,407802,408602,60,21420,3,"""2""",23400,23460
7706,408602,404400,60,21420,3,"""2""",23460,23520
7706,404400,408603,60,21420,3,"""2""",23520,23580
7706,408603,33603,60,21420,3,"""2""",23580,23640
7706,33603,33606,60,21420,3,"""2""",23640,23700
7706,33606,405002,120,21420,3,"""2""",23700,23820
7706,405002,407908,180,21420,3,"""2""",23820,24000
7706,407908,406903,60,21420,3,"""2""",24000,24060
7706,406903,406702,60,21420,3,"""2""",24060,24120
7706,406702,302603,60,21420,3,"""2""",24120,24180
7706,302603,406002,60,21420,3,"""2""",24180,24240
7706,406002,404702,180,21420,3,"""2""",24240,24420
7706,208700,200302,60,22620,3,"""2""",22620,22680
7706,200302,205702,60,22620,3,"""2""",22680,22740
7706,205702,203302,60,22620,3,"""2""",22740,22800
7706,203302,201402,60,22620,3,"""2""",22800,22860
7706,201402,205103,180,22620,3,"""2""",22860,23040
7706,205103,205202,60,22620,3,"""2""",23040,23100
7706,205202,202802,60,22620,3,"""2""",23100,23160
7706,202802,204700,60,22620,3,"""2""",23160,23220
7706,204700,204801,120,22620,3,"""2""",23220,23340
7706,204801,203900,120,22620,3,"""2""",23340,23460
7706,203900,201503,60,22620,3,"""2""",23460,23520
7706,201503,208103,120,22620,3,"""2""",23520,23640
7706,208103,34104,60,22620,3,"""2""",23640,23700
7706,34104,105002,60,22620,3,"""2""",23700,23760
7706,105002,8002,60,22620,3,"""2""",23760,23820
7706,8002,103005,120,22620,3,"""2""",23820,23940
7706,103005,112104,180,22620,3,"""2""",23940,24120
7706,112104,403101,120,22620,3,"""2""",24120,24240
7706,403101,408203,60,22620,3,"""2""",24240,24300
7706,408203,407303,60,22620,3,"""2""",24300,24360
7706,407303,400102,60,22620,3,"""2""",24360,24420
7706,400102,401203,60,22620,3,"""2""",24420,24480
7706,401203,400302,60,22620,3,"""2""",24480,24540
7706,400302,407802,60,22620,3,"""2""",24540,24600
7706,407802,408602,60,22620,3,"""2""",24600,24660
7706,408602,404400,60,22620,3,"""2""",24660,24720
7706,404400,408603,60,22620,3,"""2""",24720,24780
7706,408603,33603,60,22620,3,"""2""",24780,24840
7706,33603,33606,60,22620,3,"""2""",24840,24900
7706,33606,405002,120,22620,3,"""2""",24900,25020
7706,405002,407908,180,22620,3,"""2""",25020,25200
7706,407908,406903,60,22620,3,"""2""",25200,25260
7706,406903,406702,60,22620,3,"""2""",25260,25320
7706,406702,302603,60,22620,3,"""2""",25320,25380
7706,302603,406002,60,22620,3,"""2""",25380,25440
7706,406002,404702,180,22620,3,"""2""",25440,25620
7706,208700,200302,60,23820,3,"""2""",23820,23880
7706,200302,205702,60,23820,3,"""2""",23880,23940
7706,205702,203302,60,23820,3,"""2""",23940,24000
7706,203302,201402,60,23820,3,"""2""",24000,24060
7706,201402,205103,180,23820,3,"""2""",24060,24240
7706,205103,205202,60,23820,3,"""2""",24240,24300
7706,205202,202802,60,23820,3,"""2""",24300,24360
7706,202802,204700,60,23820,3,"""2""",24360,24420
7706,204700,204801,120,23820,3,"""2""",24420,24540
7706,204801,203900,120,23820,3,"""2""",24540,24660
7706,203900,201503,60,23820,3,"""2""",24660,24720
7706,201503,208103,120,23820,3,"""2""",24720,24840
7706,208103,34104,60,23820,3,"""2""",24840,24900
7706,34104,105002,60,23820,3,"""2""",24900,24960
7706,105002,8002,60,23820,3,"""2""",24960,25020
7706,8002,103005,120,23820,3,"""2""",25020,25140
7706,103005,112104,180,23820,3,"""2""",25140,25320
7706,112104,403101,120,23820,3,"""2""",25320,25440
7706,403101,408203,60,23820,3,"""2""",25440,25500
7706,408203,407303,60,23820,3,"""2""",25500,25560
7706,407303,400102,60,23820,3,"""2""",25560,25620
7706,400102,401203,60,23820,3,"""2""",25620,25680
7706,401203,400302,60,23820,3,"""2""",25680,25740
7706,400302,407802,60,23820,3,"""2""",25740,25800
7706,407802,408602,60,23820,3,"""2""",25800,25860
7706,408602,404400,60,23820,3,"""2""",25860,25920
7706,404400,408603,60,23820,3,"""2""",25920,25980
7706,408603,33603,60,23820,3,"""2""",25980,26040
7706,33603,33606,60,23820,3,"""2""",26040,26100
7706,33606,405002,120,23820,3,"""2""",26100,26220
7706,405002,407908,180,23820,3,"""2""",26220,26400
7706,407908,406903,60,23820,3,"""2""",26400,26460
7706,406903,406702,60,23820,3,"""2""",26460,26520
7706,406702,302603,60,23820,3,"""2""",26520,26580
7706,302603,406002,60,23820,3,"""2""",26580,26640
7706,406002,404702,180,23820,3,"""2""",26640,26820
7706,208700,200302,60,25020,3,"""2""",25020,25080
7706,200302,205702,60,25020,3,"""2""",25080,25140
7706,205702,203302,60,25020,3,"""2""",25140,25200
7706,203302,201402,60,25020,3,"""2""",25200,25260
7706,201402,205103,180,25020,3,"""2""",25260,25440
7706,205103,205202,60,25020,3,"""2""",25440,25500
7706,205202,202802,60,25020,3,"""2""",25500,25560
7706,202802,204700,60,25020,3,"""2""",25560,25620
7706,204700,204801,120,25020,3,"""2""",25620,25740
7706,204801,203900,120,25020,3,"""2""",25740,25860
7706,203900,201503,60,25020,3,"""2""",25860,25920
7706,201503,208103,120,25020,3,"""2""",25920,26040
7706,208103,34104,60,25020,3,"""2""",26040,26100
7706,34104,105002,60,25020,3,"""2""",26100,26160
7706,105002,8002,60,25020,3,"""2""",26160,26220
7706,8002,103005,120,25020,3,"""2""",26220,26340
7706,103005,112104,180,25020,3,"""2""",26340,26520
7706,112104,403101,120,25020,3,"""2""",26520,26640
7706,403101,408203,60,25020,3,"""2""",26640,26700
7706,408203,407303,60,25020,3,"""2""",26700,26760
7706,407303,400102,60,25020,3,"""2""",26760,26820
7706,400102,401203,60,25020,3,"""2""",26820,26880
7706,401203,400302,60,25020,3,"""2""",26880,26940
7706,400302,407802,60,25020,3,"""2""",26940,27000
7706,407802,408602,60,25020,3,"""2""",27000,27060
7706,408602,404400,60,25020,3,"""2""",27060,27120
7706,404400,408603,60,25020,3,"""2""",27120,27180
7706,408603,33603,60,25020,3,"""2""",27180,27240
7706,33603,33606,60,25020,3,"""2""",27240,27300
7706,33606,405002,120,25020,3,"""2""",27300,27420
7706,405002,407908,180,25020,3,"""2""",27420,27600
7706,407908,406903,60,25020,3,"""2""",27600,27660
7706,406903,406702,60,25020,3,"""2""",27660,27720
7706,406702,302603,60,25020,3,"""2""",27720,27780
7706,302603,406002,60,25020,3,"""2""",27780,27840
7706,406002,404702,180,25020,3,"""2""",27840,28020
7706,208700,200302,60,26220,3,"""2""",26220,26280
7706,200302,205702,60,26220,3,"""2""",26280,26340
7706,205702,203302,60,26220,3,"""2""",26340,26400
7706,203302,201402,60,26220,3,"""2""",26400,26460
7706,201402,205103,180,26220,3,"""2""",26460,26640
7706,205103,205202,60,26220,3,"""2""",26640,26700
7706,205202,202802,60,26220,3,"""2""",26700,26760
7706,202802,204700,60,26220,3,"""2""",26760,26820
7706,204700,204801,120,26220,3,"""2""",26820,26940
7706,204801,203900,120,26220,3,"""2""",26940,27060
7706,203900,201503,60,26220,3,"""2""",27060,27120
7706,201503,208103,120,26220,3,"""2""",27120,27240
7706,208103,34104,60,26220,3,"""2""",27240,27300
7706,34104,105002,60,26220,3,"""2""",27300,27360
7706,105002,8002,60,26220,3,"""2""",27360,27420
7706,8002,103005,120,26220,3,"""2""",27420,27540
7706,103005,112104,180,26220,3,"""2""",27540,27720
7706,112104,403101,120,26220,3,"""2""",27720,27840
7706,403101,408203,60,26220,3,"""2""",27840,27900
7706,408203,407303,60,26220,3,"""2""",27900,27960
7706,407303,400102,60,26220,3,"""2""",27960,28020
7706,400102,401203,60,26220,3,"""2""",28020,28080
7706,401203,400302,60,26220,3,"""2""",28080,28140
7706,400302,407802,60,26220,3,"""2""",28140,28200
7706,407802,408602,60,26220,3,"""2""",28200,28260
7706,408602,404400,60,26220,3,"""2""",28260,28320
7706,404400,408603,60,26220,3,"""2""",28320,28380
7706,408603,33603,60,26220,3,"""2""",28380,28440
7706,33603,33606,60,26220,3,"""2""",28440,28500
7706,33606,405002,120,26220,3,"""2""",28500,28620
7706,405002,407908,180,26220,3,"""2""",28620,28800
7706,407908,406903,60,26220,3,"""2""",28800,28860
7706,406903,406702,60,26220,3,"""2""",28860,28920
7706,406702,302603,60,26220,3,"""2""",28920,28980
7706,302603,406002,60,26220,3,"""2""",28980,29040
7706,406002,404702,180,26220,3,"""2""",29040,29220
7706,208700,200302,60,27420,3,"""2""",27420,27480
7706,200302,205702,60,27420,3,"""2""",27480,27540
7706,205702,203302,60,27420,3,"""2""",27540,27600
7706,203302,201402,60,27420,3,"""2""",27600,27660
7706,201402,205103,180,27420,3,"""2""",27660,27840
7706,205103,205202,60,27420,3,"""2""",27840,27900
7706,205202,202802,60,27420,3,"""2""",27900,27960
7706,202802,204700,60,27420,3,"""2""",27960,28020
7706,204700,204801,120,27420,3,"""2""",28020,28140
7706,204801,203900,120,27420,3,"""2""",28140,28260
7706,203900,201503,60,27420,3,"""2""",28260,28320
7706,201503,208103,120,27420,3,"""2""",28320,28440
7706,208103,34104,60,27420,3,"""2""",28440,28500
7706,34104,105002,60,27420,3,"""2""",28500,28560
7706,105002,8002,60,27420,3,"""2""",28560,28620
7706,8002,103005,120,27420,3,"""2""",28620,28740
7706,103005,112104,180,27420,3,"""2""",28740,28920
7706,112104,403101,120,27420,3,"""2""",28920,29040
7706,403101,408203,60,27420,3,"""2""",29040,29100
7706,408203,407303,60,27420,3,"""2""",29100,29160
7706,407303,400102,60,27420,3,"""2""",29160,29220
7706,400102,401203,60,27420,3,"""2""",29220,29280
7706,401203,400302,60,27420,3,"""2""",29280,29340
7706,400302,407802,60,27420,3,"""2""",29340,29400
7706,407802,408602,60,27420,3,"""2""",29400,29460
7706,408602,404400,60,27420,3,"""2""",29460,29520
7706,404400,408603,60,27420,3,"""2""",29520,29580
7706,408603,33603,60,27420,3,"""2""",29580,29640
7706,33603,33606,60,27420,3,"""2""",29640,29700
7706,33606,405002,120,27420,3,"""2""",29700,29820
7706,405002,407908,180,27420,3,"""2""",29820,30000
7706,407908,406903,60,27420,3,"""2""",30000,30060
7706,406903,406702,60,27420,3,"""2""",30060,30120
7706,406702,302603,60,27420,3,"""2""",30120,30180
7706,302603,406002,60,27420,3,"""2""",30180,30240
7706,406002,404702,180,27420,3,"""2""",30240,30420
7706,208700,200302,60,28620,3,"""2""",28620,28680
7706,200302,205702,60,28620,3,"""2""",28680,28740
7706,205702,203302,60,28620,3,"""2""",28740,28800
7706,203302,201402,60,28620,3,"""2""",28800,28860
7706,201402,205103,180,28620,3,"""2""",28860,29040
7706,205103,205202,60,28620,3,"""2""",29040,29100
7706,205202,202802,60,28620,3,"""2""",29100,29160
7706,202802,204700,60,28620,3,"""2""",29160,29220
7706,204700,204801,120,28620,3,"""2""",29220,29340
7706,204801,203900,120,28620,3,"""2""",29340,29460
7706,203900,201503,60,28620,3,"""2""",29460,29520
7706,201503,208103,120,28620,3,"""2""",29520,29640
7706,208103,34104,60,28620,3,"""2""",29640,29700
7706,34104,105002,60,28620,3,"""2""",29700,29760
7706,105002,8002,60,28620,3,"""2""",29760,29820
7706,8002,103005,120,28620,3,"""2""",29820,29940
7706,103005,112104,180,28620,3,"""2""",29940,30120
7706,112104,403101,120,28620,3,"""2""",30120,30240
7706,403101,408203,60,28620,3,"""2""",30240,30300
7706,408203,407303,60,28620,3,"""2""",30300,30360
7706,407303,400102,60,28620,3,"""2""",30360,30420
7706,400102,401203,60,28620,3,"""2""",30420,30480
7706,401203,400302,60,28620,3,"""2""",30480,30540
7706,400302,407802,60,28620,3,"""2""",30540,30600
7706,407802,408602,60,28620,3,"""2""",30600,30660
7706,408602,404400,60,28620,3,"""2""",30660,30720
7706,404400,408603,60,28620,3,"""2""",30720,30780
7706,408603,33603,60,28620,3,"""2""",30780,30840
7706,33603,33606,60,28620,3,"""2""",30840,30900
7706,33606,405002,120,28620,3,"""2""",30900,31020
7706,405002,407908,180,28620,3,"""2""",31020,31200
7706,407908,406903,60,28620,3,"""2""",31200,31260
7706,406903,406702,60,28620,3,"""2""",31260,31320
7706,406702,302603,60,28620,3,"""2""",31320,31380
7706,302603,406002,60,28620,3,"""2""",31380,31440
7706,406002,404702,180,28620,3,"""2""",31440,31620
7706,208700,200302,60,29820,3,"""2""",29820,29880
7706,200302,205702,60,29820,3,"""2""",29880,29940
7706,205702,203302,60,29820,3,"""2""",29940,30000
7706,203302,201402,60,29820,3,"""2""",30000,30060
7706,201402,205103,180,29820,3,"""2""",30060,30240
7706,205103,205202,60,29820,3,"""2""",30240,30300
7706,205202,202802,60,29820,3,"""2""",30300,30360
7706,202802,204700,60,29820,3,"""2""",30360,30420
7706,204700,204801,120,29820,3,"""2""",30420,30540
7706,204801,203900,120,29820,3,"""2""",30540,30660
7706,203900,201503,60,29820,3,"""2""",30660,30720
7706,201503,208103,120,29820,3,"""2""",30720,30840
7706,208103,34104,60,29820,3,"""2""",30840,30900
7706,34104,105002,60,29820,3,"""2""",30900,30960
7706,105002,8002,60,29820,3,"""2""",30960,31020
7706,8002,103005,120,29820,3,"""2""",31020,31140
7706,103005,112104,180,29820,3,"""2""",31140,31320
7706,112104,403101,120,29820,3,"""2""",31320,31440
7706,403101,408203,60,29820,3,"""2""",31440,31500
7706,408203,407303,60,29820,3,"""2""",31500,31560
7706,407303,400102,60,29820,3,"""2""",31560,31620
7706,400102,401203,60,29820,3,"""2""",31620,31680
7706,401203,400302,60,29820,3,"""2""",31680,31740
7706,400302,407802,60,29820,3,"""2""",31740,31800
7706,407802,408602,60,29820,3,"""2""",31800,31860
7706,408602,404400,60,29820,3,"""2""",31860,31920
7706,404400,408603,60,29820,3,"""2""",31920,31980
7706,408603,33603,60,29820,3,"""2""",31980,32040
7706,33603,33606,60,29820,3,"""2""",32040,32100
7706,33606,405002,120,29820,3,"""2""",32100,32220
7706,405002,407908,180,29820,3,"""2""",32220,32400
7706,407908,406903,60,29820,3,"""2""",32400,32460
7706,406903,406702,60,29820,3,"""2""",32460,32520
7706,406702,302603,60,29820,3,"""2""",32520,32580
7706,302603,406002,60,29820,3,"""2""",32580,32640
7706,406002,404702,180,29820,3,"""2""",32640,32820
7706,208700,200302,60,31020,3,"""2""",31020,31080
7706,200302,205702,60,31020,3,"""2""",31080,31140
7706,205702,203302,60,31020,3,"""2""",31140,31200
7706,203302,201402,60,31020,3,"""2""",31200,31260
7706,201402,205103,180,31020,3,"""2""",31260,31440
7706,205103,205202,60,31020,3,"""2""",31440,31500
7706,205202,202802,60,31020,3,"""2""",31500,31560
7706,202802,204700,60,31020,3,"""2""",31560,31620
7706,204700,204801,120,31020,3,"""2""",31620,31740
7706,204801,203900,120,31020,3,"""2""",31740,31860
7706,203900,201503,60,31020,3,"""2""",31860,31920
7706,201503,208103,120,31020,3,"""2""",31920,32040
7706,208103,34104,60,31020,3,"""2""",32040,32100
7706,34104,105002,60,31020,3,"""2""",32100,32160
7706,105002,8002,60,31020,3,"""2""",32160,32220
7706,8002,103005,120,31020,3,"""2""",32220,32340
7706,103005,112104,180,31020,3,"""2""",32340,32520
7706,112104,403101,120,31020,3,"""2""",32520,32640
7706,403101,408203,60,31020,3,"""2""",32640,32700
7706,408203,407303,60,31020,3,"""2""",32700,32760
7706,407303,400102,60,31020,3,"""2""",32760,32820
7706,400102,401203,60,31020,3,"""2""",32820,32880
7706,401203,400302,60,31020,3,"""2""",32880,32940
7706,400302,407802,60,31020,3,"""2""",32940,33000
7706,407802,408602,60,31020,3,"""2""",33000,33060
7706,408602,404400,60,31020,3,"""2""",33060,33120
7706,404400,408603,60,31020,3,"""2""",33120,33180
7706,408603,33603,60,31020,3,"""2""",33180,33240
7706,33603,33606,60,31020,3,"""2""",33240,33300
7706,33606,405002,120,31020,3,"""2""",33300,33420
7706,405002,407908,180,31020,3,"""2""",33420,33600
7706,407908,406903,60,31020,3,"""2""",33600,33660
7706,406903,406702,60,31020,3,"""2""",33660,33720
7706,406702,302603,60,31020,3,"""2""",33720,33780
7706,302603,406002,60,31020,3,"""2""",33780,33840
7706,406002,404702,180,31020,3,"""2""",33840,34020
7706,208700,200302,60,32220,3,"""2""",32220,32280
7706,200302,205702,60,32220,3,"""2""",32280,32340
7706,205702,203302,60,32220,3,"""2""",32340,32400
7706,203302,201402,60,32220,3,"""2""",32400,32460
7706,201402,205103,180,32220,3,"""2""",32460,32640
7706,205103,205202,60,32220,3,"""2""",32640,32700
7706,205202,202802,60,32220,3,"""2""",32700,32760
7706,202802,204700,60,32220,3,"""2""",32760,32820
7706,204700,204801,120,32220,3,"""2""",32820,32940
7706,204801,203900,120,32220,3,"""2""",32940,33060
7706,203900,201503,60,32220,3,"""2""",33060,33120
7706,201503,208103,120,32220,3,"""2""",33120,33240
7706,208103,34104,60,32220,3,"""2""",33240,33300
7706,34104,105002,60,32220,3,"""2""",33300,33360
7706,105002,8002,60,32220,3,"""2""",33360,33420
7706,8002,103005,120,32220,3,"""2""",33420,33540
7706,103005,112104,180,32220,3,"""2""",33540,33720
7706,112104,403101,120,32220,3,"""2""",33720,33840
7706,403101,408203,60,32220,3,"""2""",33840,33900
7706,408203,407303,60,32220,3,"""2""",33900,33960
7706,407303,400102,60,32220,3,"""2""",33960,34020
7706,400102,401203,60,32220,3,"""2""",34020,34080
7706,401203,400302,60,32220,3,"""2""",34080,34140
7706,400302,407802,60,32220,3,"""2""",34140,34200
7706,407802,408602,60,32220,3,"""2""",34200,34260
7706,408602,404400,60,32220,3,"""2""",34260,34320
7706,404400,408603,60,32220,3,"""2""",34320,34380
7706,408603,33603,60,32220,3,"""2""",34380,34440
7706,33603,33606,60,32220,3,"""2""",34440,34500
7706,33606,405002,120,32220,3,"""2""",34500,34620
7706,405002,407908,180,32220,3,"""2""",34620,34800
7706,407908,406903,60,32220,3,"""2""",34800,34860
7706,406903,406702,60,32220,3,"""2""",34860,34920
7706,406702,302603,60,32220,3,"""2""",34920,34980
7706,302603,406002,60,32220,3,"""2""",34980,35040
7706,406002,404702,180,32220,3,"""2""",35040,35220
7706,208700,200302,60,33420,3,"""2""",33420,33480
7706,200302,205702,60,33420,3,"""2""",33480,33540
7706,205702,203302,60,33420,3,"""2""",33540,33600
7706,203302,201402,60,33420,3,"""2""",33600,33660
7706,201402,205103,180,33420,3,"""2""",33660,33840
7706,205103,205202,60,33420,3,"""2""",33840,33900
7706,205202,202802,60,33420,3,"""2""",33900,33960
7706,202802,204700,60,33420,3,"""2""",33960,34020
7706,204700,204801,120,33420,3,"""2""",34020,34140
7706,204801,203900,120,33420,3,"""2""",34140,34260
7706,203900,201503,60,33420,3,"""2""",34260,34320
7706,201503,208103,120,33420,3,"""2""",34320,34440
7706,208103,34104,60,33420,3,"""2""",34440,34500
7706,34104,105002,60,33420,3,"""2""",34500,34560
7706,105002,8002,60,33420,3,"""2""",34560,34620
7706,8002,103005,120,33420,3,"""2""",34620,34740
7706,103005,112104,180,33420,3,"""2""",34740,34920
7706,112104,403101,120,33420,3,"""2""",34920,35040
7706,403101,408203,60,33420,3,"""2""",35040,35100
7706,408203,407303,60,33420,3,"""2""",35100,35160
7706,407303,400102,60,33420,3,"""2""",35160,35220
7706,400102,401203,60,33420,3,"""2""",35220,35280
7706,401203,400302,60,33420,3,"""2""",35280,35340
7706,400302,407802,60,33420,3,"""2""",35340,35400
7706,407802,408602,60,33420,3,"""2""",35400,35460
7706,408602,404400,60,33420,3,"""2""",35460,35520
7706,404400,408603,60,33420,3,"""2""",35520,35580
7706,408603,33603,60,33420,3,"""2""",35580,35640
7706,33603,33606,60,33420,3,"""2""",35640,35700
7706,33606,405002,120,33420,3,"""2""",35700,35820
7706,405002,407908,180,33420,3,"""2""",35820,36000
7706,407908,406903,60,33420,3,"""2""",36000,36060
7706,406903,406702,60,33420,3,"""2""",36060,36120
7706,406702,302603,60,33420,3,"""2""",36120,36180
7706,302603,406002,60,33420,3,"""2""",36180,36240
7706,406002,404702,180,33420,3,"""2""",36240,36420
7706,208700,200302,60,34620,3,"""2""",34620,34680
7706,200302,205702,60,34620,3,"""2""",34680,34740
7706,205702,203302,60,34620,3,"""2""",34740,34800
7706,203302,201402,60,34620,3,"""2""",34800,34860
7706,201402,205103,180,34620,3,"""2""",34860,35040
7706,205103,205202,60,34620,3,"""2""",35040,35100
7706,205202,202802,60,34620,3,"""2""",35100,35160
7706,202802,204700,60,34620,3,"""2""",35160,35220
7706,204700,204801,120,34620,3,"""2""",35220,35340
7706,204801,203900,120,34620,3,"""2""",35340,35460
7706,203900,201503,60,34620,3,"""2""",35460,35520
7706,201503,208103,120,34620,3,"""2""",35520,35640
7706,208103,34104,60,34620,3,"""2""",35640,35700
7706,34104,105002,60,34620,3,"""2""",35700,35760
7706,105002,8002,60,34620,3,"""2""",35760,35820
7706,8002,103005,120,34620,3,"""2""",35820,35940
7706,103005,112104,180,34620,3,"""2""",35940,36120
7706,112104,403101,120,34620,3,"""2""",36120,36240
7706,403101,408203,60,34620,3,"""2""",36240,36300
7706,408203,407303,60,34620,3,"""2""",36300,36360
7706,407303,400102,60,34620,3,"""2""",36360,36420
7706,400102,401203,60,34620,3,"""2""",36420,36480
7706,401203,400302,60,34620,3,"""2""",36480,36540
7706,400302,407802,60,34620,3,"""2""",36540,36600
7706,407802,408602,60,34620,3,"""2""",36600,36660
7706,408602,404400,60,34620,3,"""2""",36660,36720
7706,404400,408603,60,34620,3,"""2""",36720,36780
7706,408603,33603,60,34620,3,"""2""",36780,36840
7706,33603,33606,60,34620,3,"""2""",36840,36900
7706,33606,405002,120,34620,3,"""2""",36900,37020
7706,405002,407908,180,34620,3,"""2""",37020,37200
7706,407908,406903,60,34620,3,"""2""",37200,37260
7706,406903,406702,60,34620,3,"""2""",37260,37320
7706,406702,302603,60,34620,3,"""2""",37320,37380
7706,302603,406002,60,34620,3,"""2""",37380,37440
7706,406002,404702,180,34620,3,"""2""",37440,37620
7706,208700,200302,60,35820,3,"""2""",35820,35880
7706,200302,205702,60,35820,3,"""2""",35880,35940
7706,205702,203302,60,35820,3,"""2""",35940,36000
7706,203302,201402,60,35820,3,"""2""",36000,36060
7706,201402,205103,180,35820,3,"""2""",36060,36240
7706,205103,205202,60,35820,3,"""2""",36240,36300
7706,205202,202802,60,35820,3,"""2""",36300,36360
7706,202802,204700,60,35820,3,"""2""",36360,36420
7706,204700,204801,120,35820,3,"""2""",36420,36540
7706,204801,203900,120,35820,3,"""2""",36540,36660
7706,203900,201503,60,35820,3,"""2""",36660,36720
7706,201503,208103,120,35820,3,"""2""",36720,36840
7706,208103,34104,60,35820,3,"""2""",36840,36900
7706,34104,105002,60,35820,3,"""2""",36900,36960
7706,105002,8002,60,35820,3,"""2""",36960,37020
7706,8002,103005,120,35820,3,"""2""",37020,37140
7706,103005,112104,180,35820,3,"""2""",37140,37320
7706,112104,403101,120,35820,3,"""2""",37320,37440
7706,403101,408203,60,35820,3,"""2""",37440,37500
7706,408203,407303,60,35820,3,"""2""",37500,37560
7706,407303,400102,60,35820,3,"""2""",37560,37620
7706,400102,401203,60,35820,3,"""2""",37620,37680
7706,401203,400302,60,35820,3,"""2""",37680,37740
7706,400302,407802,60,35820,3,"""2""",37740,37800
7706,407802,408602,60,35820,3,"""2""",37800,37860
7706,408602,404400,60,35820,3,"""2""",37860,37920
7706,404400,408603,60,35820,3,"""2""",37920,37980
7706,408603,33603,60,35820,3,"""2""",37980,38040
7706,33603,33606,60,35820,3,"""2""",38040,38100
7706,33606,405002,120,35820,3,"""2""",38100,38220
7706,405002,407908,180,35820,3,"""2""",38220,38400
7706,407908,406903,60,35820,3,"""2""",38400,38460
7706,406903,406702,60,35820,3,"""2""",38460,38520
7706,406702,302603,60,35820,3,"""2""",38520,38580
7706,302603,406002,60,35820,3,"""2""",38580,38640
7706,406002,404702,180,35820,3,"""2""",38640,38820
7706,208700,200302,60,37020,3,"""2""",37020,37080
7706,200302,205702,60,37020,3,"""2""",37080,37140
7706,205702,203302,60,37020,3,"""2""",37140,37200
7706,203302,201402,60,37020,3,"""2""",37200,37260
7706,201402,205103,180,37020,3,"""2""",37260,37440
7706,205103,205202,60,37020,3,"""2""",37440,37500
7706,205202,202802,60,37020,3,"""2""",37500,37560
7706,202802,204700,60,37020,3,"""2""",37560,37620
7706,204700,204801,120,37020,3,"""2""",37620,37740
7706,204801,203900,120,37020,3,"""2""",37740,37860
7706,203900,201503,60,37020,3,"""2""",37860,37920
7706,201503,208103,120,37020,3,"""2""",37920,38040
7706,208103,34104,60,37020,3,"""2""",38040,38100
7706,34104,105002,60,37020,3,"""2""",38100,38160
7706,105002,8002,60,37020,3,"""2""",38160,38220
7706,8002,103005,120,37020,3,"""2""",38220,38340
7706,103005,112104,180,37020,3,"""2""",38340,38520
7706,112104,403101,120,37020,3,"""2""",38520,38640
7706,403101,408203,60,37020,3,"""2""",38640,38700
7706,408203,407303,60,37020,3,"""2""",38700,38760
7706,407303,400102,60,37020,3,"""2""",38760,38820
7706,400102,401203,60,37020,3,"""2""",38820,38880
7706,401203,400302,60,37020,3,"""2""",38880,38940
7706,400302,407802,60,37020,3,"""2""",38940,39000
7706,407802,408602,60,37020,3,"""2""",39000,39060
7706,408602,404400,60,37020,3,"""2""",39060,39120
7706,404400,408603,60,37020,3,"""2""",39120,39180
7706,408603,33603,60,37020,3,"""2""",39180,39240
7706,33603,33606,60,37020,3,"""2""",39240,39300
7706,33606,405002,120,37020,3,"""2""",39300,39420
7706,405002,407908,180,37020,3,"""2""",39420,39600
7706,407908,406903,60,37020,3,"""2""",39600,39660
7706,406903,406702,60,37020,3,"""2""",39660,39720
7706,406702,302603,60,37020,3,"""2""",39720,39780
7706,302603,406002,60,37020,3,"""2""",39780,39840
7706,406002,404702,180,37020,3,"""2""",39840,40020
7706,208700,200302,60,38220,3,"""2""",38220,38280
7706,200302,205702,60,38220,3,"""2""",38280,38340
7706,205702,203302,60,38220,3,"""2""",38340,38400
7706,203302,201402,60,38220,3,"""2""",38400,38460
7706,201402,205103,180,38220,3,"""2""",38460,38640
7706,205103,205202,60,38220,3,"""2""",38640,38700
7706,205202,202802,60,38220,3,"""2""",38700,38760
7706,202802,204700,60,38220,3,"""2""",38760,38820
7706,204700,204801,120,38220,3,"""2""",38820,38940
7706,204801,203900,120,38220,3,"""2""",38940,39060
7706,203900,201503,60,38220,3,"""2""",39060,39120
7706,201503,208103,120,38220,3,"""2""",39120,39240
7706,208103,34104,60,38220,3,"""2""",39240,39300
7706,34104,105002,60,38220,3,"""2""",39300,39360
7706,105002,8002,60,38220,3,"""2""",39360,39420
7706,8002,103005,120,38220,3,"""2""",39420,39540
7706,103005,112104,180,38220,3,"""2""",39540,39720
7706,112104,403101,120,38220,3,"""2""",39720,39840
7706,403101,408203,60,38220,3,"""2""",39840,39900
7706,408203,407303,60,38220,3,"""2""",39900,39960
7706,407303,400102,60,38220,3,"""2""",39960,40020
7706,400102,401203,60,38220,3,"""2""",40020,40080
7706,401203,400302,60,38220,3,"""2""",40080,40140
7706,400302,407802,60,38220,3,"""2""",40140,40200
7706,407802,408602,60,38220,3,"""2""",40200,40260
7706,408602,404400,60,38220,3,"""2""",40260,40320
7706,404400,408603,60,38220,3,"""2""",40320,40380
7706,408603,33603,60,38220,3,"""2""",40380,40440
7706,33603,33606,60,38220,3,"""2""",40440,40500
7706,33606,405002,120,38220,3,"""2""",40500,40620
7706,405002,407908,180,38220,3,"""2""",40620,40800
7706,407908,406903,60,38220,3,"""2""",40800,40860
7706,406903,406702,60,38220,3,"""2""",40860,40920
7706,406702,302603,60,38220,3,"""2""",40920,40980
7706,302603,406002,60,38220,3,"""2""",40980,41040
7706,406002,404702,180,38220,3,"""2""",41040,41220
7706,208700,200302,60,39420,3,"""2""",39420,39480
7706,200302,205702,60,39420,3,"""2""",39480,39540
7706,205702,203302,60,39420,3,"""2""",39540,39600
7706,203302,201402,60,39420,3,"""2""",39600,39660
7706,201402,205103,180,39420,3,"""2""",39660,39840
7706,205103,205202,60,39420,3,"""2""",39840,39900
7706,205202,202802,60,39420,3,"""2""",39900,39960
7706,202802,204700,60,39420,3,"""2""",39960,40020
7706,204700,204801,120,39420,3,"""2""",40020,40140
7706,204801,203900,120,39420,3,"""2""",40140,40260
7706,203900,201503,60,39420,3,"""2""",40260,40320
7706,201503,208103,120,39420,3,"""2""",40320,40440
7706,208103,34104,60,39420,3,"""2""",40440,40500
7706,34104,105002,60,39420,3,"""2""",40500,40560
7706,105002,8002,60,39420,3,"""2""",40560,40620
7706,8002,103005,120,39420,3,"""2""",40620,40740
7706,103005,112104,180,39420,3,"""2""",40740,40920
7706,112104,403101,120,39420,3,"""2""",40920,41040
7706,403101,408203,60,39420,3,"""2""",41040,41100
7706,408203,407303,60,39420,3,"""2""",41100,41160
7706,407303,400102,60,39420,3,"""2""",41160,41220
7706,400102,401203,60,39420,3,"""2""",41220,41280
7706,401203,400302,60,39420,3,"""2""",41280,41340
7706,400302,407802,60,39420,3,"""2""",41340,41400
7706,407802,408602,60,39420,3,"""2""",41400,41460
7706,408602,404400,60,39420,3,"""2""",41460,41520
7706,404400,408603,60,39420,3,"""2""",41520,41580
7706,408603,33603,60,39420,3,"""2""",41580,41640
7706,33603,33606,60,39420,3,"""2""",41640,41700
7706,33606,405002,120,39420,3,"""2""",41700,41820
7706,405002,407908,180,39420,3,"""2""",41820,42000
7706,407908,406903,60,39420,3,"""2""",42000,42060
7706,406903,406702,60,39420,3,"""2""",42060,42120
7706,406702,302603,60,39420,3,"""2""",42120,42180
7706,302603,406002,60,39420,3,"""2""",42180,42240
7706,406002,404702,180,39420,3,"""2""",42240,42420
7706,208700,200302,60,40620,3,"""2""",40620,40680
7706,200302,205702,60,40620,3,"""2""",40680,40740
7706,205702,203302,60,40620,3,"""2""",40740,40800
7706,203302,201402,60,40620,3,"""2""",40800,40860
7706,201402,205103,180,40620,3,"""2""",40860,41040
7706,205103,205202,60,40620,3,"""2""",41040,41100
7706,205202,202802,60,40620,3,"""2""",41100,41160
7706,202802,204700,60,40620,3,"""2""",41160,41220
7706,204700,204801,120,40620,3,"""2""",41220,41340
7706,204801,203900,120,40620,3,"""2""",41340,41460
7706,203900,201503,60,40620,3,"""2""",41460,41520
7706,201503,208103,120,40620,3,"""2""",41520,41640
7706,208103,34104,60,40620,3,"""2""",41640,41700
7706,34104,105002,60,40620,3,"""2""",41700,41760
7706,105002,8002,60,40620,3,"""2""",41760,41820
7706,8002,103005,120,40620,3,"""2""",41820,41940
7706,103005,112104,180,40620,3,"""2""",41940,42120
7706,112104,403101,120,40620,3,"""2""",42120,42240
7706,403101,408203,60,40620,3,"""2""",42240,42300
7706,408203,407303,60,40620,3,"""2""",42300,42360
7706,407303,400102,60,40620,3,"""2""",42360,42420
7706,400102,401203,60,40620,3,"""2""",42420,42480
7706,401203,400302,60,40620,3,"""2""",42480,42540
7706,400302,407802,60,40620,3,"""2""",42540,42600
7706,407802,408602,60,40620,3,"""2""",42600,42660
7706,408602,404400,60,40620,3,"""2""",42660,42720
7706,404400,408603,60,40620,3,"""2""",42720,42780
7706,408603,33603,60,40620,3,"""2""",42780,42840
7706,33603,33606,60,40620,3,"""2""",42840,42900
7706,33606,405002,120,40620,3,"""2""",42900,43020
7706,405002,407908,180,40620,3,"""2""",43020,43200
7706,407908,406903,60,40620,3,"""2""",43200,43260
7706,406903,406702,60,40620,3,"""2""",43260,43320
7706,406702,302603,60,40620,3,"""2""",43320,43380
7706,302603,406002,60,40620,3,"""2""",43380,43440
7706,406002,404702,180,40620,3,"""2""",43440,43620
7706,208700,200302,60,41820,3,"""2""",41820,41880
7706,200302,205702,60,41820,3,"""2""",41880,41940
7706,205702,203302,60,41820,3,"""2""",41940,42000
7706,203302,201402,60,41820,3,"""2""",42000,42060
7706,201402,205103,180,41820,3,"""2""",42060,42240
7706,205103,205202,60,41820,3,"""2""",42240,42300
7706,205202,202802,60,41820,3,"""2""",42300,42360
7706,202802,204700,60,41820,3,"""2""",42360,42420
7706,204700,204801,120,41820,3,"""2""",42420,42540
7706,204801,203900,120,41820,3,"""2""",42540,42660
7706,203900,201503,60,41820,3,"""2""",42660,42720
7706,201503,208103,120,41820,3,"""2""",42720,42840
7706,208103,34104,60,41820,3,"""2""",42840,42900
7706,34104,105002,60,41820,3,"""2""",42900,42960
7706,105002,8002,60,41820,3,"""2""",42960,43020
7706,8002,103005,120,41820,3,"""2""",43020,43140
7706,103005,112104,180,41820,3,"""2""",43140,43320
7706,112104,403101,120,41820,3,"""2""",43320,43440
7706,403101,408203,60,41820,3,"""2""",43440,43500
7706,408203,407303,60,41820,3,"""2""",43500,43560
7706,407303,400102,60,41820,3,"""2""",43560,43620
7706,400102,401203,60,41820,3,"""2""",43620,43680
7706,401203,400302,60,41820,3,"""2""",43680,43740
7706,400302,407802,60,41820,3,"""2""",43740,43800
7706,407802,408602,60,41820,3,"""2""",43800,43860
7706,408602,404400,60,41820,3,"""2""",43860,43920
7706,404400,408603,60,41820,3,"""2""",43920,43980
7706,408603,33603,60,41820,3,"""2""",43980,44040
7706,33603,33606,60,41820,3,"""2""",44040,44100
7706,33606,405002,120,41820,3,"""2""",44100,44220
7706,405002,407908,180,41820,3,"""2""",44220,44400
7706,407908,406903,60,41820,3,"""2""",44400,44460
7706,406903,406702,60,41820,3,"""2""",44460,44520
7706,406702,302603,60,41820,3,"""2""",44520,44580
7706,302603,406002,60,41820,3,"""2""",44580,44640
7706,406002,404702,180,41820,3,"""2""",44640,44820
7706,208700,200302,60,43020,3,"""2""",43020,43080
7706,200302,205702,60,43020,3,"""2""",43080,43140
7706,205702,203302,60,43020,3,"""2""",43140,43200
7706,203302,201402,60,43020,3,"""2""",43200,43260
7706,201402,205103,180,43020,3,"""2""",43260,43440
7706,205103,205202,60,43020,3,"""2""",43440,43500
7706,205202,202802,60,43020,3,"""2""",43500,43560
7706,202802,204700,60,43020,3,"""2""",43560,43620
7706,204700,204801,120,43020,3,"""2""",43620,43740
7706,204801,203900,120,43020,3,"""2""",43740,43860
7706,203900,201503,60,43020,3,"""2""",43860,43920
7706,201503,208103,120,43020,3,"""2""",43920,44040
7706,208103,34104,60,43020,3,"""2""",44040,44100
7706,34104,105002,60,43020,3,"""2""",44100,44160
7706,105002,8002,60,43020,3,"""2""",44160,44220
7706,8002,103005,120,43020,3,"""2""",44220,44340
7706,103005,112104,180,43020,3,"""2""",44340,44520
7706,112104,403101,120,43020,3,"""2""",44520,44640
7706,403101,408203,60,43020,3,"""2""",44640,44700
7706,408203,407303,60,43020,3,"""2""",44700,44760
7706,407303,400102,60,43020,3,"""2""",44760,44820
7706,400102,401203,60,43020,3,"""2""",44820,44880
7706,401203,400302,60,43020,3,"""2""",44880,44940
7706,400302,407802,60,43020,3,"""2""",44940,45000
7706,407802,408602,60,43020,3,"""2""",45000,45060
7706,408602,404400,60,43020,3,"""2""",45060,45120
7706,404400,408603,60,43020,3,"""2""",45120,45180
7706,408603,33603,60,43020,3,"""2""",45180,45240
7706,33603,33606,60,43020,3,"""2""",45240,45300
7706,33606,405002,120,43020,3,"""2""",45300,45420
7706,405002,407908,180,43020,3,"""2""",45420,45600
7706,407908,406903,60,43020,3,"""2""",45600,45660
7706,406903,406702,60,43020,3,"""2""",45660,45720
7706,406702,302603,60,43020,3,"""2""",45720,45780
7706,302603,406002,60,43020,3,"""2""",45780,45840
7706,406002,404702,180,43020,3,"""2""",45840,46020
7706,208700,200302,60,44220,3,"""2""",44220,44280
7706,200302,205702,60,44220,3,"""2""",44280,44340
7706,205702,203302,60,44220,3,"""2""",44340,44400
7706,203302,201402,60,44220,3,"""2""",44400,44460
7706,201402,205103,180,44220,3,"""2""",44460,44640
7706,205103,205202,60,44220,3,"""2""",44640,44700
7706,205202,202802,60,44220,3,"""2""",44700,44760
7706,202802,204700,60,44220,3,"""2""",44760,44820
7706,204700,204801,120,44220,3,"""2""",44820,44940
7706,204801,203900,120,44220,3,"""2""",44940,45060
7706,203900,201503,60,44220,3,"""2""",45060,45120
7706,201503,208103,120,44220,3,"""2""",45120,45240
7706,208103,34104,60,44220,3,"""2""",45240,45300
7706,34104,105002,60,44220,3,"""2""",45300,45360
7706,105002,8002,60,44220,3,"""2""",45360,45420
7706,8002,103005,120,44220,3,"""2""",45420,45540
7706,103005,112104,180,44220,3,"""2""",45540,45720
7706,112104,403101,120,44220,3,"""2""",45720,45840
7706,403101,408203,60,44220,3,"""2""",45840,45900
7706,408203,407303,60,44220,3,"""2""",45900,45960
7706,407303,400102,60,44220,3,"""2""",45960,46020
7706,400102,401203,60,44220,3,"""2""",46020,46080
7706,401203,400302,60,44220,3,"""2""",46080,46140
7706,400302,407802,60,44220,3,"""2""",46140,46200
7706,407802,408602,60,44220,3,"""2""",46200,46260
7706,408602,404400,60,44220,3,"""2""",46260,46320
7706,404400,408603,60,44220,3,"""2""",46320,46380
7706,408603,33603,60,44220,3,"""2""",46380,46440
7706,33603,33606,60,44220,3,"""2""",46440,46500
7706,33606,405002,120,44220,3,"""2""",46500,46620
7706,405002,407908,180,44220,3,"""2""",46620,46800
7706,407908,406903,60,44220,3,"""2""",46800,46860
7706,406903,406702,60,44220,3,"""2""",46860,46920
7706,406702,302603,60,44220,3,"""2""",46920,46980
7706,302603,406002,60,44220,3,"""2""",46980,47040
7706,406002,404702,180,44220,3,"""2""",47040,47220
7706,208700,200302,60,45420,3,"""2""",45420,45480
7706,200302,205702,60,45420,3,"""2""",45480,45540
7706,205702,203302,60,45420,3,"""2""",45540,45600
7706,203302,201402,60,45420,3,"""2""",45600,45660
7706,201402,205103,180,45420,3,"""2""",45660,45840
7706,205103,205202,60,45420,3,"""2""",45840,45900
7706,205202,202802,60,45420,3,"""2""",45900,45960
7706,202802,204700,60,45420,3,"""2""",45960,46020
7706,204700,204801,120,45420,3,"""2""",46020,46140
7706,204801,203900,120,45420,3,"""2""",46140,46260
7706,203900,201503,60,45420,3,"""2""",46260,46320
7706,201503,208103,120,45420,3,"""2""",46320,46440
7706,208103,34104,60,45420,3,"""2""",46440,46500
7706,34104,105002,60,45420,3,"""2""",46500,46560
7706,105002,8002,60,45420,3,"""2""",46560,46620
7706,8002,103005,120,45420,3,"""2""",46620,46740
7706,103005,112104,180,45420,3,"""2""",46740,46920
7706,112104,403101,120,45420,3,"""2""",46920,47040
7706,403101,408203,60,45420,3,"""2""",47040,47100
7706,408203,407303,60,45420,3,"""2""",47100,47160
7706,407303,400102,60,45420,3,"""2""",47160,47220
7706,400102,401203,60,45420,3,"""2""",47220,47280
7706,401203,400302,60,45420,3,"""2""",47280,47340
7706,400302,407802,60,45420,3,"""2""",47340,47400
7706,407802,408602,60,45420,3,"""2""",47400,47460
7706,408602,404400,60,45420,3,"""2""",47460,47520
7706,404400,408603,60,45420,3,"""2""",47520,47580
7706,408603,33603,60,45420,3,"""2""",47580,47640
7706,33603,33606,60,45420,3,"""2""",47640,47700
7706,33606,405002,120,45420,3,"""2""",47700,47820
7706,405002,407908,180,45420,3,"""2""",47820,48000
7706,407908,406903,60,45420,3,"""2""",48000,48060
7706,406903,406702,60,45420,3,"""2""",48060,48120
7706,406702,302603,60,45420,3,"""2""",48120,48180
7706,302603,406002,60,45420,3,"""2""",48180,48240
7706,406002,404702,180,45420,3,"""2""",48240,48420
7706,208700,200302,60,46620,3,"""2""",46620,46680
7706,200302,205702,60,46620,3,"""2""",46680,46740
7706,205702,203302,60,46620,3,"""2""",46740,46800
7706,203302,201402,60,46620,3,"""2""",46800,46860
7706,201402,205103,180,46620,3,"""2""",46860,47040
7706,205103,205202,60,46620,3,"""2""",47040,47100
7706,205202,202802,60,46620,3,"""2""",47100,47160
7706,202802,204700,60,46620,3,"""2""",47160,47220
7706,204700,204801,120,46620,3,"""2""",47220,47340
7706,204801,203900,120,46620,3,"""2""",47340,47460
7706,203900,201503,60,46620,3,"""2""",47460,47520
7706,201503,208103,120,46620,3,"""2""",47520,47640
7706,208103,34104,60,46620,3,"""2""",47640,47700
7706,34104,105002,60,46620,3,"""2""",47700,47760
7706,105002,8002,60,46620,3,"""2""",47760,47820
7706,8002,103005,120,46620,3,"""2""",47820,47940
7706,103005,112104,180,46620,3,"""2""",47940,48120
7706,112104,403101,120,46620,3,"""2""",48120,48240
7706,403101,408203,60,46620,3,"""2""",48240,48300
7706,408203,407303,60,46620,3,"""2""",48300,48360
7706,407303,400102,60,46620,3,"""2""",48360,48420
7706,400102,401203,60,46620,3,"""2""",48420,48480
7706,401203,400302,60,46620,3,"""2""",48480,48540
7706,400302,407802,60,46620,3,"""2""",48540,48600
7706,407802,408602,60,46620,3,"""2""",48600,48660
7706,408602,404400,60,46620,3,"""2""",48660,48720
7706,404400,408603,60,46620,3,"""2""",48720,48780
7706,408603,33603,60,46620,3,"""2""",48780,48840
7706,33603,33606,60,46620,3,"""2""",48840,48900
7706,33606,405002,120,46620,3,"""2""",48900,49020
7706,405002,407908,180,46620,3,"""2""",49020,49200
7706,407908,406903,60,46620,3,"""2""",49200,49260
7706,406903,406702,60,46620,3,"""2""",49260,49320
7706,406702,302603,60,46620,3,"""2""",49320,49380
7706,302603,406002,60,46620,3,"""2""",49380,49440
7706,406002,404702,180,46620,3,"""2""",49440,49620
7706,208700,200302,60,47820,3,"""2""",47820,47880
7706,200302,205702,60,47820,3,"""2""",47880,47940
7706,205702,203302,60,47820,3,"""2""",47940,48000
7706,203302,201402,60,47820,3,"""2""",48000,48060
7706,201402,205103,180,47820,3,"""2""",48060,48240
7706,205103,205202,60,47820,3,"""2""",48240,48300
7706,205202,202802,60,47820,3,"""2""",48300,48360
7706,202802,204700,60,47820,3,"""2""",48360,48420
7706,204700,204801,120,47820,3,"""2""",48420,48540
7706,204801,203900,120,47820,3,"""2""",48540,48660
7706,203900,201503,60,47820,3,"""2""",48660,48720
7706,201503,208103,120,47820,3,"""2""",48720,48840
7706,208103,34104,60,47820,3,"""2""",48840,48900
7706,34104,105002,60,47820,3,"""2""",48900,48960
7706,105002,8002,60,47820,3,"""2""",48960,49020
7706,8002,103005,120,47820,3,"""2""",49020,49140
7706,103005,112104,180,47820,3,"""2""",49140,49320
7706,112104,403101,120,47820,3,"""2""",49320,49440
7706,403101,408203,60,47820,3,"""2""",49440,49500
7706,408203,407303,60,47820,3,"""2""",49500,49560
7706,407303,400102,60,47820,3,"""2""",49560,49620
7706,400102,401203,60,47820,3,"""2""",49620,49680
7706,401203,400302,60,47820,3,"""2""",49680,49740
7706,400302,407802,60,47820,3,"""2""",49740,49800
7706,407802,408602,60,47820,3,"""2""",49800,49860
7706,408602,404400,60,47820,3,"""2""",49860,49920
7706,404400,408603,60,47820,3,"""2""",49920,49980
7706,408603,33603,60,47820,3,"""2""",49980,50040
7706,33603,33606,60,47820,3,"""2""",50040,50100
7706,33606,405002,120,47820,3,"""2""",50100,50220
7706,405002,407908,180,47820,3,"""2""",50220,50400
7706,407908,406903,60,47820,3,"""2""",50400,50460
7706,406903,406702,60,47820,3,"""2""",50460,50520
7706,406702,302603,60,47820,3,"""2""",50520,50580
7706,302603,406002,60,47820,3,"""2""",50580,50640
7706,406002,404702,180,47820,3,"""2""",50640,50820
7706,208700,200302,60,49020,3,"""2""",49020,49080
7706,200302,205702,60,49020,3,"""2""",49080,49140
7706,205702,203302,60,49020,3,"""2""",49140,49200
7706,203302,201402,60,49020,3,"""2""",49200,49260
7706,201402,205103,180,49020,3,"""2""",49260,49440
7706,205103,205202,60,49020,3,"""2""",49440,49500
7706,205202,202802,60,49020,3,"""2""",49500,49560
7706,202802,204700,60,49020,3,"""2""",49560,49620
7706,204700,204801,120,49020,3,"""2""",49620,49740
7706,204801,203900,120,49020,3,"""2""",49740,49860
7706,203900,201503,60,49020,3,"""2""",49860,49920
7706,201503,208103,120,49020,3,"""2""",49920,50040
7706,208103,34104,60,49020,3,"""2""",50040,50100
7706,34104,105002,60,49020,3,"""2""",50100,50160
7706,105002,8002,60,49020,3,"""2""",50160,50220
7706,8002,103005,120,49020,3,"""2""",50220,50340
7706,103005,112104,180,49020,3,"""2""",50340,50520
7706,112104,403101,120,49020,3,"""2""",50520,50640
7706,403101,408203,60,49020,3,"""2""",50640,50700
7706,408203,407303,60,49020,3,"""2""",50700,50760
7706,407303,400102,60,49020,3,"""2""",50760,50820
7706,400102,401203,60,49020,3,"""2""",50820,50880
7706,401203,400302,60,49020,3,"""2""",50880,50940
7706,400302,407802,60,49020,3,"""2""",50940,51000
7706,407802,408602,60,49020,3,"""2""",51000,51060
7706,408602,404400,60,49020,3,"""2""",51060,51120
7706,404400,408603,60,49020,3,"""2""",51120,51180
7706,408603,33603,60,49020,3,"""2""",51180,51240
7706,33603,33606,60,49020,3,"""2""",51240,51300
7706,33606,405002,120,49020,3,"""2""",51300,51420
7706,405002,407908,180,49020,3,"""2""",51420,51600
7706,407908,406903,60,49020,3,"""2""",51600,51660
7706,406903,406702,60,49020,3,"""2""",51660,51720
7706,406702,302603,60,49020,3,"""2""",51720,51780
7706,302603,406002,60,49020,3,"""2""",51780,51840
7706,406002,404702,180,49020,3,"""2""",51840,52020
7706,208700,200302,60,50220,3,"""2""",50220,50280
7706,200302,205702,60,50220,3,"""2""",50280,50340
7706,205702,203302,60,50220,3,"""2""",50340,50400
7706,203302,201402,60,50220,3,"""2""",50400,50460
7706,201402,205103,180,50220,3,"""2""",50460,50640
7706,205103,205202,60,50220,3,"""2""",50640,50700
7706,205202,202802,60,50220,3,"""2""",50700,50760
7706,202802,204700,60,50220,3,"""2""",50760,50820
7706,204700,204801,120,50220,3,"""2""",50820,50940
7706,204801,203900,120,50220,3,"""2""",50940,51060
7706,203900,201503,60,50220,3,"""2""",51060,51120
7706,201503,208103,120,50220,3,"""2""",51120,51240
7706,208103,34104,60,50220,3,"""2""",51240,51300
7706,34104,105002,60,50220,3,"""2""",51300,51360
7706,105002,8002,60,50220,3,"""2""",51360,51420
7706,8002,103005,120,50220,3,"""2""",51420,51540
7706,103005,112104,180,50220,3,"""2""",51540,51720
7706,112104,403101,120,50220,3,"""2""",51720,51840
7706,403101,408203,60,50220,3,"""2""",51840,51900
7706,408203,407303,60,50220,3,"""2""",51900,51960
7706,407303,400102,60,50220,3,"""2""",51960,52020
7706,400102,401203,60,50220,3,"""2""",52020,52080
7706,401203,400302,60,50220,3,"""2""",52080,52140
7706,400302,407802,60,50220,3,"""2""",52140,52200
7706,407802,408602,60,50220,3,"""2""",52200,52260
7706,408602,404400,60,50220,3,"""2""",52260,52320
7706,404400,408603,60,50220,3,"""2""",52320,52380
7706,408603,33603,60,50220,3,"""2""",52380,52440
7706,33603,33606,60,50220,3,"""2""",52440,52500
7706,33606,405002,120,50220,3,"""2""",52500,52620
7706,405002,407908,180,50220,3,"""2""",52620,52800
7706,407908,406903,60,50220,3,"""2""",52800,52860
7706,406903,406702,60,50220,3,"""2""",52860,52920
7706,406702,302603,60,50220,3,"""2""",52920,52980
7706,302603,406002,60,50220,3,"""2""",52980,53040
7706,406002,404702,180,50220,3,"""2""",53040,53220
7706,208700,200302,60,51420,3,"""2""",51420,51480
7706,200302,205702,60,51420,3,"""2""",51480,51540
7706,205702,203302,60,51420,3,"""2""",51540,51600
7706,203302,201402,60,51420,3,"""2""",51600,51660
7706,201402,205103,180,51420,3,"""2""",51660,51840
7706,205103,205202,60,51420,3,"""2""",51840,51900
7706,205202,202802,60,51420,3,"""2""",51900,51960
7706,202802,204700,60,51420,3,"""2""",51960,52020
7706,204700,204801,120,51420,3,"""2""",52020,52140
7706,204801,203900,120,51420,3,"""2""",52140,52260
7706,203900,201503,60,51420,3,"""2""",52260,52320
7706,201503,208103,120,51420,3,"""2""",52320,52440
7706,208103,34104,60,51420,3,"""2""",52440,52500
7706,34104,105002,60,51420,3,"""2""",52500,52560
7706,105002,8002,60,51420,3,"""2""",52560,52620
7706,8002,103005,120,51420,3,"""2""",52620,52740
7706,103005,112104,180,51420,3,"""2""",52740,52920
7706,112104,403101,120,51420,3,"""2""",52920,53040
7706,403101,408203,60,51420,3,"""2""",53040,53100
7706,408203,407303,60,51420,3,"""2""",53100,53160
7706,407303,400102,60,51420,3,"""2""",53160,53220
7706,400102,401203,60,51420,3,"""2""",53220,53280
7706,401203,400302,60,51420,3,"""2""",53280,53340
7706,400302,407802,60,51420,3,"""2""",53340,53400
7706,407802,408602,60,51420,3,"""2""",53400,53460
7706,408602,404400,60,51420,3,"""2""",53460,53520
7706,404400,408603,60,51420,3,"""2""",53520,53580
7706,408603,33603,60,51420,3,"""2""",53580,53640
7706,33603,33606,60,51420,3,"""2""",53640,53700
7706,33606,405002,120,51420,3,"""2""",53700,53820
7706,405002,407908,180,51420,3,"""2""",53820,54000
7706,407908,406903,60,51420,3,"""2""",54000,54060
7706,406903,406702,60,51420,3,"""2""",54060,54120
7706,406702,302603,60,51420,3,"""2""",54120,54180
7706,302603,406002,60,51420,3,"""2""",54180,54240
7706,406002,404702,180,51420,3,"""2""",54240,54420
7706,208700,200302,60,52620,3,"""2""",52620,52680
7706,200302,205702,60,52620,3,"""2""",52680,52740
7706,205702,203302,60,52620,3,"""2""",52740,52800
7706,203302,201402,60,52620,3,"""2""",52800,52860
7706,201402,205103,180,52620,3,"""2""",52860,53040
7706,205103,205202,60,52620,3,"""2""",53040,53100
7706,205202,202802,60,52620,3,"""2""",53100,53160
7706,202802,204700,60,52620,3,"""2""",53160,53220
7706,204700,204801,120,52620,3,"""2""",53220,53340
7706,204801,203900,120,52620,3,"""2""",53340,53460
7706,203900,201503,60,52620,3,"""2""",53460,53520
7706,201503,208103,120,52620,3,"""2""",53520,53640
7706,208103,34104,60,52620,3,"""2""",53640,53700
7706,34104,105002,60,52620,3,"""2""",53700,53760
7706,105002,8002,60,52620,3,"""2""",53760,53820
7706,8002,103005,120,52620,3,"""2""",53820,53940
7706,103005,112104,180,52620,3,"""2""",53940,54120
7706,112104,403101,120,52620,3,"""2""",54120,54240
7706,403101,408203,60,52620,3,"""2""",54240,54300
7706,408203,407303,60,52620,3,"""2""",54300,54360
7706,407303,400102,60,52620,3,"""2""",54360,54420
7706,400102,401203,60,52620,3,"""2""",54420,54480
7706,401203,400302,60,52620,3,"""2""",54480,54540
7706,400302,407802,60,52620,3,"""2""",54540,54600
7706,407802,408602,60,52620,3,"""2""",54600,54660
7706,408602,404400,60,52620,3,"""2""",54660,54720
7706,404400,408603,60,52620,3,"""2""",54720,54780
7706,408603,33603,60,52620,3,"""2""",54780,54840
7706,33603,33606,60,52620,3,"""2""",54840,54900
7706,33606,405002,120,52620,3,"""2""",54900,55020
7706,405002,407908,180,52620,3,"""2""",55020,55200
7706,407908,406903,60,52620,3,"""2""",55200,55260
7706,406903,406702,60,52620,3,"""2""",55260,55320
7706,406702,302603,60,52620,3,"""2""",55320,55380
7706,302603,406002,60,52620,3,"""2""",55380,55440
7706,406002,404702,180,52620,3,"""2""",55440,55620
7706,208700,200302,60,53820,3,"""2""",53820,53880
7706,200302,205702,60,53820,3,"""2""",53880,53940
7706,205702,203302,60,53820,3,"""2""",53940,54000
7706,203302,201402,60,53820,3,"""2""",54000,54060
7706,201402,205103,180,53820,3,"""2""",54060,54240
7706,205103,205202,60,53820,3,"""2""",54240,54300
7706,205202,202802,60,53820,3,"""2""",54300,54360
7706,202802,204700,60,53820,3,"""2""",54360,54420
7706,204700,204801,120,53820,3,"""2""",54420,54540
7706,204801,203900,120,53820,3,"""2""",54540,54660
7706,203900,201503,60,53820,3,"""2""",54660,54720
7706,201503,208103,120,53820,3,"""2""",54720,54840
7706,208103,34104,60,53820,3,"""2""",54840,54900
7706,34104,105002,60,53820,3,"""2""",54900,54960
7706,105002,8002,60,53820,3,"""2""",54960,55020
7706,8002,103005,120,53820,3,"""2""",55020,55140
7706,103005,112104,180,53820,3,"""2""",55140,55320
7706,112104,403101,120,53820,3,"""2""",55320,55440
7706,403101,408203,60,53820,3,"""2""",55440,55500
7706,408203,407303,60,53820,3,"""2""",55500,55560
7706,407303,400102,60,53820,3,"""2""",55560,55620
7706,400102,401203,60,53820,3,"""2""",55620,55680
7706,401203,400302,60,53820,3,"""2""",55680,55740
7706,400302,407802,60,53820,3,"""2""",55740,55800
7706,407802,408602,60,53820,3,"""2""",55800,55860
7706,408602,404400,60,53820,3,"""2""",55860,55920
7706,404400,408603,60,53820,3,"""2""",55920,55980
7706,408603,33603,60,53820,3,"""2""",55980,56040
7706,33603,33606,60,53820,3,"""2""",56040,56100
7706,33606,405002,120,53820,3,"""2""",56100,56220
7706,405002,407908,180,53820,3,"""2""",56220,56400
7706,407908,406903,60,53820,3,"""2""",56400,56460
7706,406903,406702,60,53820,3,"""2""",56460,56520
7706,406702,302603,60,53820,3,"""2""",56520,56580
7706,302603,406002,60,53820,3,"""2""",56580,56640
7706,406002,404702,180,53820,3,"""2""",56640,56820
7706,208700,200302,60,55020,3,"""2""",55020,55080
7706,200302,205702,60,55020,3,"""2""",55080,55140
7706,205702,203302,60,55020,3,"""2""",55140,55200
7706,203302,201402,60,55020,3,"""2""",55200,55260
7706,201402,205103,180,55020,3,"""2""",55260,55440
7706,205103,205202,60,55020,3,"""2""",55440,55500
7706,205202,202802,60,55020,3,"""2""",55500,55560
7706,202802,204700,60,55020,3,"""2""",55560,55620
7706,204700,204801,120,55020,3,"""2""",55620,55740
7706,204801,203900,120,55020,3,"""2""",55740,55860
7706,203900,201503,60,55020,3,"""2""",55860,55920
7706,201503,208103,120,55020,3,"""2""",55920,56040
7706,208103,34104,60,55020,3,"""2""",56040,56100
7706,34104,105002,60,55020,3,"""2""",56100,56160
7706,105002,8002,60,55020,3,"""2""",56160,56220
7706,8002,103005,120,55020,3,"""2""",56220,56340
7706,103005,112104,180,55020,3,"""2""",56340,56520
7706,112104,403101,120,55020,3,"""2""",56520,56640
7706,403101,408203,60,55020,3,"""2""",56640,56700
7706,408203,407303,60,55020,3,"""2""",56700,56760
7706,407303,400102,60,55020,3,"""2""",56760,56820
7706,400102,401203,60,55020,3,"""2""",56820,56880
7706,401203,400302,60,55020,3,"""2""",56880,56940
7706,400302,407802,60,55020,3,"""2""",56940,57000
7706,407802,408602,60,55020,3,"""2""",57000,57060
7706,408602,404400,60,55020,3,"""2""",57060,57120
7706,404400,408603,60,55020,3,"""2""",57120,57180
7706,408603,33603,60,55020,3,"""2""",57180,57240
7706,33603,33606,60,55020,3,"""2""",57240,57300
7706,33606,405002,120,55020,3,"""2""",57300,57420
7706,405002,407908,180,55020,3,"""2""",57420,57600
7706,407908,406903,60,55020,3,"""2""",57600,57660
7706,406903,406702,60,55020,3,"""2""",57660,57720
7706,406702,302603,60,55020,3,"""2""",57720,57780
7706,302603,406002,60,55020,3,"""2""",57780,57840
7706,406002,404702,180,55020,3,"""2""",57840,58020
7706,208700,200302,60,56220,3,"""2""",56220,56280
7706,200302,205702,60,56220,3,"""2""",56280,56340
7706,205702,203302,60,56220,3,"""2""",56340,56400
7706,203302,201402,60,56220,3,"""2""",56400,56460
7706,201402,205103,180,56220,3,"""2""",56460,56640
7706,205103,205202,60,56220,3,"""2""",56640,56700
7706,205202,202802,60,56220,3,"""2""",56700,56760
7706,202802,204700,60,56220,3,"""2""",56760,56820
7706,204700,204801,120,56220,3,"""2""",56820,56940
7706,204801,203900,120,56220,3,"""2""",56940,57060
7706,203900,201503,60,56220,3,"""2""",57060,57120
7706,201503,208103,120,56220,3,"""2""",57120,57240
7706,208103,34104,60,56220,3,"""2""",57240,57300
7706,34104,105002,60,56220,3,"""2""",57300,57360
7706,105002,8002,60,56220,3,"""2""",57360,57420
7706,8002,103005,120,56220,3,"""2""",57420,57540
7706,103005,112104,180,56220,3,"""2""",57540,57720
7706,112104,403101,120,56220,3,"""2""",57720,57840
7706,403101,408203,60,56220,3,"""2""",57840,57900
7706,408203,407303,60,56220,3,"""2""",57900,57960
7706,407303,400102,60,56220,3,"""2""",57960,58020
7706,400102,401203,60,56220,3,"""2""",58020,58080
7706,401203,400302,60,56220,3,"""2""",58080,58140
7706,400302,407802,60,56220,3,"""2""",58140,58200
7706,407802,408602,60,56220,3,"""2""",58200,58260
7706,408602,404400,60,56220,3,"""2""",58260,58320
7706,404400,408603,60,56220,3,"""2""",58320,58380
7706,408603,33603,60,56220,3,"""2""",58380,58440
7706,33603,33606,60,56220,3,"""2""",58440,58500
7706,33606,405002,120,56220,3,"""2""",58500,58620
7706,405002,407908,180,56220,3,"""2""",58620,58800
7706,407908,406903,60,56220,3,"""2""",58800,58860
7706,406903,406702,60,56220,3,"""2""",58860,58920
7706,406702,302603,60,56220,3,"""2""",58920,58980
7706,302603,406002,60,56220,3,"""2""",58980,59040
7706,406002,404702,180,56220,3,"""2""",59040,59220
7706,208700,200302,60,57420,3,"""2""",57420,57480
7706,200302,205702,60,57420,3,"""2""",57480,57540
7706,205702,203302,60,57420,3,"""2""",57540,57600
7706,203302,201402,60,57420,3,"""2""",57600,57660
7706,201402,205103,180,57420,3,"""2""",57660,57840
7706,205103,205202,60,57420,3,"""2""",57840,57900
7706,205202,202802,60,57420,3,"""2""",57900,57960
7706,202802,204700,60,57420,3,"""2""",57960,58020
7706,204700,204801,120,57420,3,"""2""",58020,58140
7706,204801,203900,120,57420,3,"""2""",58140,58260
7706,203900,201503,60,57420,3,"""2""",58260,58320
7706,201503,208103,120,57420,3,"""2""",58320,58440
7706,208103,34104,60,57420,3,"""2""",58440,58500
7706,34104,105002,60,57420,3,"""2""",58500,58560
7706,105002,8002,60,57420,3,"""2""",58560,58620
7706,8002,103005,120,57420,3,"""2""",58620,58740
7706,103005,112104,180,57420,3,"""2""",58740,58920
7706,112104,403101,120,57420,3,"""2""",58920,59040
7706,403101,408203,60,57420,3,"""2""",59040,59100
7706,408203,407303,60,57420,3,"""2""",59100,59160
7706,407303,400102,60,57420,3,"""2""",59160,59220
7706,400102,401203,60,57420,3,"""2""",59220,59280
7706,401203,400302,60,57420,3,"""2""",59280,59340
7706,400302,407802,60,57420,3,"""2""",59340,59400
7706,407802,408602,60,57420,3,"""2""",59400,59460
7706,408602,404400,60,57420,3,"""2""",59460,59520
7706,404400,408603,60,57420,3,"""2""",59520,59580
7706,408603,33603,60,57420,3,"""2""",59580,59640
7706,33603,33606,60,57420,3,"""2""",59640,59700
7706,33606,405002,120,57420,3,"""2""",59700,59820
7706,405002,407908,180,57420,3,"""2""",59820,60000
7706,407908,406903,60,57420,3,"""2""",60000,60060
7706,406903,406702,60,57420,3,"""2""",60060,60120
7706,406702,302603,60,57420,3,"""2""",60120,60180
7706,302603,406002,60,57420,3,"""2""",60180,60240
7706,406002,404702,180,57420,3,"""2""",60240,60420
7706,208700,200302,60,58620,3,"""2""",58620,58680
7706,200302,205702,60,58620,3,"""2""",58680,58740
7706,205702,203302,60,58620,3,"""2""",58740,58800
7706,203302,201402,60,58620,3,"""2""",58800,58860
7706,201402,205103,180,58620,3,"""2""",58860,59040
7706,205103,205202,60,58620,3,"""2""",59040,59100
7706,205202,202802,60,58620,3,"""2""",59100,59160
7706,202802,204700,60,58620,3,"""2""",59160,59220
7706,204700,204801,120,58620,3,"""2""",59220,59340
7706,204801,203900,120,58620,3,"""2""",59340,59460
7706,203900,201503,60,58620,3,"""2""",59460,59520
7706,201503,208103,120,58620,3,"""2""",59520,59640
7706,208103,34104,60,58620,3,"""2""",59640,59700
7706,34104,105002,60,58620,3,"""2""",59700,59760
7706,105002,8002,60,58620,3,"""2""",59760,59820
7706,8002,103005,120,58620,3,"""2""",59820,59940
7706,103005,112104,180,58620,3,"""2""",59940,60120
7706,112104,403101,120,58620,3,"""2""",60120,60240
7706,403101,408203,60,58620,3,"""2""",60240,60300
7706,408203,407303,60,58620,3,"""2""",60300,60360
7706,407303,400102,60,58620,3,"""2""",60360,60420
7706,400102,401203,60,58620,3,"""2""",60420,60480
7706,401203,400302,60,58620,3,"""2""",60480,60540
7706,400302,407802,60,58620,3,"""2""",60540,60600
7706,407802,408602,60,58620,3,"""2""",60600,60660
7706,408602,404400,60,58620,3,"""2""",60660,60720
7706,404400,408603,60,58620,3,"""2""",60720,60780
7706,408603,33603,60,58620,3,"""2""",60780,60840
7706,33603,33606,60,58620,3,"""2""",60840,60900
7706,33606,405002,120,58620,3,"""2""",60900,61020
7706,405002,407908,180,58620,3,"""2""",61020,61200
7706,407908,406903,60,58620,3,"""2""",61200,61260
7706,406903,406702,60,58620,3,"""2""",61260,61320
7706,406702,302603,60,58620,3,"""2""",61320,61380
7706,302603,406002,60,58620,3,"""2""",61380,61440
7706,406002,404702,180,58620,3,"""2""",61440,61620
7706,208700,200302,60,59820,3,"""2""",59820,59880
7706,200302,205702,60,59820,3,"""2""",59880,59940
7706,205702,203302,60,59820,3,"""2""",59940,60000
7706,203302,201402,60,59820,3,"""2""",60000,60060
7706,201402,205103,180,59820,3,"""2""",60060,60240
7706,205103,205202,60,59820,3,"""2""",60240,60300
7706,205202,202802,60,59820,3,"""2""",60300,60360
7706,202802,204700,60,59820,3,"""2""",60360,60420
7706,204700,204801,120,59820,3,"""2""",60420,60540
7706,204801,203900,120,59820,3,"""2""",60540,60660
7706,203900,201503,60,59820,3,"""2""",60660,60720
7706,201503,208103,120,59820,3,"""2""",60720,60840
7706,208103,34104,60,59820,3,"""2""",60840,60900
7706,34104,105002,60,59820,3,"""2""",60900,60960
7706,105002,8002,60,59820,3,"""2""",60960,61020
7706,8002,103005,120,59820,3,"""2""",61020,61140
7706,103005,112104,180,59820,3,"""2""",61140,61320
7706,112104,403101,120,59820,3,"""2""",61320,61440
7706,403101,408203,60,59820,3,"""2""",61440,61500
7706,408203,407303,60,59820,3,"""2""",61500,61560
7706,407303,400102,60,59820,3,"""2""",61560,61620
7706,400102,401203,60,59820,3,"""2""",61620,61680
7706,401203,400302,60,59820,3,"""2""",61680,61740
7706,400302,407802,60,59820,3,"""2""",61740,61800
7706,407802,408602,60,59820,3,"""2""",61800,61860
7706,408602,404400,60,59820,3,"""2""",61860,61920
7706,404400,408603,60,59820,3,"""2""",61920,61980
7706,408603,33603,60,59820,3,"""2""",61980,62040
7706,33603,33606,60,59820,3,"""2""",62040,62100
7706,33606,405002,120,59820,3,"""2""",62100,62220
7706,405002,407908,180,59820,3,"""2""",62220,62400
7706,407908,406903,60,59820,3,"""2""",62400,62460
7706,406903,406702,60,59820,3,"""2""",62460,62520
7706,406702,302603,60,59820,3,"""2""",62520,62580
7706,302603,406002,60,59820,3,"""2""",62580,62640
7706,406002,404702,180,59820,3,"""2""",62640,62820
7706,208700,200302,60,61020,3,"""2""",61020,61080
7706,200302,205702,60,61020,3,"""2""",61080,61140
7706,205702,203302,60,61020,3,"""2""",61140,61200
7706,203302,201402,60,61020,3,"""2""",61200,61260
7706,201402,205103,180,61020,3,"""2""",61260,61440
7706,205103,205202,60,61020,3,"""2""",61440,61500
7706,205202,202802,60,61020,3,"""2""",61500,61560
7706,202802,204700,60,61020,3,"""2""",61560,61620
7706,204700,204801,120,61020,3,"""2""",61620,61740
7706,204801,203900,120,61020,3,"""2""",61740,61860
7706,203900,201503,60,61020,3,"""2""",61860,61920
7706,201503,208103,120,61020,3,"""2""",61920,62040
7706,208103,34104,60,61020,3,"""2""",62040,62100
7706,34104,105002,60,61020,3,"""2""",62100,62160
7706,105002,8002,60,61020,3,"""2""",62160,62220
7706,8002,103005,120,61020,3,"""2""",62220,62340
7706,103005,112104,180,61020,3,"""2""",62340,62520
7706,112104,403101,120,61020,3,"""2""",62520,62640
7706,403101,408203,60,61020,3,"""2""",62640,62700
7706,408203,407303,60,61020,3,"""2""",62700,62760
7706,407303,400102,60,61020,3,"""2""",62760,62820
7706,400102,401203,60,61020,3,"""2""",62820,62880
7706,401203,400302,60,61020,3,"""2""",62880,62940
7706,400302,407802,60,61020,3,"""2""",62940,63000
7706,407802,408602,60,61020,3,"""2""",63000,63060
7706,408602,404400,60,61020,3,"""2""",63060,63120
7706,404400,408603,60,61020,3,"""2""",63120,63180
7706,408603,33603,60,61020,3,"""2""",63180,63240
7706,33603,33606,60,61020,3,"""2""",63240,63300
7706,33606,405002,120,61020,3,"""2""",63300,63420
7706,405002,407908,180,61020,3,"""2""",63420,63600
7706,407908,406903,60,61020,3,"""2""",63600,63660
7706,406903,406702,60,61020,3,"""2""",63660,63720
7706,406702,302603,60,61020,3,"""2""",63720,63780
7706,302603,406002,60,61020,3,"""2""",63780,63840
7706,406002,404702,180,61020,3,"""2""",63840,64020
7706,208700,200302,60,62220,3,"""2""",62220,62280
7706,200302,205702,60,62220,3,"""2""",62280,62340
7706,205702,203302,60,62220,3,"""2""",62340,62400
7706,203302,201402,60,62220,3,"""2""",62400,62460
7706,201402,205103,180,62220,3,"""2""",62460,62640
7706,205103,205202,60,62220,3,"""2""",62640,62700
7706,205202,202802,60,62220,3,"""2""",62700,62760
7706,202802,204700,60,62220,3,"""2""",62760,62820
7706,204700,204801,120,62220,3,"""2""",62820,62940
7706,204801,203900,120,62220,3,"""2""",62940,63060
7706,203900,201503,60,62220,3,"""2""",63060,63120
7706,201503,208103,120,62220,3,"""2""",63120,63240
7706,208103,34104,60,62220,3,"""2""",63240,63300
7706,34104,105002,60,62220,3,"""2""",63300,63360
7706,105002,8002,60,62220,3,"""2""",63360,63420
7706,8002,103005,120,62220,3,"""2""",63420,63540
7706,103005,112104,180,62220,3,"""2""",63540,63720
7706,112104,403101,120,62220,3,"""2""",63720,63840
7706,403101,408203,60,62220,3,"""2""",63840,63900
7706,408203,407303,60,62220,3,"""2""",63900,63960
7706,407303,400102,60,62220,3,"""2""",63960,64020
7706,400102,401203,60,62220,3,"""2""",64020,64080
7706,401203,400302,60,62220,3,"""2""",64080,64140
7706,400302,407802,60,62220,3,"""2""",64140,64200
7706,407802,408602,60,62220,3,"""2""",64200,64260
7706,408602,404400,60,62220,3,"""2""",64260,64320
7706,404400,408603,60,62220,3,"""2""",64320,64380
7706,408603,33603,60,62220,3,"""2""",64380,64440
7706,33603,33606,60,62220,3,"""2""",64440,64500
7706,33606,405002,120,62220,3,"""2""",64500,64620
7706,405002,407908,180,62220,3,"""2""",64620,64800
7706,407908,406903,60,62220,3,"""2""",64800,64860
7706,406903,406702,60,62220,3,"""2""",64860,64920
7706,406702,302603,60,62220,3,"""2""",64920,64980
7706,302603,406002,60,62220,3,"""2""",64980,65040
7706,406002,404702,180,62220,3,"""2""",65040,65220
7706,208700,200302,60,63420,3,"""2""",63420,63480
7706,200302,205702,60,63420,3,"""2""",63480,63540
7706,205702,203302,60,63420,3,"""2""",63540,63600
7706,203302,201402,60,63420,3,"""2""",63600,63660
7706,201402,205103,180,63420,3,"""2""",63660,63840
7706,205103,205202,60,63420,3,"""2""",63840,63900
7706,205202,202802,60,63420,3,"""2""",63900,63960
7706,202802,204700,60,63420,3,"""2""",63960,64020
7706,204700,204801,120,63420,3,"""2""",64020,64140
7706,204801,203900,120,63420,3,"""2""",64140,64260
7706,203900,201503,60,63420,3,"""2""",64260,64320
7706,201503,208103,120,63420,3,"""2""",64320,64440
7706,208103,34104,60,63420,3,"""2""",64440,64500
7706,34104,105002,60,63420,3,"""2""",64500,64560
7706,105002,8002,60,63420,3,"""2""",64560,64620
7706,8002,103005,120,63420,3,"""2""",64620,64740
7706,103005,112104,180,63420,3,"""2""",64740,64920
7706,112104,403101,120,63420,3,"""2""",64920,65040
7706,403101,408203,60,63420,3,"""2""",65040,65100
7706,408203,407303,60,63420,3,"""2""",65100,65160
7706,407303,400102,60,63420,3,"""2""",65160,65220
7706,400102,401203,60,63420,3,"""2""",65220,65280
7706,401203,400302,60,63420,3,"""2""",65280,65340
7706,400302,407802,60,63420,3,"""2""",65340,65400
7706,407802,408602,60,63420,3,"""2""",65400,65460
7706,408602,404400,60,63420,3,"""2""",65460,65520
7706,404400,408603,60,63420,3,"""2""",65520,65580
7706,408603,33603,60,63420,3,"""2""",65580,65640
7706,33603,33606,60,63420,3,"""2""",65640,65700
7706,33606,405002,120,63420,3,"""2""",65700,65820
7706,405002,407908,180,63420,3,"""2""",65820,66000
7706,407908,406903,60,63420,3,"""2""",66000,66060
7706,406903,406702,60,63420,3,"""2""",66060,66120
7706,406702,302603,60,63420,3,"""2""",66120,66180
7706,302603,406002,60,63420,3,"""2""",66180,66240
7706,406002,404702,180,63420,3,"""2""",66240,66420
7706,208700,200302,60,64620,3,"""2""",64620,64680
7706,200302,205702,60,64620,3,"""2""",64680,64740
7706,205702,203302,60,64620,3,"""2""",64740,64800
7706,203302,201402,60,64620,3,"""2""",64800,64860
7706,201402,205103,180,64620,3,"""2""",64860,65040
7706,205103,205202,60,64620,3,"""2""",65040,65100
7706,205202,202802,60,64620,3,"""2""",65100,65160
7706,202802,204700,60,64620,3,"""2""",65160,65220
7706,204700,204801,120,64620,3,"""2""",65220,65340
7706,204801,203900,120,64620,3,"""2""",65340,65460
7706,203900,201503,60,64620,3,"""2""",65460,65520
7706,201503,208103,120,64620,3,"""2""",65520,65640
7706,208103,34104,60,64620,3,"""2""",65640,65700
7706,34104,105002,60,64620,3,"""2""",65700,65760
7706,105002,8002,60,64620,3,"""2""",65760,65820
7706,8002,103005,120,64620,3,"""2""",65820,65940
7706,103005,112104,180,64620,3,"""2""",65940,66120
7706,112104,403101,120,64620,3,"""2""",66120,66240
7706,403101,408203,60,64620,3,"""2""",66240,66300
7706,408203,407303,60,64620,3,"""2""",66300,66360
7706,407303,400102,60,64620,3,"""2""",66360,66420
7706,400102,401203,60,64620,3,"""2""",66420,66480
7706,401203,400302,60,64620,3,"""2""",66480,66540
7706,400302,407802,60,64620,3,"""2""",66540,66600
7706,407802,408602,60,64620,3,"""2""",66600,66660
7706,408602,404400,60,64620,3,"""2""",66660,66720
7706,404400,408603,60,64620,3,"""2""",66720,66780
7706,408603,33603,60,64620,3,"""2""",66780,66840
7706,33603,33606,60,64620,3,"""2""",66840,66900
7706,33606,405002,120,64620,3,"""2""",66900,67020
7706,405002,407908,180,64620,3,"""2""",67020,67200
7706,407908,406903,60,64620,3,"""2""",67200,67260
7706,406903,406702,60,64620,3,"""2""",67260,67320
7706,406702,302603,60,64620,3,"""2""",67320,67380
7706,302603,406002,60,64620,3,"""2""",67380,67440
7706,406002,404702,180,64620,3,"""2""",67440,67620
7706,208700,200302,60,65820,3,"""2""",65820,65880
7706,200302,205702,60,65820,3,"""2""",65880,65940
7706,205702,203302,60,65820,3,"""2""",65940,66000
7706,203302,201402,60,65820,3,"""2""",66000,66060
7706,201402,205103,180,65820,3,"""2""",66060,66240
7706,205103,205202,60,65820,3,"""2""",66240,66300
7706,205202,202802,60,65820,3,"""2""",66300,66360
7706,202802,204700,60,65820,3,"""2""",66360,66420
7706,204700,204801,120,65820,3,"""2""",66420,66540
7706,204801,203900,120,65820,3,"""2""",66540,66660
7706,203900,201503,60,65820,3,"""2""",66660,66720
7706,201503,208103,120,65820,3,"""2""",66720,66840
7706,208103,34104,60,65820,3,"""2""",66840,66900
7706,34104,105002,60,65820,3,"""2""",66900,66960
7706,105002,8002,60,65820,3,"""2""",66960,67020
7706,8002,103005,120,65820,3,"""2""",67020,67140
7706,103005,112104,180,65820,3,"""2""",67140,67320
7706,112104,403101,120,65820,3,"""2""",67320,67440
7706,403101,408203,60,65820,3,"""2""",67440,67500
7706,408203,407303,60,65820,3,"""2""",67500,67560
7706,407303,400102,60,65820,3,"""2""",67560,67620
7706,400102,401203,60,65820,3,"""2""",67620,67680
7706,401203,400302,60,65820,3,"""2""",67680,67740
7706,400302,407802,60,65820,3,"""2""",67740,67800
7706,407802,408602,60,65820,3,"""2""",67800,67860
7706,408602,404400,60,65820,3,"""2""",67860,67920
7706,404400,408603,60,65820,3,"""2""",67920,67980
7706,408603,33603,60,65820,3,"""2""",67980,68040
7706,33603,33606,60,65820,3,"""2""",68040,68100
7706,33606,405002,120,65820,3,"""2""",68100,68220
7706,405002,407908,180,65820,3,"""2""",68220,68400
7706,407908,406903,60,65820,3,"""2""",68400,68460
7706,406903,406702,60,65820,3,"""2""",68460,68520
7706,406702,302603,60,65820,3,"""2""",68520,68580
7706,302603,406002,60,65820,3,"""2""",68580,68640
7706,406002,404702,180,65820,3,"""2""",68640,68820
7706,208700,200302,60,68640,3,"""2""",68640,68700
7706,200302,205702,60,68640,3,"""2""",68700,68760
7706,205702,203302,60,68640,3,"""2""",68760,68820
7706,203302,201402,60,68640,3,"""2""",68820,68880
7706,201402,205103,180,68640,3,"""2""",68880,69060
7706,205103,205202,60,68640,3,"""2""",69060,69120
7706,205202,202802,60,68640,3,"""2""",69120,69180
7706,202802,204700,60,68640,3,"""2""",69180,69240
7706,204700,204801,120,68640,3,"""2""",69240,69360
7706,204801,203900,120,68640,3,"""2""",69360,69480
7706,203900,201503,60,68640,3,"""2""",69480,69540
7706,201503,208103,120,68640,3,"""2""",69540,69660
7706,208103,34104,60,68640,3,"""2""",69660,69720
7706,34104,105002,60,68640,3,"""2""",69720,69780
7706,105002,8002,60,68640,3,"""2""",69780,69840
7706,8002,103005,120,68640,3,"""2""",69840,69960
7706,103005,112104,180,68640,3,"""2""",69960,70140
7706,112104,403101,120,68640,3,"""2""",70140,70260
7706,403101,408203,60,68640,3,"""2""",70260,70320
7706,408203,407303,60,68640,3,"""2""",70320,70380
7706,407303,400102,60,68640,3,"""2""",70380,70440
7706,400102,401203,60,68640,3,"""2""",70440,70500
7706,401203,400302,60,68640,3,"""2""",70500,70560
7706,400302,407802,60,68640,3,"""2""",70560,70620
7706,407802,408602,60,68640,3,"""2""",70620,70680
7706,408602,404400,60,68640,3,"""2""",70680,70740
7706,404400,408603,60,68640,3,"""2""",70740,70800
7706,408603,33603,60,68640,3,"""2""",70800,70860
7706,33603,33606,60,68640,3,"""2""",70860,70920
7706,33606,405002,120,68640,3,"""2""",70920,71040
7706,405002,407908,180,68640,3,"""2""",71040,71220
7706,407908,406903,60,68640,3,"""2""",71220,71280
7706,406903,406702,60,68640,3,"""2""",71280,71340
7706,406702,302603,60,68640,3,"""2""",71340,71400
7706,302603,406002,60,68640,3,"""2""",71400,71460
7706,406002,404702,180,68640,3,"""2""",71460,71640
7707,208700,200302,60,18060,3,"""2""",18060,18120
7707,200302,205702,60,18060,3,"""2""",18120,18180
7707,205702,203302,60,18060,3,"""2""",18180,18240
7707,203302,201402,60,18060,3,"""2""",18240,18300
7707,201402,205103,120,18060,3,"""2""",18300,18420
7707,205103,205202,60,18060,3,"""2""",18420,18480
7707,205202,202802,60,18060,3,"""2""",18480,18540
7707,202802,204700,60,18060,3,"""2""",18540,18600
7707,204700,204801,120,18060,3,"""2""",18600,18720
7707,204801,203900,120,18060,3,"""2""",18720,18840
7707,203900,201503,60,18060,3,"""2""",18840,18900
7707,201503,208103,60,18060,3,"""2""",18900,18960
7707,208103,34104,60,18060,3,"""2""",18960,19020
7707,34104,105002,60,18060,3,"""2""",19020,19080
7707,105002,8002,60,18060,3,"""2""",19080,19140
7707,8002,103005,120,18060,3,"""2""",19140,19260
7707,103005,112104,180,18060,3,"""2""",19260,19440
7707,112104,403101,60,18060,3,"""2""",19440,19500
7707,403101,408203,60,18060,3,"""2""",19500,19560
7707,408203,407303,60,18060,3,"""2""",19560,19620
7707,407303,400102,60,18060,3,"""2""",19620,19680
7707,400102,401203,60,18060,3,"""2""",19680,19740
7707,401203,400302,60,18060,3,"""2""",19740,19800
7707,400302,407802,60,18060,3,"""2""",19800,19860
7707,407802,408602,60,18060,3,"""2""",19860,19920
7707,408602,404400,60,18060,3,"""2""",19920,19980
7707,404400,408603,60,18060,3,"""2""",19980,20040
7707,408603,33603,60,18060,3,"""2""",20040,20100
7707,33603,33606,60,18060,3,"""2""",20100,20160
7707,33606,405002,60,18060,3,"""2""",20160,20220
7707,405002,407908,180,18060,3,"""2""",20220,20400
7707,407908,406903,60,18060,3,"""2""",20400,20460
7707,406903,406702,60,18060,3,"""2""",20460,20520
7707,406702,302603,60,18060,3,"""2""",20520,20580
7707,302603,406002,60,18060,3,"""2""",20580,20640
7707,406002,404702,180,18060,3,"""2""",20640,20820
7707,208700,200302,60,19260,3,"""2""",19260,19320
7707,200302,205702,60,19260,3,"""2""",19320,19380
7707,205702,203302,60,19260,3,"""2""",19380,19440
7707,203302,201402,60,19260,3,"""2""",19440,19500
7707,201402,205103,120,19260,3,"""2""",19500,19620
7707,205103,205202,60,19260,3,"""2""",19620,19680
7707,205202,202802,60,19260,3,"""2""",19680,19740
7707,202802,204700,60,19260,3,"""2""",19740,19800
7707,204700,204801,120,19260,3,"""2""",19800,19920
7707,204801,203900,120,19260,3,"""2""",19920,20040
7707,203900,201503,60,19260,3,"""2""",20040,20100
7707,201503,208103,60,19260,3,"""2""",20100,20160
7707,208103,34104,60,19260,3,"""2""",20160,20220
7707,34104,105002,60,19260,3,"""2""",20220,20280
7707,105002,8002,60,19260,3,"""2""",20280,20340
7707,8002,103005,120,19260,3,"""2""",20340,20460
7707,103005,112104,180,19260,3,"""2""",20460,20640
7707,112104,403101,60,19260,3,"""2""",20640,20700
7707,403101,408203,60,19260,3,"""2""",20700,20760
7707,408203,407303,60,19260,3,"""2""",20760,20820
7707,407303,400102,60,19260,3,"""2""",20820,20880
7707,400102,401203,60,19260,3,"""2""",20880,20940
7707,401203,400302,60,19260,3,"""2""",20940,21000
7707,400302,407802,60,19260,3,"""2""",21000,21060
7707,407802,408602,60,19260,3,"""2""",21060,21120
7707,408602,404400,60,19260,3,"""2""",21120,21180
7707,404400,408603,60,19260,3,"""2""",21180,21240
7707,408603,33603,60,19260,3,"""2""",21240,21300
7707,33603,33606,60,19260,3,"""2""",21300,21360
7707,33606,405002,60,19260,3,"""2""",21360,21420
7707,405002,407908,180,19260,3,"""2""",21420,21600
7707,407908,406903,60,19260,3,"""2""",21600,21660
7707,406903,406702,60,19260,3,"""2""",21660,21720
7707,406702,302603,60,19260,3,"""2""",21720,21780
7707,302603,406002,60,19260,3,"""2""",21780,21840
7707,406002,404702,180,19260,3,"""2""",21840,22020
7773,404702,32100,0,84060,3,"""13""",84060,84060
7773,32100,406001,60,84060,3,"""13""",84060,84120
7773,406001,302602,60,84060,3,"""13""",84120,84180
7773,302602,406701,60,84060,3,"""13""",84180,84240
7773,406701,406902,60,84060,3,"""13""",84240,84300
7773,406902,407909,60,84060,3,"""13""",84300,84360
7773,407909,405001,180,84060,3,"""13""",84360,84540
7773,405001,33604,60,84060,3,"""13""",84540,84600
7773,33604,408602,120,84060,3,"""13""",84600,84720
7773,408602,404400,60,84060,3,"""13""",84720,84780
7773,404400,408603,60,84060,3,"""13""",84780,84840
7773,408603,407801,60,84060,3,"""13""",84840,84900
7773,407801,400301,60,84060,3,"""13""",84900,84960
7773,400301,401202,0,84060,3,"""13""",84960,84960
7773,401202,400101,60,84060,3,"""13""",84960,85020
7773,400101,407302,60,84060,3,"""13""",85020,85080
7773,407302,408202,60,84060,3,"""13""",85080,85140
7773,408202,403104,60,84060,3,"""13""",85140,85200
7773,403104,112103,120,84060,3,"""13""",85200,85320
7773,112103,103001,180,84060,3,"""13""",85320,85500
7773,103001,8001,120,84060,3,"""13""",85500,85620
7773,8001,105001,60,84060,3,"""13""",85620,85680
7773,105001,34103,60,84060,3,"""13""",85680,85740
7773,34103,208102,120,84060,3,"""13""",85740,85860
7773,208102,201502,120,84060,3,"""13""",85860,85980
7773,201502,203904,120,84060,3,"""13""",85980,86100
7773,203904,204802,60,84060,3,"""13""",86100,86160
7773,204802,204702,60,84060,3,"""13""",86160,86220
7773,204702,202801,60,84060,3,"""13""",86220,86280
7773,202801,205201,60,84060,3,"""13""",86280,86340
7773,205201,205105,60,84060,3,"""13""",86340,86400
7773,205105,207704,60,84060,3,"""13""",86400,86460
7773,207704,207502,60,84060,3,"""13""",86460,86520
7773,207502,202501,60,84060,3,"""13""",86520,86580
7773,202501,205300,120,84060,3,"""13""",86580,86700
7773,205300,208700,360,84060,3,"""13""",86700,87060
7783,109018,112107,120,72480,66,"""1""",72480,72600
7783,112107,403102,60,72480,66,"""1""",72600,72660
7783,403102,404101,120,72480,66,"""1""",72660,72780
7783,404101,403001,60,72480,66,"""1""",72780,72840
7783,403001,406803,60,72480,66,"""1""",72840,72900
7783,406803,408003,120,72480,66,"""1""",72900,73020
7783,109018,112107,120,73680,66,"""1""",73680,73800
7783,112107,403102,60,73680,66,"""1""",73800,73860
7783,403102,404101,120,73680,66,"""1""",73860,73980
7783,404101,403001,60,73680,66,"""1""",73980,74040
7783,403001,406803,60,73680,66,"""1""",74040,74100
7783,406803,408003,120,73680,66,"""1""",74100,74220
7784,109018,112107,120,27840,66,"""1""",27840,27960
7784,112107,403102,60,27840,66,"""1""",27960,28020
7784,403102,404101,120,27840,66,"""1""",28020,28140
7784,404101,403001,60,27840,66,"""1""",28140,28200
7784,403001,406803,60,27840,66,"""1""",28200,28260
7784,406803,408003,180,27840,66,"""1""",28260,28440
7784,109018,112107,120,28440,66,"""1""",28440,28560
7784,112107,403102,60,28440,66,"""1""",28560,28620
7784,403102,404101,120,28440,66,"""1""",28620,28740
7784,404101,403001,60,28440,66,"""1""",28740,28800
7784,403001,406803,60,28440,66,"""1""",28800,28860
7784,406803,408003,180,28440,66,"""1""",28860,29040
7784,109018,112107,120,29040,66,"""1""",29040,29160
7784,112107,403102,60,29040,66,"""1""",29160,29220
7784,403102,404101,120,29040,66,"""1""",29220,29340
7784,404101,403001,60,29040,66,"""1""",29340,29400
7784,403001,406803,60,29040,66,"""1""",29400,29460
7784,406803,408003,180,29040,66,"""1""",29460,29640
7784,109018,112107,120,29640,66,"""1""",29640,29760
7784,112107,403102,60,29640,66,"""1""",29760,29820
7784,403102,404101,120,29640,66,"""1""",29820,29940
7784,404101,403001,60,29640,66,"""1""",29940,30000
7784,403001,406803,60,29640,66,"""1""",30000,30060
7784,406803,408003,180,29640,66,"""1""",30060,30240
7784,109018,112107,120,30240,66,"""1""",30240,30360
7784,112107,403102,60,30240,66,"""1""",30360,30420
7784,403102,404101,120,30240,66,"""1""",30420,30540
7784,404101,403001,60,30240,66,"""1""",30540,30600
7784,403001,406803,60,30240,66,"""1""",30600,30660
7784,406803,408003,180,30240,66,"""1""",30660,30840
7784,109018,112107,120,30840,66,"""1""",30840,30960
7784,112107,403102,60,30840,66,"""1""",30960,31020
7784,403102,404101,120,30840,66,"""1""",31020,31140
7784,404101,403001,60,30840,66,"""1""",31140,31200
7784,403001,406803,60,30840,66,"""1""",31200,31260
7784,406803,408003,180,30840,66,"""1""",31260,31440
7784,109018,112107,120,31440,66,"""1""",31440,31560
7784,112107,403102,60,31440,66,"""1""",31560,31620
7784,403102,404101,120,31440,66,"""1""",31620,31740
7784,404101,403001,60,31440,66,"""1""",31740,31800
7784,403001,406803,60,31440,66,"""1""",31800,31860
7784,406803,408003,180,31440,66,"""1""",31860,32040
7784,109018,112107,120,32040,66,"""1""",32040,32160
7784,112107,403102,60,32040,66,"""1""",32160,32220
7784,403102,404101,120,32040,66,"""1""",32220,32340
7784,404101,403001,60,32040,66,"""1""",32340,32400
7784,403001,406803,60,32040,66,"""1""",32400,32460
7784,406803,408003,180,32040,66,"""1""",32460,32640
7784,109018,112107,120,32640,66,"""1""",32640,32760
7784,112107,403102,60,32640,66,"""1""",32760,32820
7784,403102,404101,120,32640,66,"""1""",32820,32940
7784,404101,403001,60,32640,66,"""1""",32940,33000
7784,403001,406803,60,32640,66,"""1""",33000,33060
7784,406803,408003,180,32640,66,"""1""",33060,33240
7784,109018,112107,120,33240,66,"""1""",33240,33360
7784,112107,403102,60,33240,66,"""1""",33360,33420
7784,403102,404101,120,33240,66,"""1""",33420,33540
7784,404101,403001,60,33240,66,"""1""",33540,33600
7784,403001,406803,60,33240,66,"""1""",33600,33660
7784,406803,408003,180,33240,66,"""1""",33660,33840
7784,109018,112107,120,33840,66,"""1""",33840,33960
7784,112107,403102,60,33840,66,"""1""",33960,34020
7784,403102,404101,120,33840,66,"""1""",34020,34140
7784,404101,403001,60,33840,66,"""1""",34140,34200
7784,403001,406803,60,33840,66,"""1""",34200,34260
7784,406803,408003,180,33840,66,"""1""",34260,34440
7784,109018,112107,120,34440,66,"""1""",34440,34560
7784,112107,403102,60,34440,66,"""1""",34560,34620
7784,403102,404101,120,34440,66,"""1""",34620,34740
7784,404101,403001,60,34440,66,"""1""",34740,34800
7784,403001,406803,60,34440,66,"""1""",34800,34860
7784,406803,408003,180,34440,66,"""1""",34860,35040
7784,109018,112107,120,35040,66,"""1""",35040,35160
7784,112107,403102,60,35040,66,"""1""",35160,35220
7784,403102,404101,120,35040,66,"""1""",35220,35340
7784,404101,403001,60,35040,66,"""1""",35340,35400
7784,403001,406803,60,35040,66,"""1""",35400,35460
7784,406803,408003,180,35040,66,"""1""",35460,35640
7784,109018,112107,120,35640,66,"""1""",35640,35760
7784,112107,403102,60,35640,66,"""1""",35760,35820
7784,403102,404101,120,35640,66,"""1""",35820,35940
7784,404101,403001,60,35640,66,"""1""",35940,36000
7784,403001,406803,60,35640,66,"""1""",36000,36060
7784,406803,408003,180,35640,66,"""1""",36060,36240
7784,109018,112107,120,36240,66,"""1""",36240,36360
7784,112107,403102,60,36240,66,"""1""",36360,36420
7784,403102,404101,120,36240,66,"""1""",36420,36540
7784,404101,403001,60,36240,66,"""1""",36540,36600
7784,403001,406803,60,36240,66,"""1""",36600,36660
7784,406803,408003,180,36240,66,"""1""",36660,36840
7784,109018,112107,120,54240,66,"""1""",54240,54360
7784,112107,403102,60,54240,66,"""1""",54360,54420
7784,403102,404101,120,54240,66,"""1""",54420,54540
7784,404101,403001,60,54240,66,"""1""",54540,54600
7784,403001,406803,60,54240,66,"""1""",54600,54660
7784,406803,408003,180,54240,66,"""1""",54660,54840
7784,109018,112107,120,54840,66,"""1""",54840,54960
7784,112107,403102,60,54840,66,"""1""",54960,55020
7784,403102,404101,120,54840,66,"""1""",55020,55140
7784,404101,403001,60,54840,66,"""1""",55140,55200
7784,403001,406803,60,54840,66,"""1""",55200,55260
7784,406803,408003,180,54840,66,"""1""",55260,55440
7784,109018,112107,120,55440,66,"""1""",55440,55560
7784,112107,403102,60,55440,66,"""1""",55560,55620
7784,403102,404101,120,55440,66,"""1""",55620,55740
7784,404101,403001,60,55440,66,"""1""",55740,55800
7784,403001,406803,60,55440,66,"""1""",55800,55860
7784,406803,408003,180,55440,66,"""1""",55860,56040
7784,109018,112107,120,56040,66,"""1""",56040,56160
7784,112107,403102,60,56040,66,"""1""",56160,56220
7784,403102,404101,120,56040,66,"""1""",56220,56340
7784,404101,403001,60,56040,66,"""1""",56340,56400
7784,403001,406803,60,56040,66,"""1""",56400,56460
7784,406803,408003,180,56040,66,"""1""",56460,56640
7784,109018,112107,120,56640,66,"""1""",56640,56760
7784,112107,403102,60,56640,66,"""1""",56760,56820
7784,403102,404101,120,56640,66,"""1""",56820,56940
7784,404101,403001,60,56640,66,"""1""",56940,57000
7784,403001,406803,60,56640,66,"""1""",57000,57060
7784,406803,408003,180,56640,66,"""1""",57060,57240
7784,109018,112107,120,57240,66,"""1""",57240,57360
7784,112107,403102,60,57240,66,"""1""",57360,57420
7784,403102,404101,120,57240,66,"""1""",57420,57540
7784,404101,403001,60,57240,66,"""1""",57540,57600
7784,403001,406803,60,57240,66,"""1""",57600,57660
7784,406803,408003,180,57240,66,"""1""",57660,57840
7784,109018,112107,120,57840,66,"""1""",57840,57960
7784,112107,403102,60,57840,66,"""1""",57960,58020
7784,403102,404101,120,57840,66,"""1""",58020,58140
7784,404101,403001,60,57840,66,"""1""",58140,58200
7784,403001,406803,60,57840,66,"""1""",58200,58260
7784,406803,408003,180,57840,66,"""1""",58260,58440
7784,109018,112107,120,58440,66,"""1""",58440,58560
7784,112107,403102,60,58440,66,"""1""",58560,58620
7784,403102,404101,120,58440,66,"""1""",58620,58740
7784,404101,403001,60,58440,66,"""1""",58740,58800
7784,403001,406803,60,58440,66,"""1""",58800,58860
7784,406803,408003,180,58440,66,"""1""",58860,59040
7784,109018,112107,120,59040,66,"""1""",59040,59160
7784,112107,403102,60,59040,66,"""1""",59160,59220
7784,403102,404101,120,59040,66,"""1""",59220,59340
7784,404101,403001,60,59040,66,"""1""",59340,59400
7784,403001,406803,60,59040,66,"""1""",59400,59460
7784,406803,408003,180,59040,66,"""1""",59460,59640
7784,109018,112107,120,59640,66,"""1""",59640,59760
7784,112107,403102,60,59640,66,"""1""",59760,59820
7784,403102,404101,120,59640,66,"""1""",59820,59940
7784,404101,403001,60,59640,66,"""1""",59940,60000
7784,403001,406803,60,59640,66,"""1""",60000,60060
7784,406803,408003,180,59640,66,"""1""",60060,60240
7784,109018,112107,120,60240,66,"""1""",60240,60360
7784,112107,403102,60,60240,66,"""1""",60360,60420
7784,403102,404101,120,60240,66,"""1""",60420,60540
7784,404101,403001,60,60240,66,"""1""",60540,60600
7784,403001,406803,60,60240,66,"""1""",60600,60660
7784,406803,408003,180,60240,66,"""1""",60660,60840
7784,109018,112107,120,60840,66,"""1""",60840,60960
7784,112107,403102,60,60840,66,"""1""",60960,61020
7784,403102,404101,120,60840,66,"""1""",61020,61140
7784,404101,403001,60,60840,66,"""1""",61140,61200
7784,403001,406803,60,60840,66,"""1""",61200,61260
7784,406803,408003,180,60840,66,"""1""",61260,61440
7784,109018,112107,120,61440,66,"""1""",61440,61560
7784,112107,403102,60,61440,66,"""1""",61560,61620
7784,403102,404101,120,61440,66,"""1""",61620,61740
7784,404101,403001,60,61440,66,"""1""",61740,61800
7784,403001,406803,60,61440,66,"""1""",61800,61860
7784,406803,408003,180,61440,66,"""1""",61860,62040
7784,109018,112107,120,62040,66,"""1""",62040,62160
7784,112107,403102,60,62040,66,"""1""",62160,62220
7784,403102,404101,120,62040,66,"""1""",62220,62340
7784,404101,403001,60,62040,66,"""1""",62340,62400
7784,403001,406803,60,62040,66,"""1""",62400,62460
7784,406803,408003,180,62040,66,"""1""",62460,62640
7784,109018,112107,120,62640,66,"""1""",62640,62760
7784,112107,403102,60,62640,66,"""1""",62760,62820
7784,403102,404101,120,62640,66,"""1""",62820,62940
7784,404101,403001,60,62640,66,"""1""",62940,63000
7784,403001,406803,60,62640,66,"""1""",63000,63060
7784,406803,408003,180,62640,66,"""1""",63060,63240
7784,109018,112107,120,63240,66,"""1""",63240,63360
7784,112107,403102,60,63240,66,"""1""",63360,63420
7784,403102,404101,120,63240,66,"""1""",63420,63540
7784,404101,403001,60,63240,66,"""1""",63540,63600
7784,403001,406803,60,63240,66,"""1""",63600,63660
7784,406803,408003,180,63240,66,"""1""",63660,63840
7784,109018,112107,120,63840,66,"""1""",63840,63960
7784,112107,403102,60,63840,66,"""1""",63960,64020
7784,403102,404101,120,63840,66,"""1""",64020,64140
7784,404101,403001,60,63840,66,"""1""",64140,64200
7784,403001,406803,60,63840,66,"""1""",64200,64260
7784,406803,408003,180,63840,66,"""1""",64260,64440
7784,109018,112107,120,64440,66,"""1""",64440,64560
7784,112107,403102,60,64440,66,"""1""",64560,64620
7784,403102,404101,120,64440,66,"""1""",64620,64740
7784,404101,403001,60,64440,66,"""1""",64740,64800
7784,403001,406803,60,64440,66,"""1""",64800,64860
7784,406803,408003,180,64440,66,"""1""",64860,65040
7784,109018,112107,120,65040,66,"""1""",65040,65160
7784,112107,403102,60,65040,66,"""1""",65160,65220
7784,403102,404101,120,65040,66,"""1""",65220,65340
7784,404101,403001,60,65040,66,"""1""",65340,65400
7784,403001,406803,60,65040,66,"""1""",65400,65460
7784,406803,408003,180,65040,66,"""1""",65460,65640
7784,109018,112107,120,65640,66,"""1""",65640,65760
7784,112107,403102,60,65640,66,"""1""",65760,65820
7784,403102,404101,120,65640,66,"""1""",65820,65940
7784,404101,403001,60,65640,66,"""1""",65940,66000
7784,403001,406803,60,65640,66,"""1""",66000,66060
7784,406803,408003,180,65640,66,"""1""",66060,66240
7784,109018,112107,120,66240,66,"""1""",66240,66360
7784,112107,403102,60,66240,66,"""1""",66360,66420
7784,403102,404101,120,66240,66,"""1""",66420,66540
7784,404101,403001,60,66240,66,"""1""",66540,66600
7784,403001,406803,60,66240,66,"""1""",66600,66660
7784,406803,408003,180,66240,66,"""1""",66660,66840
7784,109018,112107,120,66840,66,"""1""",66840,66960
7784,112107,403102,60,66840,66,"""1""",66960,67020
7784,403102,404101,120,66840,66,"""1""",67020,67140
7784,404101,403001,60,66840,66,"""1""",67140,67200
7784,403001,406803,60,66840,66,"""1""",67200,67260
7784,406803,408003,180,66840,66,"""1""",67260,67440
7784,109018,112107,120,68040,66,"""1""",68040,68160
7784,112107,403102,60,68040,66,"""1""",68160,68220
7784,403102,404101,120,68040,66,"""1""",68220,68340
7784,404101,403001,60,68040,66,"""1""",68340,68400
7784,403001,406803,60,68040,66,"""1""",68400,68460
7784,406803,408003,180,68040,66,"""1""",68460,68640
7784,109018,112107,120,69240,66,"""1""",69240,69360
7784,112107,403102,60,69240,66,"""1""",69360,69420
7784,403102,404101,120,69240,66,"""1""",69420,69540
7784,404101,403001,60,69240,66,"""1""",69540,69600
7784,403001,406803,60,69240,66,"""1""",69600,69660
7784,406803,408003,180,69240,66,"""1""",69660,69840
7784,109018,112107,120,70440,66,"""1""",70440,70560
7784,112107,403102,60,70440,66,"""1""",70560,70620
7784,403102,404101,120,70440,66,"""1""",70620,70740
7784,404101,403001,60,70440,66,"""1""",70740,70800
7784,403001,406803,60,70440,66,"""1""",70800,70860
7784,406803,408003,180,70440,66,"""1""",70860,71040
7784,109018,112107,120,71640,66,"""1""",71640,71760
7784,112107,403102,60,71640,66,"""1""",71760,71820
7784,403102,404101,120,71640,66,"""1""",71820,71940
7784,404101,403001,60,71640,66,"""1""",71940,72000
7784,403001,406803,60,71640,66,"""1""",72000,72060
7784,406803,408003,180,71640,66,"""1""",72060,72240
7785,408005,406804,120,28380,66,"""2""",28380,28500
7785,406804,403002,60,28380,66,"""2""",28500,28560
7785,403002,404103,120,28380,66,"""2""",28560,28680
7785,404103,403104,120,28380,66,"""2""",28680,28800
7785,403104,112103,120,28380,66,"""2""",28800,28920
7785,112103,109018,120,28380,66,"""2""",28920,29040
7785,408005,406804,120,28980,66,"""2""",28980,29100
7785,406804,403002,60,28980,66,"""2""",29100,29160
7785,403002,404103,120,28980,66,"""2""",29160,29280
7785,404103,403104,120,28980,66,"""2""",29280,29400
7785,403104,112103,120,28980,66,"""2""",29400,29520
7785,112103,109018,120,28980,66,"""2""",29520,29640
7785,408005,406804,120,29580,66,"""2""",29580,29700
7785,406804,403002,60,29580,66,"""2""",29700,29760
7785,403002,404103,120,29580,66,"""2""",29760,29880
7785,404103,403104,120,29580,66,"""2""",29880,30000
7785,403104,112103,120,29580,66,"""2""",30000,30120
7785,112103,109018,120,29580,66,"""2""",30120,30240
7785,408005,406804,120,30180,66,"""2""",30180,30300
7785,406804,403002,60,30180,66,"""2""",30300,30360
7785,403002,404103,120,30180,66,"""2""",30360,30480
7785,404103,403104,120,30180,66,"""2""",30480,30600
7785,403104,112103,120,30180,66,"""2""",30600,30720
7785,112103,109018,120,30180,66,"""2""",30720,30840
7785,408005,406804,120,30780,66,"""2""",30780,30900
7785,406804,403002,60,30780,66,"""2""",30900,30960
7785,403002,404103,120,30780,66,"""2""",30960,31080
7785,404103,403104,120,30780,66,"""2""",31080,31200
7785,403104,112103,120,30780,66,"""2""",31200,31320
7785,112103,109018,120,30780,66,"""2""",31320,31440
7785,408005,406804,120,31380,66,"""2""",31380,31500
7785,406804,403002,60,31380,66,"""2""",31500,31560
7785,403002,404103,120,31380,66,"""2""",31560,31680
7785,404103,403104,120,31380,66,"""2""",31680,31800
7785,403104,112103,120,31380,66,"""2""",31800,31920
7785,112103,109018,120,31380,66,"""2""",31920,32040
7785,408005,406804,120,31980,66,"""2""",31980,32100
7785,406804,403002,60,31980,66,"""2""",32100,32160
7785,403002,404103,120,31980,66,"""2""",32160,32280
7785,404103,403104,120,31980,66,"""2""",32280,32400
7785,403104,112103,120,31980,66,"""2""",32400,32520
7785,112103,109018,120,31980,66,"""2""",32520,32640
7785,408005,406804,120,32580,66,"""2""",32580,32700
7785,406804,403002,60,32580,66,"""2""",32700,32760
7785,403002,404103,120,32580,66,"""2""",32760,32880
7785,404103,403104,120,32580,66,"""2""",32880,33000
7785,403104,112103,120,32580,66,"""2""",33000,33120
7785,112103,109018,120,32580,66,"""2""",33120,33240
7785,408005,406804,120,33180,66,"""2""",33180,33300
7785,406804,403002,60,33180,66,"""2""",33300,33360
7785,403002,404103,120,33180,66,"""2""",33360,33480
7785,404103,403104,120,33180,66,"""2""",33480,33600
7785,403104,112103,120,33180,66,"""2""",33600,33720
7785,112103,109018,120,33180,66,"""2""",33720,33840
7785,408005,406804,120,33780,66,"""2""",33780,33900
7785,406804,403002,60,33780,66,"""2""",33900,33960
7785,403002,404103,120,33780,66,"""2""",33960,34080
7785,404103,403104,120,33780,66,"""2""",34080,34200
7785,403104,112103,120,33780,66,"""2""",34200,34320
7785,112103,109018,120,33780,66,"""2""",34320,34440
7785,408005,406804,120,34380,66,"""2""",34380,34500
7785,406804,403002,60,34380,66,"""2""",34500,34560
7785,403002,404103,120,34380,66,"""2""",34560,34680
7785,404103,403104,120,34380,66,"""2""",34680,34800
7785,403104,112103,120,34380,66,"""2""",34800,34920
7785,112103,109018,120,34380,66,"""2""",34920,35040
7785,408005,406804,120,34980,66,"""2""",34980,35100
7785,406804,403002,60,34980,66,"""2""",35100,35160
7785,403002,404103,120,34980,66,"""2""",35160,35280
7785,404103,403104,120,34980,66,"""2""",35280,35400
7785,403104,112103,120,34980,66,"""2""",35400,35520
7785,112103,109018,120,34980,66,"""2""",35520,35640
7785,408005,406804,120,35580,66,"""2""",35580,35700
7785,406804,403002,60,35580,66,"""2""",35700,35760
7785,403002,404103,120,35580,66,"""2""",35760,35880
7785,404103,403104,120,35580,66,"""2""",35880,36000
7785,403104,112103,120,35580,66,"""2""",36000,36120
7785,112103,109018,120,35580,66,"""2""",36120,36240
7785,408005,406804,120,36180,66,"""2""",36180,36300
7785,406804,403002,60,36180,66,"""2""",36300,36360
7785,403002,404103,120,36180,66,"""2""",36360,36480
7785,404103,403104,120,36180,66,"""2""",36480,36600
7785,403104,112103,120,36180,66,"""2""",36600,36720
7785,112103,109018,120,36180,66,"""2""",36720,36840
7785,408005,406804,120,54180,66,"""2""",54180,54300
7785,406804,403002,60,54180,66,"""2""",54300,54360
7785,403002,404103,120,54180,66,"""2""",54360,54480
7785,404103,403104,120,54180,66,"""2""",54480,54600
7785,403104,112103,120,54180,66,"""2""",54600,54720
7785,112103,109018,120,54180,66,"""2""",54720,54840
7785,408005,406804,120,54780,66,"""2""",54780,54900
7785,406804,403002,60,54780,66,"""2""",54900,54960
7785,403002,404103,120,54780,66,"""2""",54960,55080
7785,404103,403104,120,54780,66,"""2""",55080,55200
7785,403104,112103,120,54780,66,"""2""",55200,55320
7785,112103,109018,120,54780,66,"""2""",55320,55440
7785,408005,406804,120,55380,66,"""2""",55380,55500
7785,406804,403002,60,55380,66,"""2""",55500,55560
7785,403002,404103,120,55380,66,"""2""",55560,55680
7785,404103,403104,120,55380,66,"""2""",55680,55800
7785,403104,112103,120,55380,66,"""2""",55800,55920
7785,112103,109018,120,55380,66,"""2""",55920,56040
7785,408005,406804,120,55980,66,"""2""",55980,56100
7785,406804,403002,60,55980,66,"""2""",56100,56160
7785,403002,404103,120,55980,66,"""2""",56160,56280
7785,404103,403104,120,55980,66,"""2""",56280,56400
7785,403104,112103,120,55980,66,"""2""",56400,56520
7785,112103,109018,120,55980,66,"""2""",56520,56640
7785,408005,406804,120,56580,66,"""2""",56580,56700
7785,406804,403002,60,56580,66,"""2""",56700,56760
7785,403002,404103,120,56580,66,"""2""",56760,56880
7785,404103,403104,120,56580,66,"""2""",56880,57000
7785,403104,112103,120,56580,66,"""2""",57000,57120
7785,112103,109018,120,56580,66,"""2""",57120,57240
7785,408005,406804,120,57180,66,"""2""",57180,57300
7785,406804,403002,60,57180,66,"""2""",57300,57360
7785,403002,404103,120,57180,66,"""2""",57360,57480
7785,404103,403104,120,57180,66,"""2""",57480,57600
7785,403104,112103,120,57180,66,"""2""",57600,57720
7785,112103,109018,120,57180,66,"""2""",57720,57840
7785,408005,406804,120,57780,66,"""2""",57780,57900
7785,406804,403002,60,57780,66,"""2""",57900,57960
7785,403002,404103,120,57780,66,"""2""",57960,58080
7785,404103,403104,120,57780,66,"""2""",58080,58200
7785,403104,112103,120,57780,66,"""2""",58200,58320
7785,112103,109018,120,57780,66,"""2""",58320,58440
7785,408005,406804,120,58380,66,"""2""",58380,58500
7785,406804,403002,60,58380,66,"""2""",58500,58560
7785,403002,404103,120,58380,66,"""2""",58560,58680
7785,404103,403104,120,58380,66,"""2""",58680,58800
7785,403104,112103,120,58380,66,"""2""",58800,58920
7785,112103,109018,120,58380,66,"""2""",58920,59040
7785,408005,406804,120,58980,66,"""2""",58980,59100
7785,406804,403002,60,58980,66,"""2""",59100,59160
7785,403002,404103,120,58980,66,"""2""",59160,59280
7785,404103,403104,120,58980,66,"""2""",59280,59400
7785,403104,112103,120,58980,66,"""2""",59400,59520
7785,112103,109018,120,58980,66,"""2""",59520,59640
7785,408005,406804,120,59580,66,"""2""",59580,59700
7785,406804,403002,60,59580,66,"""2""",59700,59760
7785,403002,404103,120,59580,66,"""2""",59760,59880
7785,404103,403104,120,59580,66,"""2""",59880,60000
7785,403104,112103,120,59580,66,"""2""",60000,60120
7785,112103,109018,120,59580,66,"""2""",60120,60240
7785,408005,406804,120,60180,66,"""2""",60180,60300
7785,406804,403002,60,60180,66,"""2""",60300,60360
7785,403002,404103,120,60180,66,"""2""",60360,60480
7785,404103,403104,120,60180,66,"""2""",60480,60600
7785,403104,112103,120,60180,66,"""2""",60600,60720
7785,112103,109018,120,60180,66,"""2""",60720,60840
7785,408005,406804,120,60780,66,"""2""",60780,60900
7785,406804,403002,60,60780,66,"""2""",60900,60960
7785,403002,404103,120,60780,66,"""2""",60960,61080
7785,404103,403104,120,60780,66,"""2""",61080,61200
7785,403104,112103,120,60780,66,"""2""",61200,61320
7785,112103,109018,120,60780,66,"""2""",61320,61440
7785,408005,406804,120,61380,66,"""2""",61380,61500
7785,406804,403002,60,61380,66,"""2""",61500,61560
7785,403002,404103,120,61380,66,"""2""",61560,61680
7785,404103,403104,120,61380,66,"""2""",61680,61800
7785,403104,112103,120,61380,66,"""2""",61800,61920
7785,112103,109018,120,61380,66,"""2""",61920,62040
7785,408005,406804,120,61980,66,"""2""",61980,62100
7785,406804,403002,60,61980,66,"""2""",62100,62160
7785,403002,404103,120,61980,66,"""2""",62160,62280
7785,404103,403104,120,61980,66,"""2""",62280,62400
7785,403104,112103,120,61980,66,"""2""",62400,62520
7785,112103,109018,120,61980,66,"""2""",62520,62640
7785,408005,406804,120,62580,66,"""2""",62580,62700
7785,406804,403002,60,62580,66,"""2""",62700,62760
7785,403002,404103,120,62580,66,"""2""",62760,62880
7785,404103,403104,120,62580,66,"""2""",62880,63000
7785,403104,112103,120,62580,66,"""2""",63000,63120
7785,112103,109018,120,62580,66,"""2""",63120,63240
7785,408005,406804,120,63180,66,"""2""",63180,63300
7785,406804,403002,60,63180,66,"""2""",63300,63360
7785,403002,404103,120,63180,66,"""2""",63360,63480
7785,404103,403104,120,63180,66,"""2""",63480,63600
7785,403104,112103,120,63180,66,"""2""",63600,63720
7785,112103,109018,120,63180,66,"""2""",63720,63840
7785,408005,406804,120,63780,66,"""2""",63780,63900
7785,406804,403002,60,63780,66,"""2""",63900,63960
7785,403002,404103,120,63780,66,"""2""",63960,64080
7785,404103,403104,120,63780,66,"""2""",64080,64200
7785,403104,112103,120,63780,66,"""2""",64200,64320
7785,112103,109018,120,63780,66,"""2""",64320,64440
7785,408005,406804,120,64380,66,"""2""",64380,64500
7785,406804,403002,60,64380,66,"""2""",64500,64560
7785,403002,404103,120,64380,66,"""2""",64560,64680
7785,404103,403104,120,64380,66,"""2""",64680,64800
7785,403104,112103,120,64380,66,"""2""",64800,64920
7785,112103,109018,120,64380,66,"""2""",64920,65040
7785,408005,406804,120,64980,66,"""2""",64980,65100
7785,406804,403002,60,64980,66,"""2""",65100,65160
7785,403002,404103,120,64980,66,"""2""",65160,65280
7785,404103,403104,120,64980,66,"""2""",65280,65400
7785,403104,112103,120,64980,66,"""2""",65400,65520
7785,112103,109018,120,64980,66,"""2""",65520,65640
7785,408005,406804,120,65580,66,"""2""",65580,65700
7785,406804,403002,60,65580,66,"""2""",65700,65760
7785,403002,404103,120,65580,66,"""2""",65760,65880
7785,404103,403104,120,65580,66,"""2""",65880,66000
7785,403104,112103,120,65580,66,"""2""",66000,66120
7785,112103,109018,120,65580,66,"""2""",66120,66240
7785,408005,406804,120,66180,66,"""2""",66180,66300
7785,406804,403002,60,66180,66,"""2""",66300,66360
7785,403002,404103,120,66180,66,"""2""",66360,66480
7785,404103,403104,120,66180,66,"""2""",66480,66600
7785,403104,112103,120,66180,66,"""2""",66600,66720
7785,112103,109018,120,66180,66,"""2""",66720,66840
7785,408005,406804,120,66780,66,"""2""",66780,66900
7785,406804,403002,60,66780,66,"""2""",66900,66960
7785,403002,404103,120,66780,66,"""2""",66960,67080
7785,404103,403104,120,66780,66,"""2""",67080,67200
7785,403104,112103,120,66780,66,"""2""",67200,67320
7785,112103,109018,120,66780,66,"""2""",67320,67440
7785,408005,406804,120,67380,66,"""2""",67380,67500
7785,406804,403002,60,67380,66,"""2""",67500,67560
7785,403002,404103,120,67380,66,"""2""",67560,67680
7785,404103,403104,120,67380,66,"""2""",67680,67800
7785,403104,112103,120,67380,66,"""2""",67800,67920
7785,112103,109018,120,67380,66,"""2""",67920,68040
7785,408005,406804,120,67980,66,"""2""",67980,68100
7785,406804,403002,60,67980,66,"""2""",68100,68160
7785,403002,404103,120,67980,66,"""2""",68160,68280
7785,404103,403104,120,67980,66,"""2""",68280,68400
7785,403104,112103,120,67980,66,"""2""",68400,68520
7785,112103,109018,120,67980,66,"""2""",68520,68640
7785,408005,406804,120,69180,66,"""2""",69180,69300
7785,406804,403002,60,69180,66,"""2""",69300,69360
7785,403002,404103,120,69180,66,"""2""",69360,69480
7785,404103,403104,120,69180,66,"""2""",69480,69600
7785,403104,112103,120,69180,66,"""2""",69600,69720
7785,112103,109018,120,69180,66,"""2""",69720,69840
7785,408005,406804,120,70380,66,"""2""",70380,70500
7785,406804,403002,60,70380,66,"""2""",70500,70560
7785,403002,404103,120,70380,66,"""2""",70560,70680
7785,404103,403104,120,70380,66,"""2""",70680,70800
7785,403104,112103,120,70380,66,"""2""",70800,70920
7785,112103,109018,120,70380,66,"""2""",70920,71040
7786,408005,406804,120,71580,66,"""2""",71580,71700
7786,406804,403002,60,71580,66,"""2""",71700,71760
7786,403002,404103,60,71580,66,"""2""",71760,71820
7786,404103,403104,60,71580,66,"""2""",71820,71880
7786,403104,112103,120,71580,66,"""2""",71880,72000
7786,112103,109018,120,71580,66,"""2""",72000,72120
7786,408005,406804,120,73080,66,"""2""",73080,73200
7786,406804,403002,60,73080,66,"""2""",73200,73260
7786,403002,404103,60,73080,66,"""2""",73260,73320
7786,404103,403104,60,73080,66,"""2""",73320,73380
7786,403104,112103,120,73080,66,"""2""",73380,73500
7786,112103,109018,120,73080,66,"""2""",73500,73620
7786,408005,406804,120,74280,66,"""2""",74280,74400
7786,406804,403002,60,74280,66,"""2""",74400,74460
7786,403002,404103,60,74280,66,"""2""",74460,74520
7786,404103,403104,60,74280,66,"""2""",74520,74580
7786,403104,112103,120,74280,66,"""2""",74580,74700
7786,112103,109018,120,74280,66,"""2""",74700,74820
